"cbsa","mdiv","stcou","name","lsad","year","popestimate","npopchg_","naturalinc","births","deaths","netmig","internationalmig","domesticmig","residual"
"10180",NA,48059,"Callahan County, TX","County or equivalent",2001,12717,-200,-14,145,159,-177,5,-182,-9
"10180",NA,48253,"Jones County, TX","County or equivalent",2001,20125,-598,-18,200,218,-562,6,-568,-18
"10180",NA,48441,"Taylor County, TX","County or equivalent",2001,125442,-1025,861,2031,1170,-1810,105,-1915,-76
"10420",NA,NA,"Akron, OH","Metropolitan Statistical Area",2001,698205,2244,2286,8826,6540,-403,709,-1112,361
"10420",NA,39133,"Portage County, OH","County or equivalent",2001,153026,643,659,1732,1073,138,119,19,-154
"10420",NA,39153,"Summit County, OH","County or equivalent",2001,545179,1601,1627,7094,5467,-541,590,-1131,515
"10500",NA,NA,"Albany, GA","Metropolitan Statistical Area",2001,159814,2055,1158,2493,1335,-380,120,-500,1277
"10500",NA,13007,"Baker County, GA","County or equivalent",2001,4037,-17,2,41,39,-14,3,-17,-5
"10500",NA,13095,"Dougherty County, GA","County or equivalent",2001,96109,223,789,1632,843,-478,85,-563,-88
"10500",NA,13177,"Lee County, GA","County or equivalent",2001,26745,1863,190,325,135,270,21,249,1403
"10500",NA,13273,"Terrell County, GA","County or equivalent",2001,10953,-15,73,193,120,-77,4,-81,-11
"10500",NA,13321,"Worth County, GA","County or equivalent",2001,21970,1,104,302,198,-81,7,-88,-22
"10580",NA,NA,"Albany-Schenectady-Troy, NY","Metropolitan Statistical Area",2001,829321,2169,1730,9437,7707,1204,1327,-123,-765
"10580",NA,36001,"Albany County, NY","County or equivalent",2001,295285,380,295,3200,2905,365,675,-310,-280
"10580",NA,36083,"Rensselaer County, NY","County or equivalent",2001,152245,-376,256,1753,1497,-488,260,-748,-144
"10580",NA,36091,"Saratoga County, NY","County or equivalent",2001,204076,2518,1048,2477,1429,1653,146,1507,-183
"10580",NA,36093,"Schenectady County, NY","County or equivalent",2001,145953,-525,129,1700,1571,-523,242,-765,-131
"10580",NA,36095,"Schoharie County, NY","County or equivalent",2001,31762,172,2,307,305,197,4,193,-27
"10740",NA,NA,"Albuquerque, NM","Metropolitan Statistical Area",2001,739327,7653,5387,10813,5426,2973,2096,877,-707
"10740",NA,35001,"Bernalillo County, NM","County or equivalent",2001,562388,5255,4117,8352,4235,1695,1877,-182,-557
"10740",NA,35043,"Sandoval County, NM","County or equivalent",2001,93134,1887,679,1262,583,1285,78,1207,-77
"10740",NA,35057,"Torrance County, NM","County or equivalent",2001,16673,-265,92,208,116,-345,13,-358,-12
"10740",NA,35061,"Valencia County, NM","County or equivalent",2001,67132,776,499,991,492,338,128,210,-61
"10780",NA,NA,"Alexandria, LA","Metropolitan Statistical Area",2001,144915,-169,587,2166,1579,-735,80,-815,-21
"10780",NA,22043,"Grant Parish, LA","County or equivalent",2001,18643,-44,68,269,201,-96,1,-97,-16
"10780",NA,22079,"Rapides Parish, LA","County or equivalent",2001,126272,-125,519,1897,1378,-639,79,-718,-5
"10900",NA,NA,"Allentown-Bethlehem-Easton, PA-NJ","Metropolitan Statistical Area",2001,748523,6650,1308,8653,7345,5730,1569,4161,-388
"10900",NA,34041,"Warren County, NJ","County or equivalent",2001,105270,2323,521,1291,770,1862,213,1649,-60
"10900",NA,42025,"Carbon County, PA","County or equivalent",2001,59207,375,-178,594,772,594,16,578,-41
"10900",NA,42077,"Lehigh County, PA","County or equivalent",2001,314723,2069,533,3779,3246,1824,846,978,-288
"10900",NA,42095,"Northampton County, PA","County or equivalent",2001,269323,1883,432,2989,2557,1450,494,956,1
"11020",NA,NA,"Altoona, PA","Metropolitan Statistical Area",2001,128335,-697,-175,1485,1660,-409,28,-437,-113
"11020",NA,42013,"Blair County, PA","County or equivalent",2001,128335,-697,-175,1485,1660,-409,28,-437,-113
"11100",NA,NA,"Amarillo, TX","Metropolitan Statistical Area",2001,228292,1194,1632,3575,1943,-216,549,-765,-222
"11100",NA,48011,"Armstrong County, TX","County or equivalent",2001,2150,-16,-6,17,23,-8,1,-9,-2
"11100",NA,48065,"Carson County, TX","County or equivalent",2001,6386,-119,25,83,58,-141,8,-149,-3
"11100",NA,48375,"Potter County, TX","County or equivalent",2001,114523,801,1105,2253,1148,-199,411,-610,-105
"11100",NA,48381,"Randall County, TX","County or equivalent",2001,105233,528,508,1222,714,132,129,3,-112
"11180",NA,NA,"Ames, IA","Metropolitan Statistical Area",2001,80052,-69,511,984,473,-525,519,-1044,-55
"11180",NA,19169,"Story County, IA","County or equivalent",2001,80052,-69,511,984,473,-525,519,-1044,-55
"11260",NA,NA,"Anchorage, AK","Metropolitan Statistical Area",2001,325648,5274,3578,4992,1414,2014,553,1461,-318
"11260",NA,2020,"Anchorage Municipality, AK","County or equivalent",2001,263746,3220,3031,4150,1119,470,515,-45,-281
"11260",NA,2170,"Matanuska-Susitna Borough, AK","County or equivalent",2001,61902,2054,547,842,295,1544,38,1506,-37
"11300",NA,NA,"Anderson, IN","Metropolitan Statistical Area",2001,132992,-286,135,1641,1506,-297,91,-388,-124
"11300",NA,18095,"Madison County, IN","County or equivalent",2001,132992,-286,135,1641,1506,-297,91,-388,-124
"11340",NA,NA,"Anderson, SC","Metropolitan Statistical Area",2001,168690,2377,521,2268,1747,1980,126,1854,-124
"11340",NA,45007,"Anderson County, SC","County or equivalent",2001,168690,2377,521,2268,1747,1980,126,1854,-124
"11460",NA,NA,"Ann Arbor, MI","Metropolitan Statistical Area",2001,329239,4751,2241,4110,1869,2847,2206,641,-337
"11460",NA,26161,"Washtenaw County, MI","County or equivalent",2001,329239,4751,2241,4110,1869,2847,2206,641,-337
"11500",NA,NA,"Anniston-Oxford, AL","Metropolitan Statistical Area",2001,111001,-345,173,1561,1388,-421,60,-481,-97
"11500",NA,1015,"Calhoun County, AL","County or equivalent",2001,111001,-345,173,1561,1388,-421,60,-481,-97
"11540",NA,NA,"Appleton, WI","Metropolitan Statistical Area",2001,205327,2818,1510,2854,1344,1495,236,1259,-187
"11540",NA,55015,"Calumet County, WI","County or equivalent",2001,41454,726,323,558,235,436,35,401,-33
"11540",NA,55087,"Outagamie County, WI","County or equivalent",2001,163873,2092,1187,2296,1109,1059,201,858,-154
"11700",NA,NA,"Asheville, NC","Metropolitan Statistical Area",2001,373766,3315,217,4449,4232,3418,870,2548,-320
"11700",NA,37021,"Buncombe County, NC","County or equivalent",2001,208432,1424,311,2594,2283,1302,485,817,-189
"11700",NA,37087,"Haywood County, NC","County or equivalent",2001,54562,456,-82,554,636,580,31,549,-42
"11700",NA,37089,"Henderson County, NC","County or equivalent",2001,90944,1297,5,1088,1083,1366,344,1022,-74
"11700",NA,37115,"Madison County, NC","County or equivalent",2001,19828,138,-17,213,230,170,10,160,-15
"12020",NA,NA,"Athens-Clarke County, GA","Metropolitan Statistical Area",2001,169081,2198,933,2106,1173,1424,780,644,-159
"12020",NA,13059,"Clarke County, GA","County or equivalent",2001,103425,1474,607,1269,662,967,709,258,-100
"12020",NA,13195,"Madison County, GA","County or equivalent",2001,26106,248,120,362,242,151,28,123,-23
"12020",NA,13219,"Oconee County, GA","County or equivalent",2001,26665,298,163,315,152,159,38,121,-24
"12020",NA,13221,"Oglethorpe County, GA","County or equivalent",2001,12885,178,43,160,117,147,5,142,-12
"12060",NA,NA,"Atlanta-Sandy Springs-Marietta, GA","Metropolitan Statistical Area",2001,4432582,150686,45775,73107,27332,75632,27840,47792,29279
"12060",NA,13013,"Barrow County, GA","County or equivalent",2001,48456,1895,430,805,375,1480,62,1418,-15
"12060",NA,13015,"Bartow County, GA","County or equivalent",2001,79510,2809,781,1404,623,2075,132,1943,-47
"12060",NA,13035,"Butts County, GA","County or equivalent",2001,20357,628,78,276,198,558,3,555,-8
"12060",NA,13045,"Carroll County, GA","County or equivalent",2001,91561,3560,711,1474,763,2882,204,2678,-33
"12060",NA,13057,"Cherokee County, GA","County or equivalent",2001,151284,7541,1717,2522,805,5865,532,5333,-41
"12060",NA,13063,"Clayton County, GA","County or equivalent",2001,247173,8805,3150,4502,1352,5861,1536,4325,-206
"12060",NA,13067,"Cobb County, GA","County or equivalent",2001,626870,14228,7195,10545,3350,7685,4590,3095,-652
"12060",NA,13077,"Coweta County, GA","County or equivalent",2001,93746,3597,885,1548,663,2755,269,2486,-43
"12060",NA,13085,"Dawson County, GA","County or equivalent",2001,16909,610,128,245,117,489,12,477,-7
"12060",NA,13089,"DeKalb County, GA","County or equivalent",2001,682129,13314,7065,11250,4185,-1787,7470,-9257,8036
"12060",NA,13097,"Douglas County, GA","County or equivalent",2001,95489,2786,813,1446,633,2031,177,1854,-58
"12060",NA,13113,"Fayette County, GA","County or equivalent",2001,94194,2121,371,920,549,1829,214,1615,-79
"12060",NA,13117,"Forsyth County, GA","County or equivalent",2001,108701,8203,1501,2085,584,6670,390,6280,32
"12060",NA,13121,"Fulton County, GA","County or equivalent",2001,846806,29654,7421,13504,6083,-730,5625,-6355,22963
"12060",NA,13135,"Gwinnett County, GA","County or equivalent",2001,621901,25558,8519,11060,2541,17430,5781,11649,-391
"12060",NA,13143,"Haralson County, GA","County or equivalent",2001,26302,469,133,399,266,354,11,343,-18
"12060",NA,13149,"Heard County, GA","County or equivalent",2001,11163,78,72,171,99,18,2,16,-12
"12060",NA,13151,"Henry County, GA","County or equivalent",2001,130460,8880,1269,2016,747,7580,100,7480,31
"12060",NA,13159,"Jasper County, GA","County or equivalent",2001,11628,141,44,158,114,108,11,97,-11
"12060",NA,13171,"Lamar County, GA","County or equivalent",2001,16342,372,65,221,156,315,12,303,-8
"12060",NA,13199,"Meriwether County, GA","County or equivalent",2001,22589,62,74,306,232,9,1,8,-21
"12060",NA,13217,"Newton County, GA","County or equivalent",2001,66946,4062,658,1176,518,3399,72,3327,5
"12060",NA,13223,"Paulding County, GA","County or equivalent",2001,88571,5576,1149,1602,453,4401,51,4350,26
"12060",NA,13227,"Pickens County, GA","County or equivalent",2001,24486,1127,124,345,221,1006,20,986,-3
"12060",NA,13231,"Pike County, GA","County or equivalent",2001,14036,238,46,164,118,200,1,199,-8
"12060",NA,13247,"Rockdale County, GA","County or equivalent",2001,71692,1134,506,1010,504,693,403,290,-65
"12060",NA,13255,"Spalding County, GA","County or equivalent",2001,58987,505,343,938,595,221,103,118,-59
"12060",NA,13297,"Walton County, GA","County or equivalent",2001,64294,2733,527,1015,488,2235,56,2179,-29
"12100",NA,NA,"Atlantic City-Hammonton, NJ","Metropolitan Statistical Area",2001,254783,1803,893,3389,2496,1162,1324,-162,-252
"12100",NA,34001,"Atlantic County, NJ","County or equivalent",2001,254783,1803,893,3389,2496,1162,1324,-162,-252
"12220",NA,NA,"Auburn-Opelika, AL","Metropolitan Statistical Area",2001,116738,1208,593,1377,784,728,180,548,-113
"12220",NA,1081,"Lee County, AL","County or equivalent",2001,116738,1208,593,1377,784,728,180,548,-113
"12260",NA,NA,"Augusta-Richmond County, GA-SC","Metropolitan Statistical Area",2001,502882,2665,3052,7588,4536,96,411,-315,-483
"12260",NA,13033,"Burke County, GA","County or equivalent",2001,22643,364,264,484,220,123,6,117,-23
"12260",NA,13073,"Columbia County, GA","County or equivalent",2001,91521,1743,745,1266,521,1091,106,985,-93
"12260",NA,13189,"McDuffie County, GA","County or equivalent",2001,21295,44,105,356,251,-42,6,-48,-19
"12260",NA,13245,"Richmond County, GA","County or equivalent",2001,199534,-113,1369,3286,1917,-1308,106,-1414,-174
"12260",NA,45003,"Aiken County, SC","County or equivalent",2001,143378,654,480,1892,1412,326,174,152,-152
"12260",NA,45037,"Edgefield County, SC","County or equivalent",2001,24511,-27,89,304,215,-94,13,-107,-22
"12420",NA,NA,"Austin-Round Rock, TX","Metropolitan Statistical Area",2001,1324344,58679,15476,22086,6610,43718,9063,34655,-515
"12420",NA,48021,"Bastrop County, TX","County or equivalent",2001,61258,2972,433,891,458,2542,161,2381,-3
"12420",NA,48055,"Caldwell County, TX","County or equivalent",2001,33705,1234,235,535,300,1007,51,956,-8
"12420",NA,48209,"Hays County, TX","County or equivalent",2001,104854,5801,958,1482,524,4838,187,4651,5
"12420",NA,48453,"Travis County, TX","County or equivalent",2001,847960,27044,10342,14472,4130,17315,7903,9412,-613
"12420",NA,48491,"Williamson County, TX","County or equivalent",2001,276567,21628,3508,4706,1198,18016,761,17255,104
"12540",NA,NA,"Bakersfield, CA","Metropolitan Statistical Area",2001,674235,10725,6803,11719,4916,4576,3165,1411,-654
"12540",NA,6029,"Kern County, CA","County or equivalent",2001,674235,10725,6803,11719,4916,4576,3165,1411,-654
"12580",NA,NA,"Baltimore-Towson, MD","Metropolitan Statistical Area",2001,2577412,20174,10225,34227,24002,4772,5007,-235,5177
"12580",NA,24003,"Anne Arundel County, MD","County or equivalent",2001,496881,5550,3220,6805,3585,2773,543,2230,-443
"12580",NA,24005,"Baltimore County, MD","County or equivalent",2001,762269,6277,1577,9266,7689,5408,1974,3434,-708
"12580",NA,24013,"Carroll County, MD","County or equivalent",2001,154451,2874,735,1930,1195,2267,74,2193,-128
"12580",NA,24025,"Harford County, MD","County or equivalent",2001,222251,2787,1310,2846,1536,1689,156,1533,-212
"12580",NA,24027,"Howard County, MD","County or equivalent",2001,255016,5496,2282,3556,1274,3441,1078,2363,-227
"12580",NA,24035,"Queen Anne's County, MD","County or equivalent",2001,41291,524,128,481,353,430,45,385,-34
"12580",NA,24510,"Baltimore city, MD","County or equivalent",2001,645253,-3334,973,9343,8370,-11236,1137,-12373,6929
"12620",NA,NA,"Bangor, ME","Metropolitan Statistical Area",2001,145572,668,204,1572,1368,597,118,479,-133
"12620",NA,23019,"Penobscot County, ME","County or equivalent",2001,145572,668,204,1572,1368,597,118,479,-133
"12700",NA,NA,"Barnstable Town, MA","Metropolitan Statistical Area",2001,225042,1814,-721,2023,2744,2700,406,2294,-165
"12700",NA,25001,"Barnstable County, MA","County or equivalent",2001,225042,1814,-721,2023,2744,2700,406,2294,-165
"12940",NA,NA,"Baton Rouge, LA","Metropolitan Statistical Area",2001,709718,2375,4952,10540,5588,-2060,955,-3015,-517
"12940",NA,22005,"Ascension Parish, LA","County or equivalent",2001,79086,1808,819,1337,518,1049,89,960,-60
"12940",NA,22033,"East Baton Rouge Parish, LA","County or equivalent",2001,411356,-1534,2743,6008,3265,-3984,828,-4812,-293
"12940",NA,22037,"East Feliciana Parish, LA","County or equivalent",2001,21198,-167,62,287,225,-212,2,-214,-17
"12940",NA,22047,"Iberville Parish, LA","County or equivalent",2001,33231,-84,209,528,319,-267,4,-271,-26
"12940",NA,22063,"Livingston Parish, LA","County or equivalent",2001,95197,2667,778,1465,687,1949,24,1925,-60
"12940",NA,22077,"Pointe Coupee Parish, LA","County or equivalent",2001,22524,-232,100,344,244,-312,0,-312,-20
"12940",NA,22091,"St. Helena Parish, LA","County or equivalent",2001,10425,-83,39,127,88,-113,0,-113,-9
"12940",NA,22121,"West Baton Rouge Parish, LA","County or equivalent",2001,21621,57,156,311,155,-80,5,-85,-19
"12940",NA,22125,"West Feliciana Parish, LA","County or equivalent",2001,15080,-57,46,133,87,-90,3,-93,-13
"12980",NA,NA,"Battle Creek, MI","Metropolitan Statistical Area",2001,138005,-7,494,1923,1429,-379,175,-554,-122
"12980",NA,26025,"Calhoun County, MI","County or equivalent",2001,138005,-7,494,1923,1429,-379,175,-554,-122
"13020",NA,NA,"Bay City, MI","Metropolitan Statistical Area",2001,109651,-439,224,1319,1095,-569,25,-594,-94
"13020",NA,26017,"Bay County, MI","County or equivalent",2001,109651,-439,224,1319,1095,-569,25,-594,-94
"13140",NA,NA,"Beaumont-Port Arthur, TX","Metropolitan Statistical Area",2001,381678,-2987,1186,5195,4009,-3891,603,-4494,-282
"13140",NA,48199,"Hardin County, TX","County or equivalent",2001,48378,223,156,649,493,116,11,105,-49
"13140",NA,48245,"Jefferson County, TX","County or equivalent",2001,249171,-2432,801,3437,2636,-3057,540,-3597,-176
"13140",NA,48361,"Orange County, TX","County or equivalent",2001,84129,-778,229,1109,880,-950,52,-1002,-57
"13380",NA,NA,"Bellingham, WA","Metropolitan Statistical Area",2001,171196,3470,749,1990,1241,2864,648,2216,-143
"13380",NA,53073,"Whatcom County, WA","County or equivalent",2001,171196,3470,749,1990,1241,2864,648,2216,-143
"13460",NA,NA,"Bend, OR","Metropolitan Statistical Area",2001,120645,4032,509,1460,951,3573,92,3481,-50
"13460",NA,41017,"Deschutes County, OR","County or equivalent",2001,120645,4032,509,1460,951,3573,92,3481,-50
"13740",NA,NA,"Billings, MT","Metropolitan Statistical Area",2001,140236,1144,595,1825,1230,699,34,665,-150
"13740",NA,30009,"Carbon County, MT","County or equivalent",2001,9635,71,-9,76,85,88,5,83,-8
"13740",NA,30111,"Yellowstone County, MT","County or equivalent",2001,130601,1073,604,1749,1145,611,29,582,-142
"13780",NA,NA,"Binghamton, NY","Metropolitan Statistical Area",2001,251412,-613,145,2795,2650,-523,386,-909,-235
"13780",NA,36007,"Broome County, NY","County or equivalent",2001,199958,-341,-50,2197,2247,-99,366,-465,-192
"13780",NA,36107,"Tioga County, NY","County or equivalent",2001,51454,-272,195,598,403,-424,20,-444,-43
"13820",NA,NA,"Birmingham-Hoover, AL","Metropolitan Statistical Area",2001,1060076,6711,4447,15135,10688,2084,1390,694,180
"13820",NA,1007,"Bibb County, AL","County or equivalent",2001,20942,1005,79,272,193,924,6,918,2
"13820",NA,1009,"Blount County, AL","County or equivalent",2001,51979,802,207,687,480,633,97,536,-38
"13820",NA,1021,"Chilton County, AL","County or equivalent",2001,40024,246,179,556,377,108,48,60,-41
"13820",NA,1073,"Jefferson County, AL","County or equivalent",2001,661309,-883,2192,9407,7215,-3339,1001,-4340,264
"13820",NA,1115,"St. Clair County, AL","County or equivalent",2001,66010,931,276,866,590,705,18,687,-50
"13820",NA,1117,"Shelby County, AL","County or equivalent",2001,149230,4711,1431,2357,926,3168,182,2986,112
"13820",NA,1127,"Walker County, AL","County or equivalent",2001,70582,-101,83,990,907,-115,38,-153,-69
"13900",NA,NA,"Bismarck, ND","Metropolitan Statistical Area",2001,95167,325,370,1149,779,43,45,-2,-88
"13900",NA,38015,"Burleigh County, ND","County or equivalent",2001,70095,564,351,866,515,283,35,248,-70
"13900",NA,38059,"Morton County, ND","County or equivalent",2001,25072,-239,19,283,264,-240,10,-250,-18
"13980",NA,NA,"Blacksburg-Christiansburg-Radford, VA","Metropolitan Statistical Area",2001,153038,1522,389,1622,1233,1265,416,849,-132
"13980",NA,51071,"Giles County, VA","County or equivalent",2001,16794,73,42,223,181,46,1,45,-15
"13980",NA,51121,"Montgomery County, VA","County or equivalent",2001,84947,1160,325,832,507,906,392,514,-71
"13980",NA,51155,"Pulaski County, VA","County or equivalent",2001,35136,-13,11,425,414,10,5,5,-34
"13980",NA,51750,"Radford city, VA","County or equivalent",2001,16161,302,11,142,131,303,18,285,-12
"14020",NA,NA,"Bloomington, IN","Metropolitan Statistical Area",2001,176161,340,646,1921,1275,-149,489,-638,-157
"14020",NA,18055,"Greene County, IN","County or equivalent",2001,33161,-38,63,408,345,-67,4,-71,-34
"14020",NA,18105,"Monroe County, IN","County or equivalent",2001,120934,184,521,1259,738,-233,483,-716,-104
"14020",NA,18119,"Owen County, IN","County or equivalent",2001,22066,194,62,254,192,151,2,149,-19
"14060",NA,NA,"Bloomington-Normal, IL","Metropolitan Statistical Area",2001,152598,1718,1025,2015,990,839,287,552,-146
"14060",NA,17113,"McLean County, IL","County or equivalent",2001,152598,1718,1025,2015,990,839,287,552,-146
"14260",NA,NA,"Boise City-Nampa, ID","Metropolitan Statistical Area",2001,485501,16671,4868,7957,3089,12068,1284,10784,-265
"14260",NA,16001,"Ada County, ID","County or equivalent",2001,313472,10333,3047,4884,1837,7467,776,6691,-181
"14260",NA,16015,"Boise County, ID","County or equivalent",2001,6822,75,32,75,43,50,11,39,-7
"14260",NA,16027,"Canyon County, ID","County or equivalent",2001,139050,5998,1658,2618,960,4395,410,3985,-55
"14260",NA,16045,"Gem County, ID","County or equivalent",2001,15335,127,24,191,167,115,25,90,-12
"14260",NA,16073,"Owyhee County, ID","County or equivalent",2001,10822,138,107,189,82,41,62,-21,-10
"14460",NA,NA,"Boston-Cambridge-Quincy, MA-NH","Metropolitan Statistical Area",2001,4441675,39526,21446,58179,36733,11043,24988,-13945,7037
"14460",14484,NA,"Boston-Quincy, MA","Metropolitan Division",2001,1837286,20988,9170,24647,15477,4291,11730,-7439,7527
"14460",14484,25021,"Norfolk County, MA","County or equivalent",2001,653500,2288,2722,8522,5800,175,2552,-2377,-609
"14460",14484,25023,"Plymouth County, MA","County or equivalent",2001,478807,4442,2304,6412,4108,2572,864,1708,-434
"14460",14484,25025,"Suffolk County, MA","County or equivalent",2001,704979,14258,4144,9713,5569,1544,8314,-6770,8570
"14460",15764,NA,"Cambridge-Newton-Framingham, MA","Metropolitan Division",2001,1475675,6555,7333,19190,11857,-1300,10013,-11313,522
"14460",15764,25017,"Middlesex County, MA","County or equivalent",2001,1475675,6555,7333,19190,11857,-1300,10013,-11313,522
"14460",37764,NA,"Peabody, MA","Metropolitan Division",2001,730862,5521,2987,9630,6643,3239,2873,366,-705
"14460",37764,25009,"Essex County, MA","County or equivalent",2001,730862,5521,2987,9630,6643,3239,2873,366,-705
"14460",40484,NA,"Rockingham County-Strafford County, NH","Metropolitan Division",2001,397852,6462,1956,4712,2756,4813,372,4441,-307
"14460",40484,33015,"Rockingham County, NH","County or equivalent",2001,283380,4670,1442,3343,1901,3448,245,3203,-220
"14460",40484,33017,"Strafford County, NH","County or equivalent",2001,114472,1792,514,1369,855,1365,127,1238,-87
"14500",NA,NA,"Boulder, CO /1","Metropolitan Statistical Area",2001,277756,6105,2202,3559,1357,4116,1641,2475,-213
"14500",NA,8013,"Boulder County, CO /1","County or equivalent",2001,277756,6105,2202,3559,1357,4116,1641,2475,-213
"14540",NA,NA,"Bowling Green, KY","Metropolitan Statistical Area",2001,105297,832,512,1366,854,425,381,44,-105
"14540",NA,21061,"Edmonson County, KY","County or equivalent",2001,11729,75,41,135,94,45,4,41,-11
"14540",NA,21227,"Warren County, KY","County or equivalent",2001,93568,757,471,1231,760,380,377,3,-94
"14600",NA,NA,"Bradenton-Sarasota-Venice, FL","Metropolitan Statistical Area",2001,604817,12184,-2155,5929,8084,14563,2054,12509,-224
"14600",NA,12081,"Manatee County, FL","County or equivalent",2001,271903,6277,-143,3204,3347,6523,937,5586,-103
"14600",NA,12115,"Sarasota County, FL","County or equivalent",2001,332914,5907,-2012,2725,4737,8040,1117,6923,-121
"14740",NA,NA,"Bremerton-Silverdale, WA","Metropolitan Statistical Area",2001,233304,964,1187,2973,1786,17,123,-106,-240
"14740",NA,53035,"Kitsap County, WA","County or equivalent",2001,233304,964,1187,2973,1786,17,123,-106,-240
"14860",NA,NA,"Bridgeport-Stamford-Norwalk, CT","Metropolitan Statistical Area",2001,888226,3745,5242,12273,7031,-732,6854,-7586,-765
"14860",NA,9001,"Fairfield County, CT","County or equivalent",2001,888226,3745,5242,12273,7031,-732,6854,-7586,-765
"15180",NA,NA,"Brownsville-Harlingen, TX","Metropolitan Statistical Area",2001,342449,5933,6487,8369,1882,-261,2184,-2445,-293
"15180",NA,48061,"Cameron County, TX","County or equivalent",2001,342449,5933,6487,8369,1882,-261,2184,-2445,-293
"15260",NA,NA,"Brunswick, GA","Metropolitan Statistical Area",2001,94268,1047,355,1261,906,771,132,639,-79
"15260",NA,13025,"Brantley County, GA","County or equivalent",2001,14832,164,17,142,125,159,1,158,-12
"15260",NA,13127,"Glynn County, GA","County or equivalent",2001,68349,694,280,962,682,474,131,343,-60
"15260",NA,13191,"McIntosh County, GA","County or equivalent",2001,11087,189,58,157,99,138,0,138,-7
"15380",NA,NA,"Buffalo-Niagara Falls, NY","Metropolitan Statistical Area",2001,1163544,-5568,1013,13562,12549,-5581,1482,-7063,-1000
"15380",NA,36029,"Erie County, NY","County or equivalent",2001,945205,-4256,806,11011,10205,-4242,1315,-5557,-820
"15380",NA,36063,"Niagara County, NY","County or equivalent",2001,218339,-1312,207,2551,2344,-1339,167,-1506,-180
"15500",NA,NA,"Burlington, NC","Metropolitan Statistical Area",2001,133464,1962,515,1878,1363,1564,688,876,-117
"15500",NA,37001,"Alamance County, NC","County or equivalent",2001,133464,1962,515,1878,1363,1564,688,876,-117
"15540",NA,NA,"Burlington-South Burlington, VT","Metropolitan Statistical Area",2001,201078,1510,971,2308,1337,733,496,237,-194
"15540",NA,50007,"Chittenden County, VT","County or equivalent",2001,147967,919,742,1652,910,323,468,-145,-146
"15540",NA,50011,"Franklin County, VT","County or equivalent",2001,46007,426,206,586,380,264,26,238,-44
"15540",NA,50013,"Grand Isle County, VT","County or equivalent",2001,7104,165,23,70,47,146,2,144,-4
"15940",NA,NA,"Canton-Massillon, OH","Metropolitan Statistical Area",2001,407308,342,920,5125,4205,-1430,111,-1541,852
"15940",NA,39019,"Carroll County, OH","County or equivalent",2001,28933,67,60,315,255,38,3,35,-31
"15940",NA,39151,"Stark County, OH","County or equivalent",2001,378375,275,860,4810,3950,-1468,108,-1576,883
"15980",NA,NA,"Cape Coral-Fort Myers, FL","Metropolitan Statistical Area",2001,458541,14659,10,5246,5236,14736,1922,12814,-87
"15980",NA,12071,"Lee County, FL","County or equivalent",2001,458541,14659,10,5246,5236,14736,1922,12814,-87
"16180",NA,NA,"Carson City, NV","Metropolitan Statistical Area",2001,53403,857,181,742,561,734,210,524,-58
"16180",NA,32510,"Carson City, NV","County or equivalent",2001,53403,857,181,742,561,734,210,524,-58
"16220",NA,NA,"Casper, WY","Metropolitan Statistical Area",2001,66863,306,301,889,588,73,41,32,-68
"16220",NA,56025,"Natrona County, WY","County or equivalent",2001,66863,306,301,889,588,73,41,32,-68
"16300",NA,NA,"Cedar Rapids, IA","Metropolitan Statistical Area",2001,240072,2237,1346,3297,1951,901,288,613,-10
"16300",NA,19011,"Benton County, IA","County or equivalent",2001,25618,280,67,314,247,207,4,203,6
"16300",NA,19105,"Jones County, IA","County or equivalent",2001,20159,-50,12,213,201,-40,1,-41,-22
"16300",NA,19113,"Linn County, IA","County or equivalent",2001,194295,2007,1267,2770,1503,734,283,451,6
"16580",NA,NA,"Champaign-Urbana, IL","Metropolitan Statistical Area",2001,211790,1289,1214,2749,1535,269,1049,-780,-194
"16580",NA,17019,"Champaign County, IL","County or equivalent",2001,181320,1401,1190,2369,1179,376,1039,-663,-165
"16580",NA,17053,"Ford County, IL","County or equivalent",2001,14146,-63,-19,191,210,-31,7,-38,-13
"16580",NA,17147,"Piatt County, IL","County or equivalent",2001,16324,-49,43,189,146,-76,3,-79,-16
"16620",NA,NA,"Charleston, WV","Metropolitan Statistical Area",2001,307019,-2368,57,3724,3667,-2173,84,-2257,-252
"16620",NA,54005,"Boone County, WV","County or equivalent",2001,25391,-100,50,361,311,-127,6,-133,-23
"16620",NA,54015,"Clay County, WV","County or equivalent",2001,10222,-93,7,121,114,-90,1,-91,-10
"16620",NA,54039,"Kanawha County, WV","County or equivalent",2001,197698,-2016,-188,2365,2553,-1676,71,-1747,-152
"16620",NA,54043,"Lincoln County, WV","County or equivalent",2001,22118,-15,-9,263,272,16,1,15,-22
"16620",NA,54079,"Putnam County, WV","County or equivalent",2001,51590,-144,197,614,417,-296,5,-301,-45
"16700",NA,NA,"Charleston-North Charleston-Summerville, SC","Metropolitan Statistical Area",2001,557444,6603,3509,7956,4447,3045,728,2317,49
"16700",NA,45015,"Berkeley County, SC","County or equivalent",2001,144763,1527,1179,2112,933,500,49,451,-152
"16700",NA,45019,"Charleston County, SC","County or equivalent",2001,314279,3389,1760,4570,2810,1348,587,761,281
"16700",NA,45035,"Dorchester County, SC","County or equivalent",2001,98402,1687,570,1274,704,1197,92,1105,-80
"16740",NA,NA,"Charlotte-Gastonia-Concord, NC-SC","Metropolitan Statistical Area",2001,1374889,34606,11694,21762,10068,23886,6531,17355,-974
"16740",NA,37007,"Anson County, NC","County or equivalent",2001,25318,7,73,356,283,-40,12,-52,-26
"16740",NA,37025,"Cabarrus County, NC","County or equivalent",2001,136190,3972,1084,2199,1115,2953,429,2524,-65
"16740",NA,37071,"Gaston County, NC","County or equivalent",2001,191740,964,669,2686,2017,485,563,-78,-190
"16740",NA,37119,"Mecklenburg County, NC","County or equivalent",2001,720675,19961,7428,11997,4569,13068,4723,8345,-535
"16740",NA,37179,"Union County, NC","County or equivalent",2001,131492,5933,1387,2237,850,4587,583,4004,-41
"16740",NA,45091,"York County, SC","County or equivalent",2001,169474,3769,1053,2287,1234,2833,221,2612,-117
"16820",NA,NA,"Charlottesville, VA","Metropolitan Statistical Area",2001,177836,3084,827,2211,1384,1561,579,982,696
"16820",NA,51003,"Albemarle County, VA","County or equivalent",2001,85628,1027,446,1040,594,661,380,281,-80
"16820",NA,51065,"Fluvanna County, VA","County or equivalent",2001,21175,960,71,241,170,889,6,883,0
"16820",NA,51079,"Greene County, VA","County or equivalent",2001,15744,380,103,226,123,289,7,282,-12
"16820",NA,51125,"Nelson County, VA","County or equivalent",2001,14539,73,6,174,168,81,-1,82,-14
"16820",NA,51540,"Charlottesville city, VA","County or equivalent",2001,40750,644,201,530,329,-359,187,-546,802
"16860",NA,NA,"Chattanooga, TN-GA","Metropolitan Statistical Area",2001,482638,5443,1308,6248,4940,1785,581,1204,2350
"16860",NA,13047,"Catoosa County, GA","County or equivalent",2001,54701,1070,268,743,475,844,29,815,-42
"16860",NA,13083,"Dade County, GA","County or equivalent",2001,15459,283,50,183,133,241,12,229,-8
"16860",NA,13295,"Walker County, GA","County or equivalent",2001,61590,475,77,746,669,451,37,414,-53
"16860",NA,47065,"Hamilton County, TN","County or equivalent",2001,311526,3443,835,4078,3243,118,484,-366,2490
"16860",NA,47115,"Marion County, TN","County or equivalent",2001,27829,61,79,372,293,10,10,0,-28
"16860",NA,47153,"Sequatchie County, TN","County or equivalent",2001,11533,111,-1,126,127,121,9,112,-9
"16940",NA,NA,"Cheyenne, WY","Metropolitan Statistical Area",2001,82380,632,487,1154,667,227,27,200,-82
"16940",NA,56021,"Laramie County, WY","County or equivalent",2001,82380,632,487,1154,667,227,27,200,-82
"16980",NA,NA,"Chicago-Naperville-Joliet, IL-IN-WI","Metropolitan Statistical Area",2001,9195361,77366,72858,144287,71429,3692,58856,-55164,816
"16980",16974,NA,"Chicago-Naperville-Joliet, IL","Metropolitan Division",2001,7705502,62123,61692,121906,60214,-1001,54094,-55095,1432
"16980",16974,17031,"Cook County, IL","County or equivalent",2001,5378570,1478,39061,85324,46263,-38492,42837,-81329,909
"16980",16974,17037,"DeKalb County, IL","County or equivalent",2001,90804,1483,573,1175,602,961,324,637,-51
"16980",16974,17043,"DuPage County, IL","County or equivalent",2001,914555,7890,7794,13506,5712,211,5721,-5510,-115
"16980",16974,17063,"Grundy County, IL","County or equivalent",2001,38191,516,171,487,316,374,39,335,-29
"16980",16974,17089,"Kane County, IL","County or equivalent",2001,423969,16449,5532,7997,2465,10683,3112,7571,234
"16980",16974,17093,"Kendall County, IL","County or equivalent",2001,58158,2951,593,906,313,2188,75,2113,170
"16980",16974,17111,"McHenry County, IL","County or equivalent",2001,269982,8112,2635,4084,1449,4917,800,4117,560
"16980",16974,17197,"Will County, IL","County or equivalent",2001,531273,23244,5333,8427,3094,18157,1186,16971,-246
"16980",23844,NA,"Gary, IN","Metropolitan Division",2001,677067,699,3209,9472,6263,-1886,829,-2715,-624
"16980",23844,18073,"Jasper County, IN","County or equivalent",2001,30207,25,114,361,247,-60,14,-74,-29
"16980",23844,18089,"Lake County, IN","County or equivalent",2001,484179,-310,2359,7073,4714,-2220,647,-2867,-449
"16980",23844,18111,"Newton County, IN","County or equivalent",2001,14319,-223,10,158,148,-224,13,-237,-9
"16980",23844,18127,"Porter County, IN","County or equivalent",2001,148362,1207,726,1880,1154,618,155,463,-137
"16980",29404,NA,"Lake County-Kenosha County, IL-WI","Metropolitan Division",2001,812792,14544,7957,12909,4952,6579,3933,2646,8
"16980",29404,17097,"Lake County, IL","County or equivalent",2001,660851,12677,7064,10738,3674,5475,3694,1781,138
"16980",29404,55059,"Kenosha County, WI","County or equivalent",2001,151941,1867,893,2171,1278,1104,239,865,-130
"17020",NA,NA,"Chico, CA","Metropolitan Statistical Area",2001,206366,2459,58,2277,2219,2566,479,2087,-165
"17020",NA,6007,"Butte County, CA","County or equivalent",2001,206366,2459,58,2277,2219,2566,479,2087,-165
"17140",NA,NA,"Cincinnati-Middletown, OH-KY-IN","Metropolitan Statistical Area",2001,2035394,20779,11918,29517,17599,1101,2661,-1560,7760
"17140",NA,18029,"Dearborn County, IN","County or equivalent",2001,46774,429,257,607,350,215,11,204,-43
"17140",NA,18047,"Franklin County, IN","County or equivalent",2001,22275,54,95,255,160,-19,2,-21,-22
"17140",NA,18115,"Ohio County, IN","County or equivalent",2001,5666,30,19,67,48,17,0,17,-6
"17140",NA,21015,"Boone County, KY","County or equivalent",2001,90214,3214,957,1451,494,2310,192,2118,-53
"17140",NA,21023,"Bracken County, KY","County or equivalent",2001,8361,84,-3,101,104,95,1,94,-8
"17140",NA,21037,"Campbell County, KY","County or equivalent",2001,88613,-43,391,1232,841,-356,66,-422,-78
"17140",NA,21077,"Gallatin County, KY","County or equivalent",2001,7985,101,31,106,75,75,0,75,-5
"17140",NA,21081,"Grant County, KY","County or equivalent",2001,23108,561,161,375,214,412,10,402,-12
"17140",NA,21117,"Kenton County, KY","County or equivalent",2001,151960,272,1062,2376,1314,-644,123,-767,-146
"17140",NA,21191,"Pendleton County, KY","County or equivalent",2001,14613,125,69,194,125,70,7,63,-14
"17140",NA,39015,"Brown County, OH","County or equivalent",2001,42772,189,198,565,367,34,8,26,-43
"17140",NA,39017,"Butler County, OH","County or equivalent",2001,336553,2870,2161,4863,2702,1040,375,665,-331
"17140",NA,39025,"Clermont County, OH","County or equivalent",2001,180392,1762,1434,2779,1345,514,121,393,-186
"17140",NA,39061,"Hamilton County, OH","County or equivalent",2001,849297,5007,3648,12062,8414,-7434,1577,-9011,8793
"17140",NA,39165,"Warren County, OH","County or equivalent",2001,166811,6124,1438,2484,1046,4772,168,4604,-86
"17300",NA,NA,"Clarksville, TN-KY","Metropolitan Statistical Area",2001,235650,2936,2613,4369,1756,-1043,0,-1043,1366
"17300",NA,21047,"Christian County, KY","County or equivalent",2001,74750,2335,972,1595,623,-134,-49,-85,1497
"17300",NA,21221,"Trigg County, KY","County or equivalent",2001,12686,53,-5,143,148,69,3,66,-11
"17300",NA,47125,"Montgomery County, TN","County or equivalent",2001,135659,440,1625,2475,850,-1076,47,-1123,-109
"17300",NA,47161,"Stewart County, TN","County or equivalent",2001,12555,108,21,156,135,98,-1,99,-11
"17420",NA,NA,"Cleveland, TN","Metropolitan Statistical Area",2001,105061,761,378,1344,966,479,123,356,-96
"17420",NA,47011,"Bradley County, TN","County or equivalent",2001,88840,645,355,1147,792,373,117,256,-83
"17420",NA,47139,"Polk County, TN","County or equivalent",2001,16221,116,23,197,174,106,6,100,-13
"17460",NA,NA,"Cleveland-Elyria-Mentor, OH","Metropolitan Statistical Area",2001,2143980,-3964,6619,28287,21668,-11176,3767,-14943,593
"17460",NA,39035,"Cuyahoga County, OH","County or equivalent",2001,1381701,-10410,3041,18631,15590,-12335,2980,-15315,-1116
"17460",NA,39055,"Geauga County, OH","County or equivalent",2001,91605,396,499,1123,624,-9,27,-36,-94
"17460",NA,39085,"Lake County, OH","County or equivalent",2001,229256,1600,713,2722,2009,-234,441,-675,1121
"17460",NA,39093,"Lorain County, OH","County or equivalent",2001,286803,1671,1373,3773,2400,-509,211,-720,807
"17460",NA,39103,"Medina County, OH","County or equivalent",2001,154615,2779,993,2038,1045,1911,108,1803,-125
"17660",NA,NA,"Coeur d'Alene, ID","Metropolitan Statistical Area",2001,111719,2176,683,1532,849,1593,52,1541,-100
"17660",NA,16055,"Kootenai County, ID","County or equivalent",2001,111719,2176,683,1532,849,1593,52,1541,-100
"17780",NA,NA,"College Station-Bryan, TX","Metropolitan Statistical Area",2001,186822,1372,1557,2690,1133,-17,1237,-1254,-168
"17780",NA,48041,"Brazos County, TX","County or equivalent",2001,154220,1318,1454,2223,769,-1,1198,-1199,-135
"17780",NA,48051,"Burleson County, TX","County or equivalent",2001,16607,74,59,218,159,31,12,19,-16
"17780",NA,48395,"Robertson County, TX","County or equivalent",2001,15995,-20,44,249,205,-47,27,-74,-17
"17820",NA,NA,"Colorado Springs, CO","Metropolitan Statistical Area",2001,556614,16530,5463,8569,3106,10065,1117,8948,1002
"17820",NA,8041,"El Paso County, CO","County or equivalent",2001,535556,16120,5335,8358,3023,9769,1115,8654,1016
"17820",NA,8119,"Teller County, CO","County or equivalent",2001,21058,410,128,211,83,296,2,294,-14
"17860",NA,NA,"Columbia, MO","Metropolitan Statistical Area",2001,147780,1761,928,1883,955,977,453,524,-144
"17860",NA,29019,"Boone County, MO","County or equivalent",2001,137659,1820,915,1763,848,1040,449,591,-135
"17860",NA,29089,"Howard County, MO","County or equivalent",2001,10121,-59,13,120,107,-63,4,-67,-9
"17900",NA,NA,"Columbia, SC","Metropolitan Statistical Area",2001,657438,8291,3616,9043,5427,5268,1030,4238,-593
"17900",NA,45017,"Calhoun County, SC","County or equivalent",2001,15261,37,33,192,159,21,7,14,-17
"17900",NA,45039,"Fairfield County, SC","County or equivalent",2001,23582,52,50,322,272,27,6,21,-25
"17900",NA,45055,"Kershaw County, SC","County or equivalent",2001,53335,500,263,777,514,283,17,266,-46
"17900",NA,45063,"Lexington County, SC","County or equivalent",2001,219784,2950,1321,3046,1725,1852,388,1464,-223
"17900",NA,45079,"Richland County, SC","County or equivalent",2001,326366,4820,1899,4454,2555,3182,481,2701,-261
"17900",NA,45081,"Saluda County, SC","County or equivalent",2001,19110,-68,50,252,202,-97,131,-228,-21
"17980",NA,NA,"Columbus, GA-AL","Metropolitan Statistical Area",2001,283391,1277,1660,4364,2704,-178,302,-480,-205
"17980",NA,1113,"Russell County, AL","County or equivalent",2001,49370,-290,63,658,595,-314,48,-362,-39
"17980",NA,13053,"Chattahoochee County, GA","County or equivalent",2001,15975,984,210,246,36,770,-39,809,4
"17980",NA,13145,"Harris County, GA","County or equivalent",2001,24320,524,89,295,206,448,12,436,-13
"17980",NA,13197,"Marion County, GA","County or equivalent",2001,7144,-34,22,95,73,-50,28,-78,-6
"17980",NA,13215,"Muscogee County, GA","County or equivalent",2001,186582,93,1276,3070,1794,-1032,253,-1285,-151
"18020",NA,NA,"Columbus, IN","Metropolitan Statistical Area",2001,71973,250,394,1006,612,-82,237,-319,-62
"18020",NA,18005,"Bartholomew County, IN","County or equivalent",2001,71973,250,394,1006,612,-82,237,-319,-62
"18140",NA,NA,"Columbus, OH","Metropolitan Statistical Area",2001,1641861,22356,12509,25127,12618,10319,4649,5670,-472
"18140",NA,39041,"Delaware County, OH","County or equivalent",2001,119083,7373,1205,1829,624,5242,65,5177,926
"18140",NA,39045,"Fairfield County, OH","County or equivalent",2001,125971,2551,630,1671,1041,2011,19,1992,-90
"18140",NA,39049,"Franklin County, OH","County or equivalent",2001,1082170,9883,9081,17371,8290,1862,4456,-2594,-1060
"18140",NA,39089,"Licking County, OH","County or equivalent",2001,147326,1255,724,2043,1319,669,58,611,-138
"18140",NA,39097,"Madison County, OH","County or equivalent",2001,40178,-34,135,501,366,-132,30,-162,-37
"18140",NA,39117,"Morrow County, OH","County or equivalent",2001,32390,596,171,437,266,445,4,441,-20
"18140",NA,39129,"Pickaway County, OH","County or equivalent",2001,52264,-552,180,638,458,-698,2,-700,-34
"18140",NA,39159,"Union County, OH","County or equivalent",2001,42479,1284,383,637,254,920,15,905,-19
"18580",NA,NA,"Corpus Christi, TX","Metropolitan Statistical Area",2001,401308,-1881,3335,6687,3352,-4943,531,-5474,-273
"18580",NA,48007,"Aransas County, TX","County or equivalent",2001,22514,-26,-31,258,289,25,37,-12,-20
"18580",NA,48355,"Nueces County, TX","County or equivalent",2001,311920,-1478,2670,5201,2531,-3936,480,-4416,-212
"18580",NA,48409,"San Patricio County, TX","County or equivalent",2001,66874,-377,696,1228,532,-1032,14,-1046,-41
"18700",NA,NA,"Corvallis, OR","Metropolitan Statistical Area",2001,78149,-38,316,779,463,-292,372,-664,-62
"18700",NA,41003,"Benton County, OR","County or equivalent",2001,78149,-38,316,779,463,-292,372,-664,-62
"19060",NA,NA,"Cumberland, MD-WV","Metropolitan Statistical Area",2001,101316,-529,-118,1078,1196,-318,21,-339,-93
"19060",NA,24001,"Allegany County, MD","County or equivalent",2001,74320,-487,-134,751,885,-286,14,-300,-67
"19060",NA,54057,"Mineral County, WV","County or equivalent",2001,26996,-42,16,327,311,-32,7,-39,-26
"19100",NA,NA,"Dallas-Fort Worth-Arlington, TX","Metropolitan Statistical Area",2001,5354746,158487,61650,94226,32576,93397,44845,48552,3440
"19100",19124,NA,"Dallas-Plano-Irving, TX","Metropolitan Division",2001,3591913,116689,43931,64685,20754,67816,34757,33059,4942
"19100",19124,48085,"Collin County, TX","County or equivalent",2001,537904,37706,7241,9127,1886,29855,3556,26299,610
"19100",19124,48113,"Dallas County, TX","County or equivalent",2001,2267698,42250,28649,43052,14403,9603,28299,-18696,3998
"19100",19124,48119,"Delta County, TX","County or equivalent",2001,5327,-10,-19,55,74,15,0,15,-6
"19100",19124,48121,"Denton County, TX","County or equivalent",2001,464792,25825,5897,7667,1770,19538,1976,17562,390
"19100",19124,48139,"Ellis County, TX","County or equivalent",2001,115704,3322,883,1805,922,2509,400,2109,-70
"19100",19124,48231,"Hunt County, TX","County or equivalent",2001,78216,1286,385,1088,703,963,214,749,-62
"19100",19124,48257,"Kaufman County, TX","County or equivalent",2001,75169,3087,486,1164,678,2562,208,2354,39
"19100",19124,48397,"Rockwall County, TX","County or equivalent",2001,47103,3223,409,727,318,2771,104,2667,43
"19100",23104,NA,"Fort Worth-Arlington, TX","Metropolitan Division",2001,1762833,41798,17719,29541,11822,25581,10088,15493,-1502
"19100",23104,48251,"Johnson County, TX","County or equivalent",2001,131675,3708,866,1927,1061,2920,268,2652,-78
"19100",23104,48367,"Parker County, TX","County or equivalent",2001,91640,2403,377,1097,720,2076,98,1978,-50
"19100",23104,48439,"Tarrant County, TX","County or equivalent",2001,1488537,34106,16177,25811,9634,19281,9613,9668,-1352
"19100",23104,48497,"Wise County, TX","County or equivalent",2001,50981,1581,299,706,407,1304,109,1195,-22
"19140",NA,NA,"Dalton, GA","Metropolitan Statistical Area",2001,123284,2423,1348,2300,952,1172,1046,126,-97
"19140",NA,13213,"Murray County, GA","County or equivalent",2001,37791,1017,305,572,267,738,69,669,-26
"19140",NA,13313,"Whitfield County, GA","County or equivalent",2001,85493,1406,1043,1728,685,434,977,-543,-71
"19180",NA,NA,"Danville, IL","Metropolitan Statistical Area",2001,83452,-347,244,1178,934,-524,52,-576,-67
"19180",NA,17183,"Vermilion County, IL","County or equivalent",2001,83452,-347,244,1178,934,-524,52,-576,-67
"19260",NA,NA,"Danville, VA","Metropolitan Statistical Area",2001,109351,-648,-44,1322,1366,-496,90,-586,-108
"19260",NA,51143,"Pittsylvania County, VA","County or equivalent",2001,61686,-58,136,745,609,-125,45,-170,-69
"19260",NA,51590,"Danville city, VA","County or equivalent",2001,47665,-590,-180,577,757,-371,45,-416,-39
"19340",NA,NA,"Davenport-Moline-Rock Island, IA-IL","Metropolitan Statistical Area",2001,374587,-1208,1477,5010,3533,-2374,549,-2923,-311
"19340",NA,17073,"Henry County, IL","County or equivalent",2001,50562,-487,26,571,545,-475,22,-497,-38
"19340",NA,17131,"Mercer County, IL","County or equivalent",2001,16904,-52,10,202,192,-47,4,-51,-15
"19340",NA,17161,"Rock Island County, IL","County or equivalent",2001,148620,-507,478,1979,1501,-859,287,-1146,-126
"19340",NA,19163,"Scott County, IA","County or equivalent",2001,158501,-162,963,2258,1295,-993,236,-1229,-132
"19380",NA,NA,"Dayton, OH","Metropolitan Statistical Area",2001,846005,-2051,3094,11242,8148,-5162,699,-5861,17
"19380",NA,39057,"Greene County, OH","County or equivalent",2001,149529,1322,504,1731,1227,250,212,38,568
"19380",NA,39109,"Miami County, OH","County or equivalent",2001,99096,124,305,1264,959,-87,59,-146,-94
"19380",NA,39113,"Montgomery County, OH","County or equivalent",2001,555097,-3419,2133,7731,5598,-5138,414,-5552,-414
"19380",NA,39135,"Preble County, OH","County or equivalent",2001,42283,-78,152,516,364,-187,14,-201,-43
"19460",NA,NA,"Decatur, AL","Metropolitan Statistical Area",2001,146271,231,581,1979,1398,-214,202,-416,-136
"19460",NA,1079,"Lawrence County, AL","County or equivalent",2001,34837,-20,94,450,356,-81,11,-92,-33
"19460",NA,1103,"Morgan County, AL","County or equivalent",2001,111434,251,487,1529,1042,-133,191,-324,-103
"19500",NA,NA,"Decatur, IL","Metropolitan Statistical Area",2001,113318,-1163,312,1466,1154,-1392,53,-1445,-83
"19500",NA,17115,"Macon County, IL","County or equivalent",2001,113318,-1163,312,1466,1154,-1392,53,-1445,-83
"19660",NA,NA,"Deltona-Daytona Beach-Ormond Beach, FL","Metropolitan Statistical Area",2001,451167,6155,-1204,4615,5819,7604,851,6753,-245
"19660",NA,12127,"Volusia County, FL","County or equivalent",2001,451167,6155,-1204,4615,5819,7604,851,6753,-245
"19740",NA,NA,"Denver-Aurora, CO /1","Metropolitan Statistical Area",2001,2246976,53094,22663,36107,13444,31163,14280,16883,-732
"19740",NA,8001,"Adams County, CO /1","County or equivalent",2001,360407,9462,3867,5919,2052,5878,2720,3158,-283
"19740",NA,8005,"Arapahoe County, CO /1","County or equivalent",2001,502853,11191,4511,7380,2869,7127,2863,4264,-447
"19740",NA,8014,"Broomfield County, CO /1","County or equivalent",2001,41450,1892,366,576,210,602,128,474,924
"19740",NA,8019,"Clear Creek County, CO /1","County or equivalent",2001,9401,91,72,109,37,32,2,30,-13
"19740",NA,8031,"Denver County, CO /1","County or equivalent",2001,564528,8461,6883,11400,4517,2083,6854,-4771,-505
"19740",NA,8035,"Douglas County, CO /1","County or equivalent",2001,197290,17000,3171,3656,485,13719,430,13289,110
"19740",NA,8039,"Elbert County, CO /1","County or equivalent",2001,21169,1071,165,248,83,909,9,900,-3
"19740",NA,8047,"Gilpin County, CO /1","County or equivalent",2001,4831,16,42,58,16,-21,2,-23,-5
"19740",NA,8059,"Jefferson County, CO /1","County or equivalent",2001,529702,3262,3476,6594,3118,293,1263,-970,-507
"19740",NA,8093,"Park County, CO /1","County or equivalent",2001,15345,648,110,167,57,541,9,532,-3
"19780",NA,NA,"Des Moines-West Des Moines, IA","Metropolitan Statistical Area",2001,490172,6999,3961,7601,3640,2754,1535,1219,284
"19780",NA,19049,"Dallas County, IA","County or equivalent",2001,42721,1652,254,552,298,1316,84,1232,82
"19780",NA,19077,"Guthrie County, IA","County or equivalent",2001,11222,-120,-19,120,139,-88,4,-92,-13
"19780",NA,19121,"Madison County, IA","County or equivalent",2001,14150,92,39,172,133,65,-1,66,-12
"19780",NA,19153,"Polk County, IA","County or equivalent",2001,381062,5137,3486,6247,2761,1383,1435,-52,268
"19780",NA,19181,"Warren County, IA","County or equivalent",2001,41017,238,201,510,309,78,13,65,-41
"19820",NA,NA,"Detroit-Warren-Livonia, MI","Metropolitan Statistical Area",2001,4477815,20308,22717,62537,39820,-11188,14021,-25209,8779
"19820",19804,NA,"Detroit-Livonia-Dearborn, MI","Metropolitan Division",2001,2058087,-647,10445,30885,20440,-21047,6416,-27463,9955
"19820",19804,26163,"Wayne County, MI","County or equivalent",2001,2058087,-647,10445,30885,20440,-21047,6416,-27463,9955
"19820",47644,NA,"Warren-Troy-Farmington Hills, MI","Metropolitan Division",2001,2419728,20955,12272,31652,19380,9859,7605,2254,-1176
"19820",47644,26087,"Lapeer County, MI","County or equivalent",2001,89241,937,510,1093,583,509,45,464,-82
"19820",47644,26093,"Livingston County, MI","County or equivalent",2001,163333,4906,1101,2017,916,3901,164,3737,-96
"19820",47644,26099,"Macomb County, MI","County or equivalent",2001,800000,9171,2949,10264,7315,6049,2123,3926,173
"19820",47644,26125,"Oakland County, MI","County or equivalent",2001,1201330,4842,7121,16192,9071,-1261,5176,-6437,-1018
"19820",47644,26147,"St. Clair County, MI","County or equivalent",2001,165824,1099,591,2086,1495,661,97,564,-153
"20020",NA,NA,"Dothan, AL","Metropolitan Statistical Area",2001,131256,199,495,1886,1391,-174,74,-248,-122
"20020",NA,1061,"Geneva County, AL","County or equivalent",2001,25527,-262,27,335,308,-271,8,-279,-18
"20020",NA,1067,"Henry County, AL","County or equivalent",2001,16303,-43,20,209,189,-48,10,-58,-15
"20020",NA,1069,"Houston County, AL","County or equivalent",2001,89426,504,448,1342,894,145,56,89,-89
"20100",NA,NA,"Dover, DE","Metropolitan Statistical Area",2001,128812,1702,876,1939,1063,950,134,816,-124
"20100",NA,10001,"Kent County, DE","County or equivalent",2001,128812,1702,876,1939,1063,950,134,816,-124
"20220",NA,NA,"Dubuque, IA","Metropolitan Statistical Area",2001,88988,-243,349,1195,846,-598,113,-711,6
"20220",NA,19061,"Dubuque County, IA","County or equivalent",2001,88988,-243,349,1195,846,-598,113,-711,6
"20260",NA,NA,"Duluth, MN-WI","Metropolitan Statistical Area",2001,276377,802,-108,2854,2962,1158,130,1028,-248
"20260",NA,27017,"Carlton County, MN","County or equivalent",2001,32014,291,60,387,327,258,15,243,-27
"20260",NA,27137,"St. Louis County, MN","County or equivalent",2001,200827,356,-250,1968,2218,787,86,701,-181
"20260",NA,55031,"Douglas County, WI","County or equivalent",2001,43536,155,82,499,417,113,29,84,-40
"20500",NA,NA,"Durham, NC","Metropolitan Statistical Area",2001,435230,9126,3101,6346,3245,6398,3323,3075,-373
"20500",NA,37037,"Chatham County, NC","County or equivalent",2001,51644,1919,214,682,468,1731,388,1343,-26
"20500",NA,37063,"Durham County, NC","County or equivalent",2001,229475,4857,2212,3910,1698,2859,2129,730,-214
"20500",NA,37135,"Orange County, NC","County or equivalent",2001,118214,2198,594,1304,710,1701,785,916,-97
"20500",NA,37145,"Person County, NC","County or equivalent",2001,35897,152,81,450,369,107,21,86,-36
"20740",NA,NA,"Eau Claire, WI","Metropolitan Statistical Area",2001,149697,1008,540,1777,1237,603,81,522,-135
"20740",NA,55017,"Chippewa County, WI","County or equivalent",2001,55681,355,132,672,540,271,18,253,-48
"20740",NA,55035,"Eau Claire County, WI","County or equivalent",2001,94016,653,408,1105,697,332,63,269,-87
"20940",NA,NA,"El Centro, CA","Metropolitan Statistical Area",2001,143177,766,1708,2583,875,-847,1171,-2018,-95
"20940",NA,6025,"Imperial County, CA","County or equivalent",2001,143177,766,1708,2583,875,-847,1171,-2018,-95
"21060",NA,NA,"Elizabethtown, KY","Metropolitan Statistical Area",2001,108081,391,780,1624,844,-289,72,-361,-100
"21060",NA,21093,"Hardin County, KY","County or equivalent",2001,94700,410,751,1464,713,-254,71,-325,-87
"21060",NA,21123,"Larue County, KY","County or equivalent",2001,13381,-19,29,160,131,-35,1,-36,-13
"21140",NA,NA,"Elkhart-Goshen, IN","Metropolitan Statistical Area",2001,185033,1511,1936,3311,1375,-268,925,-1193,-157
"21140",NA,18039,"Elkhart County, IN","County or equivalent",2001,185033,1511,1936,3311,1375,-268,925,-1193,-157
"21300",NA,NA,"Elmira, NY","Metropolitan Statistical Area",2001,90671,-406,220,1130,910,-553,45,-598,-73
"21300",NA,36015,"Chemung County, NY","County or equivalent",2001,90671,-406,220,1130,910,-553,45,-598,-73
"21340",NA,NA,"El Paso, TX","Metropolitan Statistical Area",2001,685035,4009,10126,14220,4094,-5702,4703,-10405,-415
"21340",NA,48141,"El Paso County, TX","County or equivalent",2001,685035,4009,10126,14220,4094,-5702,4703,-10405,-415
"21500",NA,NA,"Erie, PA","Metropolitan Statistical Area",2001,281481,766,794,3476,2682,-1016,426,-1442,988
"21500",NA,42049,"Erie County, PA","County or equivalent",2001,281481,766,794,3476,2682,-1016,426,-1442,988
"21660",NA,NA,"Eugene-Springfield, OR","Metropolitan Statistical Area",2001,324822,1337,825,3653,2828,843,751,92,-331
"21660",NA,41039,"Lane County, OR","County or equivalent",2001,324822,1337,825,3653,2828,843,751,92,-331
"21780",NA,NA,"Evansville, IN-KY","Metropolitan Statistical Area",2001,342972,-26,960,4495,3535,-659,226,-885,-327
"21780",NA,18051,"Gibson County, IN","County or equivalent",2001,32622,91,49,408,359,72,16,56,-30
"21780",NA,18129,"Posey County, IN","County or equivalent",2001,26938,-126,23,278,255,-120,9,-129,-29
"21780",NA,18163,"Vanderburgh County, IN","County or equivalent",2001,171978,20,468,2355,1887,-292,139,-431,-156
"21780",NA,18173,"Warrick County, IN","County or equivalent",2001,52694,176,249,692,443,-17,15,-32,-56
"21780",NA,21101,"Henderson County, KY","County or equivalent",2001,44784,-31,139,580,441,-125,23,-148,-45
"21780",NA,21233,"Webster County, KY","County or equivalent",2001,13956,-156,32,182,150,-177,24,-201,-11
"21820",NA,NA,"Fairbanks, AK","Metropolitan Statistical Area",2001,85293,2524,1197,1547,350,123,42,81,1204
"21820",NA,2090,"Fairbanks North Star Borough, AK","County or equivalent",2001,85293,2524,1197,1547,350,123,42,81,1204
"22020",NA,NA,"Fargo, ND-MN","Metropolitan Statistical Area",2001,176249,1473,1040,2208,1168,603,376,227,-170
"22020",NA,27027,"Clay County, MN","County or equivalent",2001,51370,79,79,461,382,50,39,11,-50
"22020",NA,38017,"Cass County, ND","County or equivalent",2001,124879,1394,961,1747,786,553,337,216,-120
"22140",NA,NA,"Farmington, NM","Metropolitan Statistical Area",2001,115128,1086,1185,1945,760,15,134,-119,-114
"22140",NA,35045,"San Juan County, NM","County or equivalent",2001,115128,1086,1185,1945,760,15,134,-119,-114
"22180",NA,NA,"Fayetteville, NC","Metropolitan Statistical Area",2001,338080,1215,4006,6240,2234,-2523,39,-2562,-268
"22180",NA,37051,"Cumberland County, NC","County or equivalent",2001,303479,461,3563,5545,1982,-2866,-87,-2779,-236
"22180",NA,37093,"Hoke County, NC","County or equivalent",2001,34601,754,443,695,252,343,126,217,-32
"22220",NA,NA,"Fayetteville-Springdale-Rogers, AR-MO","Metropolitan Statistical Area",2001,358379,8854,2719,5517,2798,6144,1569,4575,-9
"22220",NA,5007,"Benton County, AR","County or equivalent",2001,159255,4477,1122,2403,1281,3423,541,2882,-68
"22220",NA,5087,"Madison County, AR","County or equivalent",2001,14303,8,21,174,153,2,17,-15,-15
"22220",NA,5143,"Washington County, AR","County or equivalent",2001,163154,4366,1421,2596,1175,2852,920,1932,93
"22220",NA,29119,"McDonald County, MO","County or equivalent",2001,21667,3,155,344,189,-133,91,-224,-19
"22380",NA,NA,"Flagstaff, AZ","Metropolitan Statistical Area",2001,117771,1068,1321,1847,526,-137,220,-357,-116
"22380",NA,4005,"Coconino County, AZ","County or equivalent",2001,117771,1068,1321,1847,526,-137,220,-357,-116
"22420",NA,NA,"Flint, MI","Metropolitan Statistical Area",2001,437844,981,2441,6369,3928,-1057,184,-1241,-403
"22420",NA,26049,"Genesee County, MI","County or equivalent",2001,437844,981,2441,6369,3928,-1057,184,-1241,-403
"22500",NA,NA,"Florence, SC","Metropolitan Statistical Area",2001,193785,519,703,2787,2084,12,103,-91,-196
"22500",NA,45031,"Darlington County, SC","County or equivalent",2001,67551,111,146,924,778,31,27,4,-66
"22500",NA,45041,"Florence County, SC","County or equivalent",2001,126234,408,557,1863,1306,-19,76,-95,-130
"22520",NA,NA,"Florence-Muscle Shoals, AL","Metropolitan Statistical Area",2001,142224,-786,30,1633,1603,-684,60,-744,-132
"22520",NA,1033,"Colbert County, AL","County or equivalent",2001,54837,-188,-42,612,654,-90,15,-105,-56
"22520",NA,1077,"Lauderdale County, AL","County or equivalent",2001,87387,-598,72,1021,949,-594,45,-639,-76
"22540",NA,NA,"Fond du Lac, WI","Metropolitan Statistical Area",2001,97729,346,233,1135,902,218,110,108,-105
"22540",NA,55039,"Fond du Lac County, WI","County or equivalent",2001,97729,346,233,1135,902,218,110,108,-105
"22660",NA,NA,"Fort Collins-Loveland, CO","Metropolitan Statistical Area",2001,260717,7586,1794,3320,1526,5938,661,5277,-146
"22660",NA,8069,"Larimer County, CO","County or equivalent",2001,260717,7586,1794,3320,1526,5938,661,5277,-146
"22900",NA,NA,"Fort Smith, AR-OK","Metropolitan Statistical Area",2001,275436,1622,1359,4140,2781,513,599,-86,-250
"22900",NA,5033,"Crawford County, AR","County or equivalent",2001,54101,723,306,799,493,464,29,435,-47
"22900",NA,5047,"Franklin County, AR","County or equivalent",2001,17825,78,29,224,195,66,12,54,-17
"22900",NA,5131,"Sebastian County, AR","County or equivalent",2001,116247,734,668,1804,1136,176,435,-259,-110
"22900",NA,40079,"Le Flore County, OK","County or equivalent",2001,48028,-100,231,783,552,-294,106,-400,-37
"22900",NA,40135,"Sequoyah County, OK","County or equivalent",2001,39235,187,125,530,405,101,17,84,-39
"23020",NA,NA,"Fort Walton Beach-Crestview-Destin, FL","Metropolitan Statistical Area",2001,171929,971,906,2366,1460,234,72,162,-169
"23020",NA,12091,"Okaloosa County, FL","County or equivalent",2001,171929,971,906,2366,1460,234,72,162,-169
"23060",NA,NA,"Fort Wayne, IN","Metropolitan Statistical Area",2001,393469,2446,3046,6134,3088,-236,834,-1070,-364
"23060",NA,18003,"Allen County, IN","County or equivalent",2001,334823,2128,2755,5319,2564,-318,818,-1136,-309
"23060",NA,18179,"Wells County, IN","County or equivalent",2001,27604,3,108,370,262,-81,3,-84,-24
"23060",NA,18183,"Whitley County, IN","County or equivalent",2001,31042,315,183,445,262,163,13,150,-31
"23420",NA,NA,"Fresno, CA","Metropolitan Statistical Area",2001,813476,11353,8748,14226,5478,3383,5117,-1734,-778
"23420",NA,6019,"Fresno County, CA","County or equivalent",2001,813476,11353,8748,14226,5478,3383,5117,-1734,-778
"23460",NA,NA,"Gadsden, AL","Metropolitan Statistical Area",2001,102882,-426,14,1365,1351,-349,92,-441,-91
"23460",NA,1055,"Etowah County, AL","County or equivalent",2001,102882,-426,14,1365,1351,-349,92,-441,-91
"23540",NA,NA,"Gainesville, FL","Metropolitan Statistical Area",2001,235839,2724,997,2677,1680,1939,873,1066,-212
"23540",NA,12001,"Alachua County, FL","County or equivalent",2001,221282,2705,982,2501,1519,1919,864,1055,-196
"23540",NA,12041,"Gilchrist County, FL","County or equivalent",2001,14557,19,15,176,161,20,9,11,-16
"23580",NA,NA,"Gainesville, GA","Metropolitan Statistical Area",2001,146798,5919,1837,2858,1021,4016,1771,2245,66
"23580",NA,13139,"Hall County, GA","County or equivalent",2001,146798,5919,1837,2858,1021,4016,1771,2245,66
"24020",NA,NA,"Glens Falls, NY","Metropolitan Statistical Area",2001,124653,304,10,1249,1239,418,41,377,-124
"24020",NA,36113,"Warren County, NY","County or equivalent",2001,63566,201,-6,642,648,268,29,239,-61
"24020",NA,36115,"Washington County, NY","County or equivalent",2001,61087,103,16,607,591,150,12,138,-63
"24140",NA,NA,"Goldsboro, NC","Metropolitan Statistical Area",2001,112894,-400,685,1758,1073,-1000,224,-1224,-85
"24140",NA,37191,"Wayne County, NC","County or equivalent",2001,112894,-400,685,1758,1073,-1000,224,-1224,-85
"24220",NA,NA,"Grand Forks, ND-MN","Metropolitan Statistical Area",2001,96413,-915,339,1154,815,-1191,116,-1307,-63
"24220",NA,27119,"Polk County, MN","County or equivalent",2001,31028,-353,-69,301,370,-261,19,-280,-23
"24220",NA,38035,"Grand Forks County, ND","County or equivalent",2001,65385,-562,408,853,445,-930,97,-1027,-40
"24300",NA,NA,"Grand Junction, CO","Metropolitan Statistical Area",2001,119284,1798,328,1513,1185,1582,131,1451,-112
"24300",NA,8077,"Mesa County, CO","County or equivalent",2001,119284,1798,328,1513,1185,1582,131,1451,-112
"24340",NA,NA,"Grand Rapids-Wyoming, MI","Metropolitan Statistical Area",2001,750079,7041,6177,11736,5559,1560,2366,-806,-696
"24340",NA,26015,"Barry County, MI","County or equivalent",2001,57443,540,228,703,475,361,11,350,-49
"24340",NA,26067,"Ionia County, MI","County or equivalent",2001,61906,229,370,864,494,-82,24,-106,-59
"24340",NA,26081,"Kent County, MI","County or equivalent",2001,582144,5688,5345,9522,4177,891,2290,-1399,-548
"24340",NA,26123,"Newaygo County, MI","County or equivalent",2001,48586,584,234,647,413,390,41,349,-40
"24500",NA,NA,"Great Falls, MT","Metropolitan Statistical Area",2001,80380,180,253,1044,791,-535,-6,-529,462
"24500",NA,30013,"Cascade County, MT","County or equivalent",2001,80380,180,253,1044,791,-535,-6,-529,462
"24540",NA,NA,"Greeley, CO /1","Metropolitan Statistical Area",2001,193077,10041,1999,3205,1206,8058,966,7092,-16
"24540",NA,8123,"Weld County, CO /1","County or equivalent",2001,193077,10041,1999,3205,1206,8058,966,7092,-16
"24580",NA,NA,"Green Bay, WI","Metropolitan Statistical Area",2001,285833,2514,1690,3823,2133,1103,520,583,-279
"24580",NA,55009,"Brown County, WI","County or equivalent",2001,229483,2163,1626,3195,1569,766,504,262,-229
"24580",NA,55061,"Kewaunee County, WI","County or equivalent",2001,20258,60,44,246,202,36,14,22,-20
"24580",NA,55083,"Oconto County, WI","County or equivalent",2001,36092,291,20,382,362,301,2,299,-30
"24660",NA,NA,"Greensboro-High Point, NC","Metropolitan Statistical Area",2001,652193,6763,3505,9111,5606,3876,2980,896,-618
"24660",NA,37081,"Guilford County, NC","County or equivalent",2001,427979,5522,2557,6016,3459,3370,2095,1275,-405
"24660",NA,37151,"Randolph County, NC","County or equivalent",2001,132197,1183,781,1908,1127,531,675,-144,-129
"24660",NA,37157,"Rockingham County, NC","County or equivalent",2001,92017,58,167,1187,1020,-25,210,-235,-84
"24780",NA,NA,"Greenville, NC","Metropolitan Statistical Area",2001,155002,1840,990,2224,1234,995,414,581,-145
"24780",NA,37079,"Greene County, NC","County or equivalent",2001,19172,151,71,244,173,100,95,5,-20
"24780",NA,37147,"Pitt County, NC","County or equivalent",2001,135830,1689,919,1980,1061,895,319,576,-125
"24860",NA,NA,"Greenville-Mauldin-Easley, SC","Metropolitan Statistical Area",2001,567649,5778,2372,7462,5090,3918,1687,2231,-512
"24860",NA,45045,"Greenville County, SC","County or equivalent",2001,386183,5093,1880,5352,3472,3549,1358,2191,-336
"24860",NA,45059,"Laurens County, SC","County or equivalent",2001,69972,280,73,815,742,276,93,183,-69
"24860",NA,45077,"Pickens County, SC","County or equivalent",2001,111494,405,419,1295,876,93,236,-143,-107
"25060",NA,NA,"Gulfport-Biloxi, MS","Metropolitan Statistical Area",2001,248147,1313,1341,3693,2352,179,124,55,-207
"25060",NA,28045,"Hancock County, MS","County or equivalent",2001,43848,574,87,551,464,521,13,508,-34
"25060",NA,28047,"Harrison County, MS","County or equivalent",2001,190232,360,1193,2940,1747,-666,110,-776,-167
"25060",NA,28131,"Stone County, MS","County or equivalent",2001,14067,379,61,202,141,324,1,323,-6
"25180",NA,NA,"Hagerstown-Martinsburg, MD-WV","Metropolitan Statistical Area",2001,226707,3184,703,2809,2106,2645,107,2538,-164
"25180",NA,24043,"Washington County, MD","County or equivalent",2001,132982,884,332,1614,1282,670,79,591,-118
"25180",NA,54003,"Berkeley County, WV","County or equivalent",2001,78573,2160,372,1048,676,1823,18,1805,-35
"25180",NA,54065,"Morgan County, WV","County or equivalent",2001,15152,140,-1,147,148,152,10,142,-11
"25260",NA,NA,"Hanford-Corcoran, CA","Metropolitan Statistical Area",2001,132502,2726,1508,2223,715,1332,566,766,-114
"25260",NA,6031,"Kings County, CA","County or equivalent",2001,132502,2726,1508,2223,715,1332,566,766,-114
"25420",NA,NA,"Harrisburg-Carlisle, PA","Metropolitan Statistical Area",2001,510338,942,1123,5972,4849,290,792,-502,-471
"25420",NA,42041,"Cumberland County, PA","County or equivalent",2001,215055,1068,199,2228,2029,1076,318,758,-207
"25420",NA,42043,"Dauphin County, PA","County or equivalent",2001,251534,-263,719,3184,2465,-765,470,-1235,-217
"25420",NA,42099,"Perry County, PA","County or equivalent",2001,43749,137,205,560,355,-21,4,-25,-47
"25500",NA,NA,"Harrisonburg, VA","Metropolitan Statistical Area",2001,109841,1558,518,1383,865,942,420,522,98
"25500",NA,51165,"Rockingham County, VA","County or equivalent",2001,68557,711,347,895,548,225,139,86,139
"25500",NA,51660,"Harrisonburg city, VA","County or equivalent",2001,41284,847,171,488,317,717,281,436,-41
"25540",NA,NA,"Hartford-West Hartford-East Hartford, CT","Metropolitan Statistical Area",2001,1156929,6023,3414,13993,10579,3718,3837,-119,-1109
"25540",NA,9003,"Hartford County, CT","County or equivalent",2001,861209,2770,2383,10648,8265,1230,3328,-2098,-843
"25540",NA,9007,"Middlesex County, CT","County or equivalent",2001,157020,1405,425,1825,1400,1122,260,862,-142
"25540",NA,9013,"Tolland County, CT","County or equivalent",2001,138700,1848,606,1520,914,1366,249,1117,-124
"25620",NA,NA,"Hattiesburg, MS","Metropolitan Statistical Area",2001,125348,1018,725,1854,1129,416,120,296,-123
"25620",NA,28035,"Forrest County, MS","County or equivalent",2001,73227,408,379,1088,709,104,113,-9,-75
"25620",NA,28073,"Lamar County, MS","County or equivalent",2001,39952,617,312,590,278,340,8,332,-35
"25620",NA,28111,"Perry County, MS","County or equivalent",2001,12169,-7,34,176,142,-28,-1,-27,-13
"25860",NA,NA,"Hickory-Lenoir-Morganton, NC","Metropolitan Statistical Area",2001,346722,3619,1444,4659,3215,2202,1037,1165,-27
"25860",NA,37003,"Alexander County, NC","County or equivalent",2001,33982,310,141,439,298,199,49,150,-30
"25860",NA,37023,"Burke County, NC","County or equivalent",2001,89285,-31,280,1089,809,-233,228,-461,-78
"25860",NA,37027,"Caldwell County, NC","County or equivalent",2001,78156,542,261,1024,763,85,102,-17,196
"25860",NA,37035,"Catawba County, NC","County or equivalent",2001,145299,2798,762,2107,1345,2151,658,1493,-115
"25980",NA,NA,"Hinesville-Fort Stewart, GA","Metropolitan Statistical Area",2001,70807,-985,1253,1606,353,-2220,30,-2250,-18
"25980",NA,13179,"Liberty County, GA","County or equivalent",2001,60410,-1031,1150,1434,284,-2175,-10,-2165,-6
"25980",NA,13183,"Long County, GA","County or equivalent",2001,10397,46,103,172,69,-45,40,-85,-12
"26100",NA,NA,"Holland-Grand Haven, MI","Metropolitan Statistical Area",2001,243438,3976,2226,3659,1433,1969,373,1596,-219
"26100",NA,26139,"Ottawa County, MI","County or equivalent",2001,243438,3976,2226,3659,1433,1969,373,1596,-219
"26180",NA,NA,"Honolulu, HI","Metropolitan Statistical Area",2001,877024,1970,6823,12751,5928,-4175,3937,-8112,-678
"26180",NA,15003,"Honolulu County, HI","County or equivalent",2001,877024,1970,6823,12751,5928,-4175,3937,-8112,-678
"26300",NA,NA,"Hot Springs, AR","Metropolitan Statistical Area",2001,89298,950,-226,992,1218,1231,70,1161,-55
"26300",NA,5051,"Garland County, AR","County or equivalent",2001,89298,950,-226,992,1218,1231,70,1161,-55
"26380",NA,NA,"Houma-Bayou Cane-Thibodaux, LA","Metropolitan Statistical Area",2001,194764,337,1357,2963,1606,-851,117,-968,-169
"26380",NA,22057,"Lafourche Parish, LA","County or equivalent",2001,90040,68,425,1185,760,-276,60,-336,-81
"26380",NA,22109,"Terrebonne Parish, LA","County or equivalent",2001,104724,269,932,1778,846,-575,57,-632,-88
"26420",NA,NA,"Houston-Sugar Land-Baytown, TX","Metropolitan Statistical Area",2001,4851949,112324,54101,83630,29529,45342,40772,4570,12881
"26420",NA,48015,"Austin County, TX","County or equivalent",2001,24185,443,32,330,298,434,65,369,-23
"26420",NA,48039,"Brazoria County, TX","County or equivalent",2001,248339,5209,2512,4112,1600,2891,757,2134,-194
"26420",NA,48071,"Chambers County, TX","County or equivalent",2001,26551,386,99,279,180,309,61,248,-22
"26420",NA,48157,"Fort Bend County, TX","County or equivalent",2001,375211,16453,3826,5290,1464,12270,1998,10272,357
"26420",NA,48167,"Galveston County, TX","County or equivalent",2001,254563,3855,1631,3800,2169,2449,862,1587,-225
"26420",NA,48201,"Harris County, TX","County or equivalent",2001,3483800,69869,42706,63300,20594,14216,35512,-21296,12947
"26420",NA,48291,"Liberty County, TX","County or equivalent",2001,71641,1081,348,1026,678,788,114,674,-55
"26420",NA,48339,"Montgomery County, TX","County or equivalent",2001,311689,14348,2615,4703,2088,11582,1262,10320,151
"26420",NA,48407,"San Jacinto County, TX","County or equivalent",2001,22761,309,66,283,217,263,25,238,-20
"26420",NA,48473,"Waller County, TX","County or equivalent",2001,33209,371,266,507,241,140,116,24,-35
"26580",NA,NA,"Huntington-Ashland, WV-KY-OH","Metropolitan Statistical Area",2001,286998,-1359,152,3492,3340,-1254,81,-1335,-257
"26580",NA,21019,"Boyd County, KY","County or equivalent",2001,49480,-183,-21,561,582,-111,9,-120,-51
"26580",NA,21089,"Greenup County, KY","County or equivalent",2001,36897,65,38,437,399,65,0,65,-38
"26580",NA,39087,"Lawrence County, OH","County or equivalent",2001,61988,-264,48,780,732,-256,13,-269,-56
"26580",NA,54011,"Cabell County, WV","County or equivalent",2001,95934,-776,39,1210,1171,-740,50,-790,-75
"26580",NA,54099,"Wayne County, WV","County or equivalent",2001,42699,-201,48,504,456,-212,9,-221,-37
"26620",NA,NA,"Huntsville, AL","Metropolitan Statistical Area",2001,347754,3987,1869,4628,2759,2083,537,1546,35
"26620",NA,1083,"Limestone County, AL","County or equivalent",2001,66619,707,366,923,557,397,42,355,-56
"26620",NA,1089,"Madison County, AL","County or equivalent",2001,281135,3280,1503,3705,2202,1686,495,1191,91
"26820",NA,NA,"Idaho Falls, ID","Metropolitan Statistical Area",2001,102916,846,1129,1854,725,-185,159,-344,-98
"26820",NA,16019,"Bonneville County, ID","County or equivalent",2001,83651,793,884,1483,599,-6,108,-114,-85
"26820",NA,16051,"Jefferson County, ID","County or equivalent",2001,19265,53,245,371,126,-179,51,-230,-13
"26900",NA,NA,"Indianapolis-Carmel, IN","Metropolitan Statistical Area",2001,1555700,24621,11866,24521,12655,12379,3183,9196,376
"26900",NA,18011,"Boone County, IN","County or equivalent",2001,47086,707,236,657,421,515,18,497,-44
"26900",NA,18013,"Brown County, IN","County or equivalent",2001,15114,128,50,158,108,91,8,83,-13
"26900",NA,18057,"Hamilton County, IN","County or equivalent",2001,196259,10972,2305,3292,987,7462,308,7154,1205
"26900",NA,18059,"Hancock County, IN","County or equivalent",2001,56594,932,267,711,444,709,5,704,-44
"26900",NA,18063,"Hendricks County, IN","County or equivalent",2001,109885,4520,818,1524,706,3741,73,3668,-39
"26900",NA,18081,"Johnson County, IN","County or equivalent",2001,118733,2795,663,1625,962,1899,93,1806,233
"26900",NA,18097,"Marion County, IN","County or equivalent",2001,864855,3947,6761,14574,7813,-2037,2576,-4613,-777
"26900",NA,18109,"Morgan County, IN","County or equivalent",2001,67171,285,390,937,547,-39,14,-53,-66
"26900",NA,18133,"Putnam County, IN","County or equivalent",2001,36177,64,101,399,298,-2,16,-18,-35
"26900",NA,18145,"Shelby County, IN","County or equivalent",2001,43826,271,275,644,369,40,72,-32,-44
"26980",NA,NA,"Iowa City, IA","Metropolitan Statistical Area",2001,134854,2692,968,1672,704,1508,567,941,216
"26980",NA,19103,"Johnson County, IA","County or equivalent",2001,113849,2388,875,1362,487,1279,550,729,234
"26980",NA,19183,"Washington County, IA","County or equivalent",2001,21005,304,93,310,217,229,17,212,-18
"27060",NA,NA,"Ithaca, NY","Metropolitan Statistical Area",2001,97572,916,218,828,610,799,730,69,-101
"27060",NA,36109,"Tompkins County, NY","County or equivalent",2001,97572,916,218,828,610,799,730,69,-101
"27100",NA,NA,"Jackson, MI","Metropolitan Statistical Area",2001,159761,1022,614,2043,1429,555,106,449,-147
"27100",NA,26075,"Jackson County, MI","County or equivalent",2001,159761,1022,614,2043,1429,555,106,449,-147
"27140",NA,NA,"Jackson, MS","Metropolitan Statistical Area",2001,501164,2910,3415,7778,4363,-60,296,-356,-445
"27140",NA,28029,"Copiah County, MS","County or equivalent",2001,28831,69,140,454,314,-43,3,-46,-28
"27140",NA,28049,"Hinds County, MS","County or equivalent",2001,249426,-1170,1846,3920,2074,-2804,126,-2930,-212
"27140",NA,28089,"Madison County, MS","County or equivalent",2001,76527,1461,454,1273,819,1102,50,1052,-95
"27140",NA,28121,"Rankin County, MS","County or equivalent",2001,118947,2773,896,1726,830,1965,100,1865,-88
"27140",NA,28127,"Simpson County, MS","County or equivalent",2001,27433,-223,79,405,326,-280,17,-297,-22
"27180",NA,NA,"Jackson, TN","Metropolitan Statistical Area",2001,108788,1220,502,1546,1044,810,153,657,-92
"27180",NA,47023,"Chester County, TN","County or equivalent",2001,15828,275,-5,174,179,289,2,287,-9
"27180",NA,47113,"Madison County, TN","County or equivalent",2001,92960,945,507,1372,865,521,151,370,-83
"27260",NA,NA,"Jacksonville, FL","Metropolitan Statistical Area",2001,1147922,21740,6481,16378,9897,16119,1955,14164,-860
"27260",NA,12003,"Baker County, FL","County or equivalent",2001,22558,184,168,346,178,38,4,34,-22
"27260",NA,12019,"Clay County, FL","County or equivalent",2001,145456,3835,722,1837,1115,3213,146,3067,-100
"27260",NA,12031,"Duval County, FL","County or equivalent",2001,791001,11239,5214,12172,6958,6693,1630,5063,-668
"27260",NA,12089,"Nassau County, FL","County or equivalent",2001,59123,1168,235,736,501,986,38,948,-53
"27260",NA,12109,"St. Johns County, FL","County or equivalent",2001,129784,5314,142,1287,1145,5189,137,5052,-17
"27340",NA,NA,"Jacksonville, NC","Metropolitan Statistical Area",2001,149664,-112,2423,3253,830,-2431,-390,-2041,-104
"27340",NA,37133,"Onslow County, NC","County or equivalent",2001,149664,-112,2423,3253,830,-2431,-390,-2041,-104
"27500",NA,NA,"Janesville, WI","Metropolitan Statistical Area",2001,153156,660,743,2071,1328,63,281,-218,-146
"27500",NA,55105,"Rock County, WI","County or equivalent",2001,153156,660,743,2071,1328,63,281,-218,-146
"27620",NA,NA,"Jefferson City, MO","Metropolitan Statistical Area",2001,140901,584,489,1740,1251,222,129,93,-127
"27620",NA,29027,"Callaway County, MO","County or equivalent",2001,41491,566,180,513,333,418,26,392,-32
"27620",NA,29051,"Cole County, MO","County or equivalent",2001,71600,124,263,876,613,-73,98,-171,-66
"27620",NA,29135,"Moniteau County, MO","County or equivalent",2001,14753,-82,23,193,170,-88,4,-92,-17
"27620",NA,29151,"Osage County, MO","County or equivalent",2001,13057,-24,23,158,135,-35,1,-36,-12
"27740",NA,NA,"Johnson City, TN","Metropolitan Statistical Area",2001,182076,80,17,2013,1996,248,128,120,-185
"27740",NA,47019,"Carter County, TN","County or equivalent",2001,56869,34,-75,557,632,162,21,141,-53
"27740",NA,47171,"Unicoi County, TN","County or equivalent",2001,17557,-108,-63,177,240,-25,-1,-24,-20
"27740",NA,47179,"Washington County, TN","County or equivalent",2001,107650,154,155,1279,1124,111,108,3,-112
"27780",NA,NA,"Johnstown, PA","Metropolitan Statistical Area",2001,150968,-1241,-506,1524,2030,-596,46,-642,-139
"27780",NA,42021,"Cambria County, PA","County or equivalent",2001,150968,-1241,-506,1524,2030,-596,46,-642,-139
"27860",NA,NA,"Jonesboro, AR","Metropolitan Statistical Area",2001,108785,646,528,1556,1028,221,134,87,-103
"27860",NA,5031,"Craighead County, AR","County or equivalent",2001,83273,753,464,1196,732,370,118,252,-81
"27860",NA,5111,"Poinsett County, AR","County or equivalent",2001,25512,-107,64,360,296,-149,16,-165,-22
"27900",NA,NA,"Joplin, MO","Metropolitan Statistical Area",2001,158596,886,809,2446,1637,238,199,39,-161
"27900",NA,29097,"Jasper County, MO","County or equivalent",2001,105822,818,633,1725,1092,290,166,124,-105
"27900",NA,29145,"Newton County, MO","County or equivalent",2001,52774,68,176,721,545,-52,33,-85,-56
"28020",NA,NA,"Kalamazoo-Portage, MI","Metropolitan Statistical Area",2001,316722,1345,1571,4208,2637,76,619,-543,-302
"28020",NA,26077,"Kalamazoo County, MI","County or equivalent",2001,239993,967,1153,3140,1987,40,552,-512,-226
"28020",NA,26159,"Van Buren County, MI","County or equivalent",2001,76729,378,418,1068,650,36,67,-31,-76
"28100",NA,NA,"Kankakee-Bradley, IL","Metropolitan Statistical Area",2001,104805,929,384,1538,1154,312,150,162,233
"28100",NA,17091,"Kankakee County, IL","County or equivalent",2001,104805,929,384,1538,1154,312,150,162,233
"28140",NA,NA,"Kansas City, MO-KS","Metropolitan Statistical Area",2001,1863707,20893,12391,27842,15451,8744,4450,4294,-242
"28140",NA,20059,"Franklin County, KS","County or equivalent",2001,25145,294,89,352,263,96,18,78,109
"28140",NA,20091,"Johnson County, KS","County or equivalent",2001,463878,9273,4210,7011,2801,5457,1369,4088,-394
"28140",NA,20103,"Leavenworth County, KS","County or equivalent",2001,69798,876,412,906,494,524,28,496,-60
"28140",NA,20107,"Linn County, KS","County or equivalent",2001,9718,113,-2,116,118,123,0,123,-8
"28140",NA,20121,"Miami County, KS","County or equivalent",2001,28592,82,133,403,270,-23,7,-30,-28
"28140",NA,20209,"Wyandotte County, KS","County or equivalent",2001,158265,409,1222,2793,1571,-674,1035,-1709,-139
"28140",NA,29013,"Bates County, MO","County or equivalent",2001,16774,72,-11,206,217,98,9,89,-15
"28140",NA,29025,"Caldwell County, MO","County or equivalent",2001,8987,10,-9,108,117,28,0,28,-9
"28140",NA,29037,"Cass County, MO","County or equivalent",2001,84568,1972,387,1143,756,1648,50,1598,-63
"28140",NA,29047,"Clay County, MO","County or equivalent",2001,188205,3399,1364,2805,1441,2185,263,1922,-150
"28140",NA,29049,"Clinton County, MO","County or equivalent",2001,19396,365,32,240,208,358,1,357,-25
"28140",NA,29095,"Jackson County, MO","County or equivalent",2001,658104,2384,3968,10064,6096,-2235,1517,-3752,651
"28140",NA,29107,"Lafayette County, MO","County or equivalent",2001,32869,-144,7,383,376,-122,8,-130,-29
"28140",NA,29165,"Platte County, MO","County or equivalent",2001,76016,1770,530,1033,503,1299,146,1153,-59
"28140",NA,29177,"Ray County, MO","County or equivalent",2001,23392,18,59,279,220,-18,-1,-17,-23
"28420",NA,NA,"Kennewick-Pasco-Richland, WA","Metropolitan Statistical Area",2001,196345,3654,1961,3259,1298,1869,1171,698,-176
"28420",NA,53005,"Benton County, WA","County or equivalent",2001,145574,2489,1117,2116,999,1500,539,961,-128
"28420",NA,53021,"Franklin County, WA","County or equivalent",2001,50771,1165,844,1143,299,369,632,-263,-48
"28660",NA,NA,"Killeen-Temple-Fort Hood, TX","Metropolitan Statistical Area",2001,334434,2422,4655,6713,2058,-2498,152,-2650,265
"28660",NA,48027,"Bell County, TX","County or equivalent",2001,242546,3423,3930,5462,1532,-816,239,-1055,309
"28660",NA,48099,"Coryell County, TX","County or equivalent",2001,73764,-1248,696,1030,334,-1913,-117,-1796,-31
"28660",NA,48281,"Lampasas County, TX","County or equivalent",2001,18124,247,29,221,192,231,30,201,-13
"28700",NA,NA,"Kingsport-Bristol-Bristol, TN-VA","Metropolitan Statistical Area",2001,298214,-224,39,3353,3314,6,136,-130,-269
"28700",NA,47073,"Hawkins County, TN","County or equivalent",2001,54148,458,131,647,516,372,19,353,-45
"28700",NA,47163,"Sullivan County, TN","County or equivalent",2001,152411,-508,17,1767,1750,-389,96,-485,-136
"28700",NA,51169,"Scott County, VA","County or equivalent",2001,23096,-268,-85,234,319,-164,4,-168,-19
"28700",NA,51191,"Washington County, VA","County or equivalent",2001,51204,56,30,501,471,78,11,67,-52
"28700",NA,51520,"Bristol city, VA","County or equivalent",2001,17355,38,-54,204,258,109,6,103,-17
"28740",NA,NA,"Kingston, NY","Metropolitan Statistical Area",2001,178312,431,136,1746,1610,464,207,257,-169
"28740",NA,36111,"Ulster County, NY","County or equivalent",2001,178312,431,136,1746,1610,464,207,257,-169
"28940",NA,NA,"Knoxville, TN","Metropolitan Statistical Area",2001,625202,7652,1482,7651,6169,4759,672,4087,1411
"28940",NA,47001,"Anderson County, TN","County or equivalent",2001,71317,85,-5,798,803,159,85,74,-69
"28940",NA,47009,"Blount County, TN","County or equivalent",2001,107926,1709,246,1311,1065,1535,93,1442,-72
"28940",NA,47093,"Knox County, TN","County or equivalent",2001,387712,4684,1118,4828,3710,1980,459,1521,1586
"28940",NA,47105,"Loudon County, TN","County or equivalent",2001,39963,749,62,490,428,712,35,677,-25
"28940",NA,47173,"Union County, TN","County or equivalent",2001,18284,425,61,224,163,373,0,373,-9
"29020",NA,NA,"Kokomo, IN","Metropolitan Statistical Area",2001,101413,-116,358,1396,1038,-383,65,-448,-91
"29020",NA,18067,"Howard County, IN","County or equivalent",2001,84955,-16,333,1196,863,-274,62,-336,-75
"29020",NA,18159,"Tipton County, IN","County or equivalent",2001,16458,-100,25,200,175,-109,3,-112,-16
"29100",NA,NA,"La Crosse, WI-MN","Metropolitan Statistical Area",2001,127600,583,292,1444,1152,410,80,330,-119
"29100",NA,27055,"Houston County, MN","County or equivalent",2001,19894,157,4,206,202,171,9,162,-18
"29100",NA,55063,"La Crosse County, WI","County or equivalent",2001,107706,426,288,1238,950,239,71,168,-101
"29140",NA,NA,"Lafayette, IN","Metropolitan Statistical Area",2001,180150,1315,1068,2353,1285,416,998,-582,-169
"29140",NA,18007,"Benton County, IN","County or equivalent",2001,9290,-106,34,131,97,-133,1,-134,-7
"29140",NA,18015,"Carroll County, IN","County or equivalent",2001,20261,114,82,232,150,51,23,28,-19
"29140",NA,18157,"Tippecanoe County, IN","County or equivalent",2001,150599,1307,952,1990,1038,498,974,-476,-143
"29180",NA,NA,"Lafayette, LA","Metropolitan Statistical Area",2001,239848,749,1798,3565,1767,-842,250,-1092,-207
"29180",NA,22055,"Lafayette Parish, LA","County or equivalent",2001,190780,336,1442,2790,1348,-946,242,-1188,-160
"29180",NA,22099,"St. Martin Parish, LA","County or equivalent",2001,49068,413,356,775,419,104,8,96,-47
"29340",NA,NA,"Lake Charles, LA","Metropolitan Statistical Area",2001,192809,-659,1060,2845,1785,-1572,91,-1663,-147
"29340",NA,22019,"Calcasieu Parish, LA","County or equivalent",2001,182976,-542,1019,2735,1716,-1420,78,-1498,-141
"29340",NA,22023,"Cameron Parish, LA","County or equivalent",2001,9833,-117,41,110,69,-152,13,-165,-6
"29420",NA,NA,"Lake Havasu City-Kingman, AZ","Metropolitan Statistical Area",2001,159822,3642,-163,1769,1932,3879,327,3552,-74
"29420",NA,4015,"Mohave County, AZ","County or equivalent",2001,159822,3642,-163,1769,1932,3879,327,3552,-74
"29460",NA,NA,"Lakeland-Winter Haven, FL","Metropolitan Statistical Area",2001,491250,5908,1696,6874,5178,4616,1293,3323,-404
"29460",NA,12105,"Polk County, FL","County or equivalent",2001,491250,5908,1696,6874,5178,4616,1293,3323,-404
"29540",NA,NA,"Lancaster, PA","Metropolitan Statistical Area",2001,474337,2561,2519,6802,4283,534,526,8,-492
"29540",NA,42071,"Lancaster County, PA","County or equivalent",2001,474337,2561,2519,6802,4283,534,526,8,-492
"29620",NA,NA,"Lansing-East Lansing, MI","Metropolitan Statistical Area",2001,450720,2229,2670,5793,3123,-46,1316,-1362,-395
"29620",NA,26037,"Clinton County, MI","County or equivalent",2001,65519,580,315,757,442,321,15,306,-56
"29620",NA,26045,"Eaton County, MI","County or equivalent",2001,104637,703,543,1327,784,264,95,169,-104
"29620",NA,26065,"Ingham County, MI","County or equivalent",2001,280564,946,1812,3709,1897,-631,1206,-1837,-235
"29700",NA,NA,"Laredo, TX","Metropolitan Statistical Area",2001,199947,5391,4827,5823,996,742,1772,-1030,-178
"29700",NA,48479,"Webb County, TX","County or equivalent",2001,199947,5391,4827,5823,996,742,1772,-1030,-178
"29740",NA,NA,"Las Cruces, NM","Metropolitan Statistical Area",2001,176536,1544,1967,3015,1048,-273,801,-1074,-150
"29740",NA,35013,"Dona Ana County, NM","County or equivalent",2001,176536,1544,1967,3015,1048,-273,801,-1074,-150
"29820",NA,NA,"Las Vegas-Paradise, NV","Metropolitan Statistical Area",2001,1455993,62753,11845,22460,10615,51501,10190,41311,-593
"29820",NA,32003,"Clark County, NV","County or equivalent",2001,1455993,62753,11845,22460,10615,51501,10190,41311,-593
"29940",NA,NA,"Lawrence, KS","Metropolitan Statistical Area",2001,102325,2044,635,1166,531,571,353,218,838
"29940",NA,20045,"Douglas County, KS","County or equivalent",2001,102325,2044,635,1166,531,571,353,218,838
"30020",NA,NA,"Lawton, OK","Metropolitan Statistical Area",2001,112224,-2451,1062,1886,824,-3483,-56,-3427,-30
"30020",NA,40031,"Comanche County, OK","County or equivalent",2001,112224,-2451,1062,1886,824,-3483,-56,-3427,-30
"30140",NA,NA,"Lebanon, PA","Metropolitan Statistical Area",2001,120819,402,182,1434,1252,349,124,225,-129
"30140",NA,42075,"Lebanon County, PA","County or equivalent",2001,120819,402,182,1434,1252,349,124,225,-129
"30300",NA,NA,"Lewiston, ID-WA","Metropolitan Statistical Area",2001,57476,-478,64,667,603,-498,29,-527,-44
"30300",NA,16069,"Nez Perce County, ID","County or equivalent",2001,37006,-393,20,437,417,-386,27,-413,-27
"30300",NA,53003,"Asotin County, WA","County or equivalent",2001,20470,-85,44,230,186,-112,2,-114,-17
"30340",NA,NA,"Lewiston-Auburn, ME","Metropolitan Statistical Area",2001,104138,292,160,1187,1027,228,58,170,-96
"30340",NA,23001,"Androscoggin County, ME","County or equivalent",2001,104138,292,160,1187,1027,228,58,170,-96
"30460",NA,NA,"Lexington-Fayette, KY","Metropolitan Statistical Area",2001,413605,3959,2603,5781,3178,1728,1385,343,-372
"30460",NA,21017,"Bourbon County, KY","County or equivalent",2001,19415,49,20,236,216,48,45,3,-19
"30460",NA,21049,"Clark County, KY","County or equivalent",2001,33436,216,112,399,287,133,16,117,-29
"30460",NA,21067,"Fayette County, KY","County or equivalent",2001,263188,2020,1800,3758,1958,468,1184,-716,-248
"30460",NA,21113,"Jessamine County, KY","County or equivalent",2001,39739,532,256,529,273,315,37,278,-39
"30460",NA,21209,"Scott County, KY","County or equivalent",2001,34488,1075,289,536,247,802,41,761,-16
"30460",NA,21239,"Woodford County, KY","County or equivalent",2001,23339,67,126,323,197,-38,62,-100,-21
"30620",NA,NA,"Lima, OH","Metropolitan Statistical Area",2001,108196,-381,442,1565,1123,-735,30,-765,-88
"30620",NA,39003,"Allen County, OH","County or equivalent",2001,108196,-381,442,1565,1123,-735,30,-765,-88
"30700",NA,NA,"Lincoln, NE","Metropolitan Statistical Area",2001,270968,3059,2073,3903,1830,1255,1009,246,-269
"30700",NA,31109,"Lancaster County, NE","County or equivalent",2001,254343,2965,2027,3711,1684,1190,1001,189,-252
"30700",NA,31159,"Seward County, NE","County or equivalent",2001,16625,94,46,192,146,65,8,57,-17
"30780",NA,NA,"Little Rock-North Little Rock-Conway, AR","Metropolitan Statistical Area",2001,617324,5196,3526,8973,5447,1796,616,1180,-126
"30780",NA,5045,"Faulkner County, AR","County or equivalent",2001,88696,2238,653,1263,610,1593,97,1496,-8
"30780",NA,5053,"Grant County, AR","County or equivalent",2001,16628,140,28,199,171,125,2,123,-13
"30780",NA,5085,"Lonoke County, AR","County or equivalent",2001,53909,784,254,717,463,608,11,597,-78
"30780",NA,5105,"Perry County, AR","County or equivalent",2001,10301,65,24,134,110,50,0,50,-9
"30780",NA,5119,"Pulaski County, AR","County or equivalent",2001,363023,1142,2398,5733,3335,-1318,469,-1787,62
"30780",NA,5125,"Saline County, AR","County or equivalent",2001,84767,827,169,927,758,738,37,701,-80
"30860",NA,NA,"Logan, UT-ID","Metropolitan Statistical Area",2001,105230,2028,1874,2389,515,-790,423,-1213,944
"30860",NA,16041,"Franklin County, ID","County or equivalent",2001,11452,101,109,197,88,3,26,-23,-11
"30860",NA,49005,"Cache County, UT","County or equivalent",2001,93778,1927,1765,2192,427,-793,397,-1190,955
"30980",NA,NA,"Longview, TX","Metropolitan Statistical Area",2001,194622,640,608,2828,2220,226,421,-195,-194
"30980",NA,48183,"Gregg County, TX","County or equivalent",2001,111624,351,512,1770,1258,-59,280,-339,-102
"30980",NA,48401,"Rusk County, TX","County or equivalent",2001,47359,12,88,604,516,-20,115,-135,-56
"30980",NA,48459,"Upshur County, TX","County or equivalent",2001,35639,277,8,454,446,305,26,279,-36
"31020",NA,NA,"Longview, WA","Metropolitan Statistical Area",2001,93598,599,346,1247,901,355,149,206,-102
"31020",NA,53015,"Cowlitz County, WA","County or equivalent",2001,93598,599,346,1247,901,355,149,206,-102
"31100",NA,NA,"Los Angeles-Long Beach-Santa Ana, CA","Metropolitan Statistical Area",2001,12536598,135568,125154,201843,76689,20655,124689,-104034,-10241
"31100",31084,NA,"Los Angeles-Long Beach-Glendale, CA","Metropolitan Division",2001,9643067,98955,95703,155576,59873,11014,97509,-86495,-7762
"31100",31084,6037,"Los Angeles County, CA","County or equivalent",2001,9643067,98955,95703,155576,59873,11014,97509,-86495,-7762
"31100",42044,NA,"Santa Ana-Anaheim-Irvine, CA","Metropolitan Division",2001,2893531,36613,29451,46267,16816,9641,27180,-17539,-2479
"31100",42044,6059,"Orange County, CA","County or equivalent",2001,2893531,36613,29451,46267,16816,9641,27180,-17539,-2479
"31140",NA,NA,"Louisville/Jefferson County, KY-IN","Metropolitan Statistical Area",2001,1172085,7025,4852,15995,11143,2533,1830,703,-360
"31140",NA,18019,"Clark County, IN","County or equivalent",2001,97174,426,369,1297,928,153,95,58,-96
"31140",NA,18043,"Floyd County, IN","County or equivalent",2001,71440,533,191,874,683,403,16,387,-61
"31140",NA,18061,"Harrison County, IN","County or equivalent",2001,34664,149,138,434,296,46,17,29,-35
"31140",NA,18175,"Washington County, IN","County or equivalent",2001,27446,184,106,375,269,103,5,98,-25
"31140",NA,21029,"Bullitt County, KY","County or equivalent",2001,63197,1563,342,705,363,578,3,575,643
"31140",NA,21103,"Henry County, KY","County or equivalent",2001,15216,120,64,223,159,71,17,54,-15
"31140",NA,21111,"Jefferson County, KY","County or equivalent",2001,694966,962,2686,9890,7204,-1075,1475,-2550,-649
"31140",NA,21163,"Meade County, KY","County or equivalent",2001,26790,266,145,309,164,145,10,135,-24
"31140",NA,21179,"Nelson County, KY","County or equivalent",2001,38194,517,193,517,324,354,32,322,-30
"31140",NA,21185,"Oldham County, KY","County or equivalent",2001,47837,858,262,548,286,630,27,603,-34
"31140",NA,21211,"Shelby County, KY","County or equivalent",2001,34064,519,244,528,284,304,129,175,-29
"31140",NA,21215,"Spencer County, KY","County or equivalent",2001,12687,693,99,192,93,595,3,592,-1
"31140",NA,21223,"Trimble County, KY","County or equivalent",2001,8410,235,13,103,90,226,1,225,-4
"31180",NA,NA,"Lubbock, TX","Metropolitan Statistical Area",2001,253363,3242,1940,3920,1980,1326,294,1032,-24
"31180",NA,48107,"Crosby County, TX","County or equivalent",2001,6963,-93,49,116,67,-138,6,-144,-4
"31180",NA,48303,"Lubbock County, TX","County or equivalent",2001,246400,3335,1891,3804,1913,1464,288,1176,-20
"31340",NA,NA,"Lynchburg, VA","Metropolitan Statistical Area",2001,229123,206,451,2713,2262,-16,203,-219,-229
"31340",NA,51009,"Amherst County, VA","County or equivalent",2001,31975,92,47,345,298,76,18,58,-31
"31340",NA,51011,"Appomattox County, VA","County or equivalent",2001,13777,85,13,143,130,84,10,74,-12
"31340",NA,51019,"Bedford County, VA","County or equivalent",2001,60978,374,170,580,410,264,27,237,-60
"31340",NA,51031,"Campbell County, VA","County or equivalent",2001,51249,104,248,679,431,-89,21,-110,-55
"31340",NA,51515,"Bedford city, VA","County or equivalent",2001,6332,18,-2,163,165,29,-1,30,-9
"31340",NA,51680,"Lynchburg city, VA","County or equivalent",2001,64812,-467,-25,803,828,-380,128,-508,-62
"31420",NA,NA,"Macon, GA","Metropolitan Statistical Area",2001,222771,386,1103,3386,2283,-529,186,-715,-188
"31420",NA,13021,"Bibb County, GA","County or equivalent",2001,153618,-234,850,2516,1666,-957,159,-1116,-127
"31420",NA,13079,"Crawford County, GA","County or equivalent",2001,12446,17,19,135,116,13,1,12,-15
"31420",NA,13169,"Jones County, GA","County or equivalent",2001,24160,460,141,326,185,336,10,326,-17
"31420",NA,13207,"Monroe County, GA","County or equivalent",2001,22013,180,86,294,208,113,17,96,-19
"31420",NA,13289,"Twiggs County, GA","County or equivalent",2001,10534,-37,7,115,108,-34,-1,-33,-10
"31460",NA,NA,"Madera, CA","Metropolitan Statistical Area",2001,125474,1902,1253,2144,891,774,901,-127,-125
"31460",NA,6039,"Madera County, CA","County or equivalent",2001,125474,1902,1253,2144,891,774,901,-127,-125
"31540",NA,NA,"Madison, WI","Metropolitan Statistical Area",2001,511709,7689,3044,6393,3349,5094,1913,3181,-449
"31540",NA,55021,"Columbia County, WI","County or equivalent",2001,52983,364,49,588,539,360,25,335,-45
"31540",NA,55025,"Dane County, WI","County or equivalent",2001,435807,7207,2900,5526,2626,4688,1887,2801,-381
"31540",NA,55049,"Iowa County, WI","County or equivalent",2001,22919,118,95,279,184,46,1,45,-23
"31700",NA,NA,"Manchester-Nashua, NH","Metropolitan Statistical Area",2001,388064,5703,2254,5038,2784,3769,1296,2473,-320
"31700",NA,33011,"Hillsborough County, NH","County or equivalent",2001,388064,5703,2254,5038,2784,3769,1296,2473,-320
"31900",NA,NA,"Mansfield, OH","Metropolitan Statistical Area",2001,128006,-793,480,1673,1193,-1178,51,-1229,-95
"31900",NA,39139,"Richland County, OH","County or equivalent",2001,128006,-793,480,1673,1193,-1178,51,-1229,-95
"32580",NA,NA,"McAllen-Edinburg-Mission, TX","Metropolitan Statistical Area",2001,588836,15338,12427,15276,2849,3456,5128,-1672,-545
"32580",NA,48215,"Hidalgo County, TX","County or equivalent",2001,588836,15338,12427,15276,2849,3456,5128,-1672,-545
"32780",NA,NA,"Medford, OR","Metropolitan Statistical Area",2001,183797,2009,176,2067,1891,2002,272,1730,-169
"32780",NA,41029,"Jackson County, OR","County or equivalent",2001,183797,2009,176,2067,1891,2002,272,1730,-169
"32820",NA,NA,"Memphis, TN-MS-AR","Metropolitan Statistical Area",2001,1215042,6796,8688,19500,10812,-1017,2040,-3057,-875
"32820",NA,5035,"Crittenden County, AR","County or equivalent",2001,51223,246,360,875,515,-151,31,-182,37
"32820",NA,28033,"DeSoto County, MS","County or equivalent",2001,113246,4578,978,1782,804,3648,127,3521,-48
"32820",NA,28093,"Marshall County, MS","County or equivalent",2001,35044,-7,208,560,352,-180,6,-186,-35
"32820",NA,28137,"Tate County, MS","County or equivalent",2001,25505,63,140,399,259,-51,1,-52,-26
"32820",NA,28143,"Tunica County, MS","County or equivalent",2001,9358,137,84,175,91,64,7,57,-11
"32820",NA,47047,"Fayette County, TN","County or equivalent",2001,30192,1092,137,424,287,961,8,953,-6
"32820",NA,47157,"Shelby County, TN","County or equivalent",2001,897963,-288,6512,14579,8067,-6048,1845,-7893,-752
"32820",NA,47167,"Tipton County, TN","County or equivalent",2001,52511,975,269,706,437,740,15,725,-34
"32900",NA,NA,"Merced, CA","Metropolitan Statistical Area",2001,217457,5905,2561,3938,1377,3512,1378,2134,-168
"32900",NA,6047,"Merced County, CA","County or equivalent",2001,217457,5905,2561,3938,1377,3512,1378,2134,-168
"33100",NA,NA,"Miami-Fort Lauderdale-Pompano Beach, FL","Metropolitan Statistical Area",2001,5108584,82066,20020,68396,48376,60373,64038,-3665,1673
"33100",22744,NA,"Fort Lauderdale-Pompano Beach-Deerfield Beach, FL","Metropolitan Division",2001,1668165,36182,6167,22446,16279,29776,15899,13877,239
"33100",22744,12011,"Broward County, FL","County or equivalent",2001,1668165,36182,6167,22446,16279,29776,15899,13877,239
"33100",33124,NA,"Miami-Miami Beach-Kendall, FL","Metropolitan Division",2001,2283934,24823,13538,32374,18836,8994,40220,-31226,2291
"33100",33124,12086,"Miami-Dade County, FL","County or equivalent",2001,2283934,24823,13538,32374,18836,8994,40220,-31226,2291
"33100",48424,NA,"West Palm Beach-Boca Raton-Boynton Beach, FL","Metropolitan Division",2001,1156485,21061,315,13576,13261,21603,7919,13684,-857
"33100",48424,12099,"Palm Beach County, FL","County or equivalent",2001,1156485,21061,315,13576,13261,21603,7919,13684,-857
"33140",NA,NA,"Michigan City-La Porte, IN","Metropolitan Statistical Area",2001,110049,-109,370,1442,1072,-379,95,-474,-100
"33140",NA,18091,"LaPorte County, IN","County or equivalent",2001,110049,-109,370,1442,1072,-379,95,-474,-100
"33260",NA,NA,"Midland, TX","Metropolitan Statistical Area",2001,115763,288,928,1811,883,-545,185,-730,-95
"33260",NA,48329,"Midland County, TX","County or equivalent",2001,115763,288,928,1811,883,-545,185,-730,-95
"33340",NA,NA,"Milwaukee-Waukesha-West Allis, WI","Metropolitan Statistical Area",2001,1510819,8558,8315,21628,13313,-5056,3563,-8619,5299
"33340",NA,55079,"Milwaukee County, WI","County or equivalent",2001,943749,4029,5701,14833,9132,-7529,3057,-10586,5857
"33340",NA,55089,"Ozaukee County, WI","County or equivalent",2001,82970,442,280,857,577,238,79,159,-76
"33340",NA,55131,"Washington County, WI","County or equivalent",2001,119309,1350,680,1492,812,780,78,702,-110
"33340",NA,55133,"Waukesha County, WI","County or equivalent",2001,364791,2737,1654,4446,2792,1455,349,1106,-372
"33460",NA,NA,"Minneapolis-St. Paul-Bloomington, MN-WI","Metropolitan Statistical Area",2001,3023746,42238,25649,44641,18992,18759,11188,7571,-2170
"33460",NA,27003,"Anoka County, MN","County or equivalent",2001,304897,5162,2995,4450,1455,2447,454,1993,-280
"33460",NA,27019,"Carver County, MN","County or equivalent",2001,73093,2232,905,1193,288,1372,151,1221,-45
"33460",NA,27025,"Chisago County, MN","County or equivalent",2001,43094,1555,341,644,303,1231,6,1225,-17
"33460",NA,27037,"Dakota County, MN","County or equivalent",2001,363509,5659,3640,5286,1646,2356,758,1598,-337
"33460",NA,27053,"Hennepin County, MN","County or equivalent",2001,1124857,6630,8663,16709,8046,-1069,6884,-7953,-964
"33460",NA,27059,"Isanti County, MN","County or equivalent",2001,32624,1110,174,378,204,951,12,939,-15
"33460",NA,27123,"Ramsey County, MN","County or equivalent",2001,512982,1397,3525,7651,4126,-1716,2426,-4142,-412
"33460",NA,27139,"Scott County, MN","County or equivalent",2001,97192,6115,1298,1708,410,4810,156,4654,7
"33460",NA,27141,"Sherburne County, MN","County or equivalent",2001,68259,2984,845,1160,315,1951,22,1929,188
"33460",NA,27163,"Washington County, MN","County or equivalent",2001,206633,4104,1828,2806,978,2443,237,2206,-167
"33460",NA,27171,"Wright County, MN","County or equivalent",2001,93742,2990,908,1432,524,2139,46,2093,-57
"33460",NA,55093,"Pierce County, WI","County or equivalent",2001,37214,296,169,395,226,161,10,151,-34
"33460",NA,55109,"St. Croix County, WI","County or equivalent",2001,65650,2004,358,829,471,1683,26,1657,-37
"33540",NA,NA,"Missoula, MT","Metropolitan Statistical Area",2001,97398,1231,458,1116,658,854,83,771,-81
"33540",NA,30063,"Missoula County, MT","County or equivalent",2001,97398,1231,458,1116,658,854,83,771,-81
"33660",NA,NA,"Mobile, AL","Metropolitan Statistical Area",2001,399997,-31,2191,6090,3899,-1880,480,-2360,-342
"33660",NA,1097,"Mobile County, AL","County or equivalent",2001,399997,-31,2191,6090,3899,-1880,480,-2360,-342
"33700",NA,NA,"Modesto, CA","Metropolitan Statistical Area",2001,463940,14232,3821,7396,3575,10716,2273,8443,-305
"33700",NA,6099,"Stanislaus County, CA","County or equivalent",2001,463940,14232,3821,7396,3575,10716,2273,8443,-305
"33740",NA,NA,"Monroe, LA","Metropolitan Statistical Area",2001,169404,-643,1026,2709,1683,-1528,61,-1589,-141
"33740",NA,22073,"Ouachita Parish, LA","County or equivalent",2001,146599,-669,938,2365,1427,-1490,43,-1533,-117
"33740",NA,22111,"Union Parish, LA","County or equivalent",2001,22805,26,88,344,256,-38,18,-56,-24
"33780",NA,NA,"Monroe, MI","Metropolitan Statistical Area",2001,147631,1226,554,1757,1203,810,106,704,-138
"33780",NA,26115,"Monroe County, MI","County or equivalent",2001,147631,1226,554,1757,1203,810,106,704,-138
"33860",NA,NA,"Montgomery, AL","Metropolitan Statistical Area",2001,348336,1331,2415,5461,3046,-812,177,-989,-272
"33860",NA,1001,"Autauga County, AL","County or equivalent",2001,44437,563,281,635,354,323,5,318,-41
"33860",NA,1051,"Elmore County, AL","County or equivalent",2001,67570,1338,494,1022,528,891,10,881,-47
"33860",NA,1085,"Lowndes County, AL","County or equivalent",2001,13452,-35,99,234,135,-123,0,-123,-11
"33860",NA,1101,"Montgomery County, AL","County or equivalent",2001,222877,-535,1541,3570,2029,-1903,162,-2065,-173
"34060",NA,NA,"Morgantown, WV","Metropolitan Statistical Area",2001,111940,739,153,1166,1013,684,240,444,-98
"34060",NA,54061,"Monongalia County, WV","County or equivalent",2001,82767,853,233,900,667,690,238,452,-70
"34060",NA,54077,"Preston County, WV","County or equivalent",2001,29173,-114,-80,266,346,-6,2,-8,-28
"34100",NA,NA,"Morristown, TN","Metropolitan Statistical Area",2001,124751,1189,424,1627,1203,880,406,474,-115
"34100",NA,47057,"Grainger County, TN","County or equivalent",2001,20831,94,56,255,199,57,17,40,-19
"34100",NA,47063,"Hamblen County, TN","County or equivalent",2001,58760,517,278,852,574,296,333,-37,-57
"34100",NA,47089,"Jefferson County, TN","County or equivalent",2001,45160,578,90,520,430,527,56,471,-39
"34580",NA,NA,"Mount Vernon-Anacortes, WA","Metropolitan Statistical Area",2001,104828,1362,493,1435,942,959,404,555,-90
"34580",NA,53057,"Skagit County, WA","County or equivalent",2001,104828,1362,493,1435,942,959,404,555,-90
"34620",NA,NA,"Muncie, IN","Metropolitan Statistical Area",2001,119987,1253,257,1417,1160,1086,134,952,-90
"34620",NA,18035,"Delaware County, IN","County or equivalent",2001,119987,1253,257,1417,1160,1086,134,952,-90
"34740",NA,NA,"Muskegon-Norton Shores, MI","Metropolitan Statistical Area",2001,171239,753,847,2435,1588,75,116,-41,-169
"34740",NA,26121,"Muskegon County, MI","County or equivalent",2001,171239,753,847,2435,1588,75,116,-41,-169
"34820",NA,NA,"Myrtle Beach-North Myrtle Beach-Conway, SC","Metropolitan Statistical Area",2001,201833,3713,602,2518,1916,3232,438,2794,-121
"34820",NA,45051,"Horry County, SC","County or equivalent",2001,201833,3713,602,2518,1916,3232,438,2794,-121
"34900",NA,NA,"Napa, CA","Metropolitan Statistical Area",2001,126753,2215,257,1584,1327,2065,856,1209,-107
"34900",NA,6055,"Napa County, CA","County or equivalent",2001,126753,2215,257,1584,1327,2065,856,1209,-107
"34940",NA,NA,"Naples-Marco Island, FL","Metropolitan Statistical Area",2001,264096,10061,921,3282,2361,9254,2490,6764,-114
"34940",NA,12021,"Collier County, FL","County or equivalent",2001,264096,10061,921,3282,2361,9254,2490,6764,-114
"34980",NA,NA,"Nashville-Davidson--Murfreesboro--Franklin, TN","Metropolitan Statistical Area",2001,1343402,25888,9006,19654,10648,12048,3877,8171,4834
"34980",NA,47015,"Cannon County, TN","County or equivalent",2001,12988,82,3,152,149,91,8,83,-12
"34980",NA,47021,"Cheatham County, TN","County or equivalent",2001,36549,453,219,471,252,266,10,256,-32
"34980",NA,47037,"Davidson County, TN","County or equivalent",2001,578832,8555,3868,8930,5062,-679,2829,-3508,5366
"34980",NA,47043,"Dickson County, TN","County or equivalent",2001,43861,508,270,624,354,274,9,265,-36
"34980",NA,47081,"Hickman County, TN","County or equivalent",2001,22704,267,76,310,234,210,0,210,-19
"34980",NA,47111,"Macon County, TN","County or equivalent",2001,20808,363,70,275,205,309,35,274,-16
"34980",NA,47147,"Robertson County, TN","County or equivalent",2001,55943,1117,338,832,494,817,142,675,-38
"34980",NA,47149,"Rutherford County, TN","County or equivalent",2001,189626,6057,1756,2935,1179,4411,357,4054,-110
"34980",NA,47159,"Smith County, TN","County or equivalent",2001,17958,167,42,236,194,139,8,131,-14
"34980",NA,47165,"Sumner County, TN","County or equivalent",2001,133610,2454,773,1806,1033,1782,168,1614,-101
"34980",NA,47169,"Trousdale County, TN","County or equivalent",2001,7287,-20,4,92,88,-17,12,-29,-7
"34980",NA,47187,"Williamson County, TN","County or equivalent",2001,132194,4109,1001,1702,701,3189,248,2941,-81
"34980",NA,47189,"Wilson County, TN","County or equivalent",2001,91042,1776,586,1289,703,1256,51,1205,-66
"35300",NA,NA,"New Haven-Milford, CT","Metropolitan Statistical Area",2001,828441,3456,2382,10259,7877,1888,3019,-1131,-814
"35300",NA,9009,"New Haven County, CT","County or equivalent",2001,828441,3456,2382,10259,7877,1888,3019,-1131,-814
"35380",NA,NA,"New Orleans-Metairie-Kenner, LA","Metropolitan Statistical Area",2001,1310879,-4661,6599,18969,12370,-11097,1588,-12685,-163
"35380",NA,22051,"Jefferson Parish, LA","County or equivalent",2001,451981,-2712,2102,6257,4155,-4875,855,-5730,61
"35380",NA,22071,"Orleans Parish, LA","County or equivalent",2001,477835,-5800,2362,7448,5086,-8227,533,-8760,65
"35380",NA,22075,"Plaquemines Parish, LA","County or equivalent",2001,26853,116,165,392,227,-22,-3,-19,-27
"35380",NA,22087,"St. Bernard Parish, LA","County or equivalent",2001,66540,-448,88,827,739,-533,21,-554,-3
"35380",NA,22089,"St. Charles Parish, LA","County or equivalent",2001,48410,248,377,722,345,-81,46,-127,-48
"35380",NA,22095,"St. John the Baptist Parish, LA","County or equivalent",2001,43567,414,354,662,308,102,23,79,-42
"35380",NA,22103,"St. Tammany Parish, LA","County or equivalent",2001,195693,3521,1151,2661,1510,2539,113,2426,-169
"35620",NA,NA,"New York-Northern New Jersey-Long Island, NY-NJ-PA","Metropolitan Statistical Area",2001,18491057,137703,116029,261113,145084,-9581,166837,-176418,31255
"35620",20764,NA,"Edison-New Brunswick, NJ","Metropolitan Division",2001,2210590,28158,9068,28923,19855,17517,13476,4041,1573
"35620",20764,34023,"Middlesex County, NJ","County or equivalent",2001,760553,7751,4537,10267,5730,3900,8415,-4515,-686
"35620",20764,34025,"Monmouth County, NJ","County or equivalent",2001,623962,6872,2520,7778,5258,1809,2074,-265,2543
"35620",20764,34029,"Ocean County, NJ","County or equivalent",2001,523675,10021,-313,6524,6837,10251,715,9536,83
"35620",20764,34035,"Somerset County, NJ","County or equivalent",2001,302400,3514,2324,4354,2030,1557,2272,-715,-367
"35620",35004,NA,"Nassau-Suffolk, NY","Metropolitan Division",2001,2791376,31639,14395,36925,22530,689,9590,-8901,16555
"35620",35004,36059,"Nassau County, NY","County or equivalent",2001,1342570,6497,5388,16705,11317,-6351,5055,-11406,7460
"35620",35004,36103,"Suffolk County, NY","County or equivalent",2001,1448806,25142,9007,20220,11213,7040,4535,2505,9095
"35620",35084,NA,"Newark-Union, NJ-PA","Metropolitan Division",2001,2110912,10343,12149,29615,17466,121,14372,-14251,-1927
"35620",35084,34013,"Essex County, NJ","County or equivalent",2001,793238,919,4781,11977,7196,-3158,6442,-9600,-704
"35620",35084,34019,"Hunterdon County, NJ","County or equivalent",2001,124619,2077,663,1434,771,1600,240,1360,-186
"35620",35084,34027,"Morris County, NJ","County or equivalent",2001,473281,1933,2936,6415,3479,-623,2855,-3478,-380
"35620",35084,34037,"Sussex County, NJ","County or equivalent",2001,146046,1436,792,1768,976,775,157,618,-131
"35620",35084,34039,"Union County, NJ","County or equivalent",2001,525695,2555,2932,7630,4698,134,4654,-4520,-511
"35620",35084,42103,"Pike County, PA","County or equivalent",2001,48033,1423,45,391,346,1393,24,1369,-15
"35620",35644,NA,"New York-White Plains-Wayne, NY-NJ","Metropolitan Division",2001,11378179,67563,80417,165650,85233,-27908,129399,-157307,15054
"35620",35644,34003,"Bergen County, NJ","County or equivalent",2001,888875,3395,2902,10060,7158,1369,7547,-6178,-876
"35620",35644,34017,"Hudson County, NJ","County or equivalent",2001,612847,3363,3812,8421,4609,62,9474,-9412,-511
"35620",35644,34031,"Passaic County, NJ","County or equivalent",2001,492832,2008,3774,7834,4060,-1393,4594,-5987,-373
"35620",35644,36005,"Bronx County, NY","County or equivalent",2001,1342182,8463,12927,23026,10099,-4539,13354,-17893,75
"35620",35644,36047,"Kings County, NY","County or equivalent",2001,2471559,5802,21943,40149,18206,-16889,30963,-47852,748
"35620",35644,36061,"New York County, NY","County or equivalent",2001,1561272,20662,8812,20171,11359,8830,17241,-8411,3020
"35620",35644,36079,"Putnam County, NY","County or equivalent",2001,96995,928,592,1151,559,431,244,187,-95
"35620",35644,36081,"Queens County, NY","County or equivalent",2001,2234868,4685,15505,31608,16103,-17668,35133,-52801,6848
"35620",35644,36085,"Richmond County, NY","County or equivalent",2001,453054,7642,2200,5706,3506,2335,2029,306,3107
"35620",35644,36087,"Rockland County, NY","County or equivalent",2001,288656,1247,2481,4552,2071,-1235,1564,-2799,1
"35620",35644,36119,"Westchester County, NY","County or equivalent",2001,935039,9368,5469,12972,7503,789,7256,-6467,3110
"35660",NA,NA,"Niles-Benton Harbor, MI","Metropolitan Statistical Area",2001,161630,-908,614,2239,1625,-1409,368,-1777,-113
"35660",NA,26021,"Berrien County, MI","County or equivalent",2001,161630,-908,614,2239,1625,-1409,368,-1777,-113
"35980",NA,NA,"Norwich-New London, CT","Metropolitan Statistical Area",2001,260901,1365,764,3062,2298,846,338,508,-245
"35980",NA,9011,"New London County, CT","County or equivalent",2001,260901,1365,764,3062,2298,846,338,508,-245
"36100",NA,NA,"Ocala, FL","Metropolitan Statistical Area",2001,264372,4098,-613,2886,3499,4887,362,4525,-176
"36100",NA,12083,"Marion County, FL","County or equivalent",2001,264372,4098,-613,2886,3499,4887,362,4525,-176
"36140",NA,NA,"Ocean City, NJ","Metropolitan Statistical Area",2001,101861,-447,-294,979,1273,-45,55,-100,-108
"36140",NA,34009,"Cape May County, NJ","County or equivalent",2001,101861,-447,-294,979,1273,-45,55,-100,-108
"36220",NA,NA,"Odessa, TX","Metropolitan Statistical Area",2001,120596,-69,1211,2180,969,-1182,220,-1402,-98
"36220",NA,48135,"Ector County, TX","County or equivalent",2001,120596,-69,1211,2180,969,-1182,220,-1402,-98
"36260",NA,NA,"Ogden-Clearfield, UT","Metropolitan Statistical Area",2001,452712,7856,6440,8947,2507,332,938,-606,1084
"36260",NA,49011,"Davis County, UT","County or equivalent",2001,244528,4249,3819,4909,1090,53,273,-220,377
"36260",NA,49029,"Morgan County, UT","County or equivalent",2001,7290,135,88,116,28,54,3,51,-7
"36260",NA,49057,"Weber County, UT","County or equivalent",2001,200894,3472,2533,3922,1389,225,662,-437,714
"36420",NA,NA,"Oklahoma City, OK","Metropolitan Statistical Area",2001,1107523,9689,6328,16221,9893,4307,3087,1220,-946
"36420",NA,40017,"Canadian County, OK","County or equivalent",2001,89502,1358,456,1112,656,989,88,901,-87
"36420",NA,40027,"Cleveland County, OK","County or equivalent",2001,212460,4084,1140,2417,1277,3098,447,2651,-154
"36420",NA,40051,"Grady County, OK","County or equivalent",2001,45849,279,84,561,477,236,9,227,-41
"36420",NA,40081,"Lincoln County, OK","County or equivalent",2001,32088,-39,52,390,338,-60,7,-67,-31
"36420",NA,40083,"Logan County, OK","County or equivalent",2001,34519,577,88,404,316,512,11,501,-23
"36420",NA,40087,"McClain County, OK","County or equivalent",2001,27778,-68,102,381,279,-146,27,-173,-24
"36420",NA,40109,"Oklahoma County, OK","County or equivalent",2001,665327,3498,4406,10956,6550,-322,2498,-2820,-586
"36500",NA,NA,"Olympia, WA","Metropolitan Statistical Area",2001,212509,4226,1101,2676,1575,3287,329,2958,-162
"36500",NA,53067,"Thurston County, WA","County or equivalent",2001,212509,4226,1101,2676,1575,3287,329,2958,-162
"36540",NA,NA,"Omaha-Council Bluffs, NE-IA","Metropolitan Statistical Area",2001,775256,6182,6209,12174,5965,670,1846,-1176,-697
"36540",NA,19085,"Harrison County, IA","County or equivalent",2001,15639,-52,14,187,173,-51,6,-57,-15
"36540",NA,19129,"Mills County, IA","County or equivalent",2001,14482,-73,24,168,144,-83,4,-87,-14
"36540",NA,19155,"Pottawattamie County, IA","County or equivalent",2001,87662,-303,345,1191,846,-569,54,-623,-79
"36540",NA,31025,"Cass County, NE","County or equivalent",2001,24525,132,91,310,219,65,8,57,-24
"36540",NA,31055,"Douglas County, NE","County or equivalent",2001,467928,3254,4038,7697,3659,-358,1641,-1999,-426
"36540",NA,31153,"Sarpy County, NE","County or equivalent",2001,126017,2865,1543,2143,600,1428,104,1324,-106
"36540",NA,31155,"Saunders County, NE","County or equivalent",2001,19916,64,84,249,165,-1,10,-11,-19
"36540",NA,31177,"Washington County, NE","County or equivalent",2001,19087,295,70,229,159,239,19,220,-14
"36740",NA,NA,"Orlando-Kissimmee, FL","Metropolitan Statistical Area",2001,1708129,51388,10693,23967,13274,40226,9803,30423,469
"36740",NA,12069,"Lake County, FL","County or equivalent",2001,223873,11075,-507,2449,2956,11696,376,11320,-114
"36740",NA,12095,"Orange County, FL","County or equivalent",2001,927391,24627,7823,14170,6347,17446,6504,10942,-642
"36740",NA,12097,"Osceola County, FL","County or equivalent",2001,183255,9105,1442,2748,1306,6133,1585,4548,1530
"36740",NA,12117,"Seminole County, FL","County or equivalent",2001,373610,6581,1935,4600,2665,4951,1338,3613,-305
"36780",NA,NA,"Oshkosh-Neenah, WI","Metropolitan Statistical Area",2001,157762,686,709,1952,1243,137,187,-50,-160
"36780",NA,55139,"Winnebago County, WI","County or equivalent",2001,157762,686,709,1952,1243,137,187,-50,-160
"36980",NA,NA,"Owensboro, KY","Metropolitan Statistical Area",2001,109853,-151,495,1598,1103,-548,48,-596,-98
"36980",NA,21059,"Daviess County, KY","County or equivalent",2001,91570,-36,414,1342,928,-369,37,-406,-81
"36980",NA,21091,"Hancock County, KY","County or equivalent",2001,8436,15,62,126,64,-37,2,-39,-10
"36980",NA,21149,"McLean County, KY","County or equivalent",2001,9847,-130,19,130,111,-142,9,-151,-7
"37100",NA,NA,"Oxnard-Thousand Oaks-Ventura, CA","Metropolitan Statistical Area",2001,765710,9296,6844,11609,4765,3218,4189,-971,-766
"37100",NA,6111,"Ventura County, CA","County or equivalent",2001,765710,9296,6844,11609,4765,3218,4189,-971,-766
"37340",NA,NA,"Palm Bay-Melbourne-Titusville, FL","Metropolitan Statistical Area",2001,485843,8145,-284,4895,5179,8749,668,8081,-320
"37340",NA,12009,"Brevard County, FL","County or equivalent",2001,485843,8145,-284,4895,5179,8749,668,8081,-320
"37380",NA,NA,"Palm Coast, FL","Metropolitan Statistical Area",2001,53695,3142,-231,408,639,3368,78,3290,5
"37380",NA,12035,"Flagler County, FL","County or equivalent",2001,53695,3142,-231,408,639,3368,78,3290,5
"37460",NA,NA,"Panama City-Lynn Haven, FL","Metropolitan Statistical Area",2001,149783,1531,633,2023,1390,1033,87,946,-135
"37460",NA,12005,"Bay County, FL","County or equivalent",2001,149783,1531,633,2023,1390,1033,87,946,-135
"37620",NA,NA,"Parkersburg-Marietta-Vienna, WV-OH","Metropolitan Statistical Area",2001,163832,-612,51,1901,1850,-517,26,-543,-146
"37620",NA,39167,"Washington County, OH","County or equivalent",2001,62755,-434,23,706,683,-406,4,-410,-51
"37620",NA,54073,"Pleasants County, WV","County or equivalent",2001,7537,37,-13,79,92,57,3,54,-7
"37620",NA,54105,"Wirt County, WV","County or equivalent",2001,5852,-29,1,49,48,-22,1,-23,-8
"37620",NA,54107,"Wood County, WV","County or equivalent",2001,87688,-186,40,1067,1027,-146,18,-164,-80
"37700",NA,NA,"Pascagoula, MS","Metropolitan Statistical Area",2001,151991,961,866,2240,1374,246,129,117,-151
"37700",NA,28039,"George County, MS","County or equivalent",2001,19460,265,123,340,217,159,14,145,-17
"37700",NA,28059,"Jackson County, MS","County or equivalent",2001,132531,696,743,1900,1157,87,115,-28,-134
"37860",NA,NA,"Pensacola-Ferry Pass-Brent, FL","Metropolitan Statistical Area",2001,420315,7153,1624,5385,3761,5841,254,5587,-312
"37860",NA,12033,"Escambia County, FL","County or equivalent",2001,298810,4031,1036,3901,2865,3226,202,3024,-231
"37860",NA,12113,"Santa Rosa County, FL","County or equivalent",2001,121505,3122,588,1484,896,2615,52,2563,-81
"37900",NA,NA,"Peoria, IL","Metropolitan Statistical Area",2001,365135,-1459,1296,4912,3616,-2479,328,-2807,-276
"37900",NA,17123,"Marshall County, IL","County or equivalent",2001,12921,-217,-44,133,177,-165,1,-166,-8
"37900",NA,17143,"Peoria County, IL","County or equivalent",2001,182207,-949,842,2600,1758,-1648,270,-1918,-143
"37900",NA,17175,"Stark County, IL","County or equivalent",2001,6302,-18,-13,86,99,3,-1,4,-8
"37900",NA,17179,"Tazewell County, IL","County or equivalent",2001,128145,-351,409,1642,1233,-654,50,-704,-106
"37900",NA,17203,"Woodford County, IL","County or equivalent",2001,35560,76,102,451,349,-15,8,-23,-11
"37980",NA,NA,"Philadelphia-Camden-Wilmington, PA-NJ-DE-MD","Metropolitan Statistical Area",2001,5707865,14949,19462,74448,54986,-388,14370,-14758,-4125
"37980",15804,NA,"Camden, NJ","Metropolitan Division",2001,1196244,7846,4162,14541,10379,3666,1936,1730,18
"37980",15804,34005,"Burlington County, NJ","County or equivalent",2001,429576,5097,1357,4888,3531,4112,651,3461,-372
"37980",15804,34007,"Camden County, NJ","County or equivalent",2001,507683,90,1958,6733,4775,-2137,1130,-3267,269
"37980",15804,34015,"Gloucester County, NJ","County or equivalent",2001,258985,2659,847,2920,2073,1691,155,1536,121
"37980",37964,NA,"Philadelphia, PA","Metropolitan Division",2001,3853818,1840,12153,51187,39034,-6806,10666,-17472,-3507
"37980",37964,42017,"Bucks County, PA","County or equivalent",2001,603199,3791,2242,7255,5013,2191,1019,1172,-642
"37980",37964,42029,"Chester County, PA","County or equivalent",2001,441568,5789,2476,5853,3377,3728,1002,2726,-415
"37980",37964,42045,"Delaware County, PA","County or equivalent",2001,552554,513,1012,6914,5902,30,1265,-1235,-529
"37980",37964,42091,"Montgomery County, PA","County or equivalent",2001,757890,6952,2353,9470,7117,5315,1631,3684,-716
"37980",37964,42101,"Philadelphia County, PA","County or equivalent",2001,1498607,-15205,4070,21695,17625,-18070,5749,-23819,-1205
"37980",48864,NA,"Wilmington, DE-MD-NJ","Metropolitan Division",2001,657803,5263,3147,8720,5573,2752,1768,984,-636
"37980",48864,10003,"New Castle County, DE","County or equivalent",2001,505415,3556,2725,6902,4177,1343,1644,-301,-512
"37980",48864,24015,"Cecil County, MD","County or equivalent",2001,88256,1791,386,1132,746,1469,53,1416,-64
"37980",48864,34033,"Salem County, NJ","County or equivalent",2001,64132,-84,36,686,650,-60,71,-131,-60
"38060",NA,NA,"Phoenix-Mesa-Scottsdale, AZ","Metropolitan Statistical Area",2001,3387790,109014,33660,58028,24368,75694,25876,49818,-340
"38060",NA,4013,"Maricopa County, AZ","County or equivalent",2001,3199440,101940,32634,55460,22826,71427,25297,46130,-2121
"38060",NA,4021,"Pinal County, AZ","County or equivalent",2001,188350,7074,1026,2568,1542,4267,579,3688,1781
"38220",NA,NA,"Pine Bluff, AR","Metropolitan Statistical Area",2001,106494,-743,392,1505,1113,-1047,74,-1121,-88
"38220",NA,5025,"Cleveland County, AR","County or equivalent",2001,8620,76,22,109,87,62,7,55,-8
"38220",NA,5069,"Jefferson County, AR","County or equivalent",2001,83438,-781,346,1242,896,-1061,66,-1127,-66
"38220",NA,5079,"Lincoln County, AR","County or equivalent",2001,14436,-38,24,154,130,-48,1,-49,-14
"38300",NA,NA,"Pittsburgh, PA","Metropolitan Statistical Area",2001,2418251,-10763,-2903,25855,28758,-5661,2424,-8085,-2199
"38300",NA,42003,"Allegheny County, PA","County or equivalent",2001,1272576,-7338,-1130,14157,15287,-5037,2158,-7195,-1171
"38300",NA,42005,"Armstrong County, PA","County or equivalent",2001,71803,-512,-147,722,869,-302,5,-307,-63
"38300",NA,42007,"Beaver County, PA","County or equivalent",2001,179593,-1522,-326,1805,2131,-1042,44,-1086,-154
"38300",NA,42019,"Butler County, PA","County or equivalent",2001,175831,1312,343,2106,1763,1144,76,1068,-175
"38300",NA,42051,"Fayette County, PA","County or equivalent",2001,147076,-1438,-354,1497,1851,-964,21,-985,-120
"38300",NA,42125,"Washington County, PA","County or equivalent",2001,203089,142,-468,2055,2523,785,50,735,-175
"38300",NA,42129,"Westmoreland County, PA","County or equivalent",2001,368283,-1407,-821,3513,4334,-245,70,-315,-341
"38340",NA,NA,"Pittsfield, MA","Metropolitan Statistical Area",2001,133718,-1069,-420,1202,1622,-528,143,-671,-121
"38340",NA,25003,"Berkshire County, MA","County or equivalent",2001,133718,-1069,-420,1202,1622,-528,143,-671,-121
"38540",NA,NA,"Pocatello, ID","Metropolitan Statistical Area",2001,84180,1004,910,1513,603,-543,99,-642,637
"38540",NA,16005,"Bannock County, ID","County or equivalent",2001,76698,1022,848,1404,556,-403,69,-472,577
"38540",NA,16077,"Power County, ID","County or equivalent",2001,7482,-18,62,109,47,-140,30,-170,60
"38860",NA,NA,"Portland-South Portland-Biddeford, ME","Metropolitan Statistical Area",2001,495358,6030,1283,5544,4261,5147,466,4681,-400
"38860",NA,23005,"Cumberland County, ME","County or equivalent",2001,267948,1920,662,3033,2371,1503,378,1125,-245
"38860",NA,23023,"Sagadahoc County, ME","County or equivalent",2001,35500,274,112,386,274,197,8,189,-35
"38860",NA,23031,"York County, ME","County or equivalent",2001,191910,3836,509,2125,1616,3447,80,3367,-120
"38900",NA,NA,"Portland-Vancouver-Beaverton, OR-WA","Metropolitan Statistical Area",2001,1975944,39834,13839,28469,14630,27656,10533,17123,-1661
"38900",NA,41005,"Clackamas County, OR","County or equivalent",2001,344837,5325,1527,4203,2676,4114,995,3119,-316
"38900",NA,41009,"Columbia County, OR","County or equivalent",2001,44233,576,160,549,389,451,14,437,-35
"38900",NA,41051,"Multnomah County, OR","County or equivalent",2001,669766,8000,3618,9423,5805,5025,4327,698,-643
"38900",NA,41067,"Washington County, OR","County or equivalent",2001,462481,13972,4941,7609,2668,9376,3315,6061,-345
"38900",NA,41071,"Yamhill County, OR","County or equivalent",2001,86280,1033,501,1176,675,617,335,282,-85
"38900",NA,53011,"Clark County, WA","County or equivalent",2001,358515,10989,3067,5408,2341,8149,1539,6610,-227
"38900",NA,53059,"Skamania County, WA","County or equivalent",2001,9832,-61,25,101,76,-76,8,-84,-10
"38940",NA,NA,"Port St. Lucie, FL","Metropolitan Statistical Area",2001,326820,6257,-503,3410,3913,6926,978,5948,-166
"38940",NA,12085,"Martin County, FL","County or equivalent",2001,129104,1954,-284,1237,1521,2302,355,1947,-64
"38940",NA,12111,"St. Lucie County, FL","County or equivalent",2001,197716,4303,-219,2173,2392,4624,623,4001,-102
"39100",NA,NA,"Poughkeepsie-Newburgh-Middletown, NY","Metropolitan Statistical Area",2001,633216,9130,3524,8251,4727,6118,1520,4598,-512
"39100",NA,36027,"Dutchess County, NY","County or equivalent",2001,284332,3365,1105,3334,2229,2500,725,1775,-240
"39100",NA,36071,"Orange County, NY","County or equivalent",2001,348884,5765,2419,4917,2498,3618,795,2823,-272
"39140",NA,NA,"Prescott, AZ","Metropolitan Statistical Area",2001,173265,4387,-110,1756,1866,4557,361,4196,-60
"39140",NA,4025,"Yavapai County, AZ","County or equivalent",2001,173265,4387,-110,1756,1866,4557,361,4196,-60
"39300",NA,NA,"Providence-New Bedford-Fall River, RI-MA","Metropolitan Statistical Area",2001,1596705,9911,3961,19114,15153,7422,4375,3047,-1472
"39300",NA,25005,"Bristol County, MA","County or equivalent",2001,538640,2571,1387,6685,5298,1688,822,866,-504
"39300",NA,44001,"Bristol County, RI","County or equivalent",2001,50994,270,-59,464,523,371,25,346,-42
"39300",NA,44003,"Kent County, RI","County or equivalent",2001,168654,1171,162,1894,1732,1146,151,995,-137
"39300",NA,44005,"Newport County, RI","County or equivalent",2001,85433,-225,204,898,694,-358,114,-472,-71
"39300",NA,44007,"Providence County, RI","County or equivalent",2001,627759,4893,1865,7877,6012,3639,3145,494,-611
"39300",NA,44009,"Washington County, RI","County or equivalent",2001,125225,1231,402,1296,894,936,118,818,-107
"39340",NA,NA,"Provo-Orem, UT","Metropolitan Statistical Area",2001,396212,16306,8668,10335,1667,4483,1509,2974,3155
"39340",NA,49023,"Juab County, UT","County or equivalent",2001,8388,117,115,172,57,10,2,8,-8
"39340",NA,49049,"Utah County, UT","County or equivalent",2001,387824,16189,8553,10163,1610,4473,1507,2966,3163
"39380",NA,NA,"Pueblo, CO","Metropolitan Statistical Area",2001,144119,2286,614,2007,1393,1781,182,1599,-109
"39380",NA,8101,"Pueblo County, CO","County or equivalent",2001,144119,2286,614,2007,1393,1781,182,1599,-109
"39460",NA,NA,"Punta Gorda, FL","Metropolitan Statistical Area",2001,145919,3680,-1099,1047,2146,4840,187,4653,-61
"39460",NA,12015,"Charlotte County, FL","County or equivalent",2001,145919,3680,-1099,1047,2146,4840,187,4653,-61
"39540",NA,NA,"Racine, WI","Metropolitan Statistical Area",2001,189938,964,968,2624,1656,-544,286,-830,540
"39540",NA,55101,"Racine County, WI","County or equivalent",2001,189938,964,968,2624,1656,-544,286,-830,540
"39580",NA,NA,"Raleigh-Cary, NC","Metropolitan Statistical Area",2001,835454,31091,8517,13286,4769,21394,5217,16177,1180
"39580",NA,37069,"Franklin County, NC","County or equivalent",2001,48784,1183,223,671,448,986,148,838,-26
"39580",NA,37101,"Johnston County, NC","County or equivalent",2001,127682,4382,1129,2077,948,3310,556,2754,-57
"39580",NA,37183,"Wake County, NC","County or equivalent",2001,658988,25526,7165,10538,3373,17098,4513,12585,1263
"39660",NA,NA,"Rapid City, SD","Metropolitan Statistical Area",2001,114178,1171,948,1770,822,336,48,288,-113
"39660",NA,46093,"Meade County, SD","County or equivalent",2001,24199,-14,210,382,172,-200,-1,-199,-24
"39660",NA,46103,"Pennington County, SD","County or equivalent",2001,89979,1185,738,1388,650,536,49,487,-89
"39740",NA,NA,"Reading, PA","Metropolitan Statistical Area",2001,377068,2571,992,4704,3712,1913,633,1280,-334
"39740",NA,42011,"Berks County, PA","County or equivalent",2001,377068,2571,992,4704,3712,1913,633,1280,-334
"39820",NA,NA,"Redding, CA","Metropolitan Statistical Area",2001,166962,3180,99,1850,1751,3192,129,3063,-111
"39820",NA,6089,"Shasta County, CA","County or equivalent",2001,166962,3180,99,1850,1751,3192,129,3063,-111
"39900",NA,NA,"Reno-Sparks, NV","Metropolitan Statistical Area",2001,355006,10228,2478,5072,2594,7997,1872,6125,-247
"39900",NA,32029,"Storey County, NV","County or equivalent",2001,3416,23,-17,4,21,45,4,41,-5
"39900",NA,32031,"Washoe County, NV","County or equivalent",2001,351590,10205,2495,5068,2573,7952,1868,6084,-242
"40060",NA,NA,"Richmond, VA","Metropolitan Statistical Area",2001,1110879,10753,5200,14918,9718,6586,2048,4538,-1033
"40060",NA,51007,"Amelia County, VA","County or equivalent",2001,11537,59,40,160,120,32,1,31,-13
"40060",NA,51033,"Caroline County, VA","County or equivalent",2001,22132,-2,29,253,224,-7,10,-17,-24
"40060",NA,51036,"Charles City County, VA","County or equivalent",2001,6947,21,8,69,61,20,2,18,-7
"40060",NA,51041,"Chesterfield County, VA","County or equivalent",2001,264469,3608,1842,3303,1461,2012,503,1509,-246
"40060",NA,51049,"Cumberland County, VA","County or equivalent",2001,8986,-12,11,89,78,-12,10,-22,-11
"40060",NA,51053,"Dinwiddie County, VA","County or equivalent",2001,24435,-195,50,242,192,-218,6,-224,-27
"40060",NA,51075,"Goochland County, VA","County or equivalent",2001,17256,320,52,206,154,282,13,269,-14
"40060",NA,51085,"Hanover County, VA","County or equivalent",2001,88895,1901,446,1092,646,1525,47,1478,-70
"40060",NA,51087,"Henrico County, VA","County or equivalent",2001,265957,2695,1360,3736,2376,1596,952,644,-261
"40060",NA,51097,"King and Queen County, VA","County or equivalent",2001,6598,-23,-3,73,76,-13,-1,-12,-7
"40060",NA,51101,"King William County, VA","County or equivalent",2001,13437,240,61,196,135,190,6,184,-11
"40060",NA,51109,"Louisa County, VA","County or equivalent",2001,26286,520,60,322,262,477,5,472,-17
"40060",NA,51127,"New Kent County, VA","County or equivalent",2001,13884,354,47,147,100,313,0,313,-6
"40060",NA,51145,"Powhatan County, VA","County or equivalent",2001,23080,473,154,279,125,337,1,336,-18
"40060",NA,51149,"Prince George County, VA","County or equivalent",2001,33915,732,259,410,151,497,-18,515,-24
"40060",NA,51183,"Sussex County, VA","County or equivalent",2001,12268,-208,-29,124,153,-169,11,-180,-10
"40060",NA,51570,"Colonial Heights city, VA","County or equivalent",2001,17045,135,-4,202,206,157,22,135,-18
"40060",NA,51670,"Hopewell city, VA","County or equivalent",2001,22249,-54,78,367,289,-112,16,-128,-20
"40060",NA,51730,"Petersburg city, VA","County or equivalent",2001,33299,-282,36,530,494,-290,16,-306,-28
"40060",NA,51760,"Richmond city, VA","County or equivalent",2001,198204,471,703,3118,2415,-31,446,-477,-201
"40140",NA,NA,"Riverside-San Bernardino-Ontario, CA","Metropolitan Statistical Area",2001,3378073,100121,30071,54032,23961,72194,14982,57212,-2144
"40140",NA,6065,"Riverside County, CA","County or equivalent",2001,1615534,56257,12557,25102,12545,44568,7582,36986,-868
"40140",NA,6071,"San Bernardino County, CA","County or equivalent",2001,1762539,43864,17514,28930,11416,27626,7400,20226,-1276
"40220",NA,NA,"Roanoke, VA","Metropolitan Statistical Area",2001,288591,149,115,3317,3202,305,331,-26,-271
"40220",NA,51023,"Botetourt County, VA","County or equivalent",2001,30666,102,26,281,255,105,2,103,-29
"40220",NA,51045,"Craig County, VA","County or equivalent",2001,5061,-31,21,60,39,-47,1,-48,-5
"40220",NA,51067,"Franklin County, VA","County or equivalent",2001,47882,449,100,535,435,386,8,378,-37
"40220",NA,51161,"Roanoke County, VA","County or equivalent",2001,85800,48,-24,816,840,161,114,47,-89
"40220",NA,51770,"Roanoke city, VA","County or equivalent",2001,94541,-256,139,1399,1260,-311,186,-497,-84
"40220",NA,51775,"Salem city, VA","County or equivalent",2001,24641,-163,-147,226,373,11,20,-9,-27
"40340",NA,NA,"Rochester, MN","Metropolitan Statistical Area",2001,166625,2235,1317,2385,1068,1090,720,370,-172
"40340",NA,27039,"Dodge County, MN","County or equivalent",2001,18098,244,121,242,121,139,21,118,-16
"40340",NA,27109,"Olmsted County, MN","County or equivalent",2001,126736,1853,1113,1879,766,874,657,217,-134
"40340",NA,27157,"Wabasha County, MN","County or equivalent",2001,21791,138,83,264,181,77,42,35,-22
"40380",NA,NA,"Rochester, NY","Metropolitan Statistical Area",2001,1041383,-422,3649,12637,8988,-3180,1985,-5165,-891
"40380",NA,36051,"Livingston County, NY","County or equivalent",2001,64455,95,129,633,504,30,10,20,-64
"40380",NA,36055,"Monroe County, NY","County or equivalent",2001,738766,-248,2811,9206,6395,-2443,1854,-4297,-616
"40380",NA,36069,"Ontario County, NY","County or equivalent",2001,100773,487,300,1160,860,289,69,220,-102
"40380",NA,36073,"Orleans County, NY","County or equivalent",2001,43685,-464,61,477,416,-494,17,-511,-31
"40380",NA,36117,"Wayne County, NY","County or equivalent",2001,93704,-292,348,1161,813,-562,35,-597,-78
"40420",NA,NA,"Rockford, IL","Metropolitan Statistical Area",2001,323933,2930,1721,4499,2778,723,998,-275,486
"40420",NA,17007,"Boone County, IL","County or equivalent",2001,43189,1134,328,613,285,839,143,696,-33
"40420",NA,17201,"Winnebago County, IL","County or equivalent",2001,280744,1796,1393,3886,2493,-116,855,-971,519
"40580",NA,NA,"Rocky Mount, NC","Metropolitan Statistical Area",2001,143301,258,584,2090,1506,-120,216,-336,-206
"40580",NA,37065,"Edgecombe County, NC","County or equivalent",2001,55124,-214,183,794,611,-287,94,-381,-110
"40580",NA,37127,"Nash County, NC","County or equivalent",2001,88177,472,401,1296,895,167,122,45,-96
"40660",NA,NA,"Rome, GA","Metropolitan Statistical Area",2001,91136,340,411,1390,979,24,251,-227,-95
"40660",NA,13115,"Floyd County, GA","County or equivalent",2001,91136,340,411,1390,979,24,251,-227,-95
"40900",NA,NA,"Sacramento--Arden-Arcade--Roseville, CA","Metropolitan Statistical Area",2001,1866408,57908,12063,25665,13602,47010,9736,37274,-1165
"40900",NA,6017,"El Dorado County, CA","County or equivalent",2001,160814,3686,540,1688,1148,3228,321,2907,-82
"40900",NA,6061,"Placer County, CA","County or equivalent",2001,264212,12957,1116,3069,1953,11967,537,11430,-126
"40900",NA,6067,"Sacramento County, CA","County or equivalent",2001,1265948,35701,9290,18645,9355,27240,7298,19942,-829
"40900",NA,6113,"Yolo County, CA","County or equivalent",2001,175434,5564,1117,2263,1146,4575,1580,2995,-128
"40980",NA,NA,"Saginaw-Saginaw Township North, MI","Metropolitan Statistical Area",2001,209351,-575,662,2753,2091,-1054,157,-1211,-183
"40980",NA,26145,"Saginaw County, MI","County or equivalent",2001,209351,-575,662,2753,2091,-1054,157,-1211,-183
"41060",NA,NA,"St. Cloud, MN","Metropolitan Statistical Area",2001,171645,3623,1189,2299,1110,996,186,810,1438
"41060",NA,27009,"Benton County, MN","County or equivalent",2001,35690,1194,249,563,314,771,34,737,174
"41060",NA,27145,"Stearns County, MN","County or equivalent",2001,135955,2429,940,1736,796,225,152,73,1264
"41100",NA,NA,"St. George, UT","Metropolitan Statistical Area",2001,94613,3359,1076,1741,665,2351,171,2180,-68
"41100",NA,49053,"Washington County, UT","County or equivalent",2001,94613,3359,1076,1741,665,2351,171,2180,-68
"41140",NA,NA,"St. Joseph, MO-KS","Metropolitan Statistical Area",2001,123964,-5,135,1460,1325,-466,37,-503,326
"41140",NA,20043,"Doniphan County, KS","County or equivalent",2001,8186,-49,-9,84,93,-31,0,-31,-9
"41140",NA,29003,"Andrew County, MO","County or equivalent",2001,16589,59,12,171,159,64,1,63,-17
"41140",NA,29021,"Buchanan County, MO","County or equivalent",2001,86177,83,138,1090,952,-419,31,-450,364
"41140",NA,29063,"DeKalb County, MO","County or equivalent",2001,13012,-98,-6,115,121,-80,5,-85,-12
"41180",NA,NA,"St. Louis, MO-IL","Metropolitan Statistical Area",2001,2718858,17321,10808,36167,25359,-291,4129,-4420,6804
"41180",NA,17005,"Bond County, IL","County or equivalent",2001,17610,-40,5,184,179,-28,3,-31,-17
"41180",NA,17013,"Calhoun County, IL","County or equivalent",2001,5042,-48,-19,48,67,-24,1,-25,-5
"41180",NA,17027,"Clinton County, IL","County or equivalent",2001,35629,100,84,405,321,50,14,36,-34
"41180",NA,17083,"Jersey County, IL","County or equivalent",2001,21709,54,-11,223,234,89,2,87,-24
"41180",NA,17117,"Macoupin County, IL","County or equivalent",2001,48832,-157,-15,585,600,-99,3,-102,-43
"41180",NA,17119,"Madison County, IL","County or equivalent",2001,260434,1317,765,3388,2623,373,97,276,179
"41180",NA,17133,"Monroe County, IL","County or equivalent",2001,28371,607,119,365,246,429,8,421,59
"41180",NA,17163,"St. Clair County, IL","County or equivalent",2001,255895,-309,1166,3689,2523,-1632,51,-1683,157
"41180",NA,29071,"Franklin County, MO","County or equivalent",2001,94854,796,440,1276,836,446,7,439,-90
"41180",NA,29099,"Jefferson County, MO","County or equivalent",2001,200655,1917,1138,2614,1476,972,73,899,-193
"41180",NA,29113,"Lincoln County, MO","County or equivalent",2001,40751,1495,258,567,309,1248,9,1239,-11
"41180",NA,29183,"St. Charles County, MO","County or equivalent",2001,294653,8490,2618,4241,1623,6083,199,5884,-211
"41180",NA,29189,"St. Louis County, MO","County or equivalent",2001,1015690,-640,2895,12647,9752,-2644,1909,-4553,-891
"41180",NA,29219,"Warren County, MO","County or equivalent",2001,25324,604,109,316,207,508,15,493,-13
"41180",NA,29221,"Washington County, MO","County or equivalent",2001,23454,44,104,311,207,-38,5,-43,-22
"41180",NA,29510,"St. Louis city, MO","County or equivalent",2001,349955,3091,1152,5308,4156,-6024,1733,-7757,7963
"41420",NA,NA,"Salem, OR","Metropolitan Statistical Area",2001,352568,4352,2296,5222,2926,2399,1966,433,-343
"41420",NA,41047,"Marion County, OR","County or equivalent",2001,288772,3210,2051,4466,2415,1437,1771,-334,-278
"41420",NA,41053,"Polk County, OR","County or equivalent",2001,63796,1142,245,756,511,962,195,767,-65
"41500",NA,NA,"Salinas, CA","Metropolitan Statistical Area",2001,407350,4255,4528,7003,2475,53,4167,-4114,-326
"41500",NA,6053,"Monterey County, CA","County or equivalent",2001,407350,4255,4528,7003,2475,53,4167,-4114,-326
"41540",NA,NA,"Salisbury, MD","Metropolitan Statistical Area",2001,110431,849,345,1417,1072,604,185,419,-100
"41540",NA,24039,"Somerset County, MD","County or equivalent",2001,25160,439,2,272,270,452,31,421,-15
"41540",NA,24045,"Wicomico County, MD","County or equivalent",2001,85271,410,343,1145,802,152,154,-2,-85
"41620",NA,NA,"Salt Lake City, UT","Metropolitan Statistical Area",2001,988900,16294,14326,19777,5451,-1235,6110,-7345,3203
"41620",NA,49035,"Salt Lake County, UT","County or equivalent",2001,914237,13233,13196,18335,5139,-3197,5847,-9044,3234
"41620",NA,49043,"Summit County, UT","County or equivalent",2001,30924,937,378,484,106,581,165,416,-22
"41620",NA,49045,"Tooele County, UT","County or equivalent",2001,43739,2124,752,958,206,1381,98,1283,-9
"41660",NA,NA,"San Angelo, TX","Metropolitan Statistical Area",2001,105540,-270,569,1613,1044,-751,91,-842,-88
"41660",NA,48235,"Irion County, TX","County or equivalent",2001,1700,-69,-7,7,14,-61,2,-63,-1
"41660",NA,48451,"Tom Green County, TX","County or equivalent",2001,103840,-201,576,1606,1030,-690,89,-779,-87
"41700",NA,NA,"San Antonio, TX","Metropolitan Statistical Area",2001,1743870,24600,15754,28484,12730,10454,4803,5651,-1608
"41700",NA,48013,"Atascosa County, TX","County or equivalent",2001,39871,997,371,672,301,655,37,618,-29
"41700",NA,48019,"Bandera County, TX","County or equivalent",2001,18201,389,33,197,164,365,20,345,-9
"41700",NA,48029,"Bexar County, TX","County or equivalent",2001,1414634,16803,13888,24049,10161,4313,4386,-73,-1398
"41700",NA,48091,"Comal County, TX","County or equivalent",2001,81419,2675,423,1103,680,2280,109,2171,-28
"41700",NA,48187,"Guadalupe County, TX","County or equivalent",2001,92045,2173,619,1217,598,1624,185,1439,-70
"41700",NA,48259,"Kendall County, TX","County or equivalent",2001,24511,542,65,305,240,494,41,453,-17
"41700",NA,48325,"Medina County, TX","County or equivalent",2001,39927,465,179,518,339,320,18,302,-34
"41700",NA,48493,"Wilson County, TX","County or equivalent",2001,33262,556,176,423,247,403,7,396,-23
"41740",NA,NA,"San Diego-Carlsbad-San Marcos, CA","Metropolitan Statistical Area",2001,2869630,44235,24208,44094,19886,22700,16254,6446,-2673
"41740",NA,6073,"San Diego County, CA","County or equivalent",2001,2869630,44235,24208,44094,19886,22700,16254,6446,-2673
"41780",NA,NA,"Sandusky, OH","Metropolitan Statistical Area",2001,79228,-377,134,924,790,-447,26,-473,-64
"41780",NA,39043,"Erie County, OH","County or equivalent",2001,79228,-377,134,924,790,-447,26,-473,-64
"41860",NA,NA,"San Francisco-Oakland-Fremont, CA","Metropolitan Statistical Area",2001,4181279,44008,27269,57443,30174,13306,38223,-24917,3433
"41860",36084,NA,"Oakland-Fremont-Hayward, CA","Metropolitan Division",2001,2441672,37972,18675,35559,16884,21487,20692,795,-2190
"41860",36084,6001,"Alameda County, CA","County or equivalent",2001,1469656,19260,12228,22328,10100,8454,14978,-6524,-1422
"41860",36084,6013,"Contra Costa County, CA","County or equivalent",2001,972016,18712,6447,13231,6784,13033,5714,7319,-768
"41860",41884,NA,"San Francisco-San Mateo-Redwood City, CA","Metropolitan Division",2001,1739607,6036,8594,21884,13290,-8181,17531,-25712,5623
"41860",41884,6041,"Marin County, CA","County or equivalent",2001,248032,435,1029,2871,1842,-368,1478,-1846,-226
"41860",41884,6075,"San Francisco County, CA","County or equivalent",2001,784385,6853,1996,8610,6614,-1474,8571,-10045,6331
"41860",41884,6081,"San Mateo County, CA","County or equivalent",2001,707190,-1252,5569,10403,4834,-6339,7482,-13821,-482
"41940",NA,NA,"San Jose-Sunnyvale-Santa Clara, CA","Metropolitan Statistical Area",2001,1746353,6376,19421,28637,9216,-11982,24902,-36884,-1063
"41940",NA,6069,"San Benito County, CA","County or equivalent",2001,54741,918,630,897,267,345,331,14,-57
"41940",NA,6085,"Santa Clara County, CA","County or equivalent",2001,1691612,5458,18791,27740,8949,-12327,24571,-36898,-1006
"42020",NA,NA,"San Luis Obispo-Paso Robles, CA","Metropolitan Statistical Area",2001,251525,3649,368,2450,2082,3450,604,2846,-169
"42020",NA,6079,"San Luis Obispo County, CA","County or equivalent",2001,251525,3649,368,2450,2082,3450,604,2846,-169
"42060",NA,NA,"Santa Barbara-Santa Maria-Goleta, CA","Metropolitan Statistical Area",2001,401690,1864,2825,5713,2888,-655,2776,-3431,-306
"42060",NA,6083,"Santa Barbara County, CA","County or equivalent",2001,401690,1864,2825,5713,2888,-655,2776,-3431,-306
"42100",NA,NA,"Santa Cruz-Watsonville, CA","Metropolitan Statistical Area",2001,255754,-96,1813,3509,1696,-1702,1498,-3200,-207
"42100",NA,6087,"Santa Cruz County, CA","County or equivalent",2001,255754,-96,1813,3509,1696,-1702,1498,-3200,-207
"42140",NA,NA,"Santa Fe, NM","Metropolitan Statistical Area",2001,131563,1741,826,1611,785,1039,740,299,-124
"42140",NA,35049,"Santa Fe County, NM","County or equivalent",2001,131563,1741,826,1611,785,1039,740,299,-124
"42220",NA,NA,"Santa Rosa-Petaluma, CA","Metropolitan Statistical Area",2001,464608,4183,1716,5648,3932,2937,2447,490,-470
"42220",NA,6097,"Sonoma County, CA","County or equivalent",2001,464608,4183,1716,5648,3932,2937,2447,490,-470
"42340",NA,NA,"Savannah, GA","Metropolitan Statistical Area",2001,296993,3333,1765,4518,2753,1828,445,1383,-260
"42340",NA,13029,"Bryan County, GA","County or equivalent",2001,24115,605,213,358,145,404,8,396,-12
"42340",NA,13051,"Chatham County, GA","County or equivalent",2001,233566,1231,1223,3562,2339,241,425,-184,-233
"42340",NA,13103,"Effingham County, GA","County or equivalent",2001,39312,1497,329,598,269,1183,12,1171,-15
"42540",NA,NA,"Scranton--Wilkes-Barre, PA","Metropolitan Statistical Area",2001,555595,-3919,-2040,5562,7602,-1354,295,-1649,-525
"42540",NA,42069,"Lackawanna County, PA","County or equivalent",2001,212022,-891,-634,2240,2874,-61,125,-186,-196
"42540",NA,42079,"Luzerne County, PA","County or equivalent",2001,315487,-3068,-1470,2989,4459,-1298,166,-1464,-300
"42540",NA,42131,"Wyoming County, PA","County or equivalent",2001,28086,40,64,333,269,5,4,1,-29
"42660",NA,NA,"Seattle-Tacoma-Bellevue, WA","Metropolitan Statistical Area",2001,3094159,41664,20116,41004,20888,21206,16244,4962,342
"42660",42644,NA,"Seattle-Bellevue-Everett, WA","Metropolitan Division",2001,2377949,29422,15280,30836,15556,13246,14556,-1310,896
"42660",42644,53033,"King County, WA","County or equivalent",2001,1756766,17351,10503,22182,11679,5418,12286,-6868,1430
"42660",42644,53061,"Snohomish County, WA","County or equivalent",2001,621183,12071,4777,8654,3877,7828,2270,5558,-534
"42660",45104,NA,"Tacoma, WA","Metropolitan Division",2001,716210,12242,4836,10168,5332,7960,1688,6272,-554
"42660",45104,53053,"Pierce County, WA","County or equivalent",2001,716210,12242,4836,10168,5332,7960,1688,6272,-554
"42680",NA,NA,"Sebastian-Vero Beach, FL","Metropolitan Statistical Area",2001,115287,1911,-473,1097,1570,2435,311,2124,-51
"42680",NA,12061,"Indian River County, FL","County or equivalent",2001,115287,1911,-473,1097,1570,2435,311,2124,-51
"43100",NA,NA,"Sheboygan, WI","Metropolitan Statistical Area",2001,112872,127,38,1106,1068,203,170,33,-114
"43100",NA,55117,"Sheboygan County, WI","County or equivalent",2001,112872,127,38,1106,1068,203,170,33,-114
"43300",NA,NA,"Sherman-Denison, TX","Metropolitan Statistical Area",2001,112381,1395,192,1490,1298,1293,242,1051,-90
"43300",NA,48181,"Grayson County, TX","County or equivalent",2001,112381,1395,192,1490,1298,1293,242,1051,-90
"43340",NA,NA,"Shreveport-Bossier City, LA","Metropolitan Statistical Area",2001,375915,-207,1904,5699,3795,-1783,160,-1943,-328
"43340",NA,22015,"Bossier Parish, LA","County or equivalent",2001,99797,990,745,1541,796,336,30,306,-91
"43340",NA,22017,"Caddo Parish, LA","County or equivalent",2001,250666,-1136,1103,3787,2684,-2027,121,-2148,-212
"43340",NA,22031,"De Soto Parish, LA","County or equivalent",2001,25452,-61,56,371,315,-92,9,-101,-25
"43580",NA,NA,"Sioux City, IA-NE-SD","Metropolitan Statistical Area",2001,142470,-525,1084,2298,1214,-1514,595,-2109,-95
"43580",NA,19193,"Woodbury County, IA","County or equivalent",2001,103313,-503,813,1694,881,-1249,408,-1657,-67
"43580",NA,31043,"Dakota County, NE","County or equivalent",2001,20270,-3,216,361,145,-207,153,-360,-12
"43580",NA,31051,"Dixon County, NE","County or equivalent",2001,6251,-65,4,75,71,-65,14,-79,-4
"43580",NA,46127,"Union County, SD","County or equivalent",2001,12636,46,51,168,117,7,20,-13,-12
"43620",NA,NA,"Sioux Falls, SD","Metropolitan Statistical Area",2001,193214,4908,1473,2910,1437,2407,453,1954,1028
"43620",NA,46083,"Lincoln County, SD","County or equivalent",2001,26168,1639,269,421,152,1294,19,1275,76
"43620",NA,46087,"McCook County, SD","County or equivalent",2001,5869,20,6,70,64,20,0,20,-6
"43620",NA,46099,"Minnehaha County, SD","County or equivalent",2001,152435,3356,1235,2338,1103,1156,434,722,965
"43620",NA,46125,"Turner County, SD","County or equivalent",2001,8742,-107,-37,81,118,-63,0,-63,-7
"43780",NA,NA,"South Bend-Mishawaka, IN-MI","Metropolitan Statistical Area",2001,316588,-365,1539,4425,2886,-1626,668,-2294,-278
"43780",NA,18141,"St. Joseph County, IN","County or equivalent",2001,265477,-357,1460,3895,2435,-1591,647,-2238,-226
"43780",NA,26027,"Cass County, MI","County or equivalent",2001,51111,-8,79,530,451,-35,21,-56,-52
"43900",NA,NA,"Spartanburg, SC","Metropolitan Statistical Area",2001,256693,2297,790,3413,2623,1741,495,1246,-234
"43900",NA,45083,"Spartanburg County, SC","County or equivalent",2001,256693,2297,790,3413,2623,1741,495,1246,-234
"44060",NA,NA,"Spokane, WA","Metropolitan Statistical Area",2001,422780,3974,1820,5550,3730,2563,831,1732,-409
"44060",NA,53063,"Spokane County, WA","County or equivalent",2001,422780,3974,1820,5550,3730,2563,831,1732,-409
"44100",NA,NA,"Springfield, IL","Metropolitan Statistical Area",2001,202766,1182,852,2837,1985,-193,98,-291,523
"44100",NA,17129,"Menard County, IL","County or equivalent",2001,12484,-10,34,157,123,-32,3,-35,-12
"44100",NA,17167,"Sangamon County, IL","County or equivalent",2001,190282,1192,818,2680,1862,-161,95,-256,535
"44140",NA,NA,"Springfield, MA","Metropolitan Statistical Area",2001,680295,-142,1225,7784,6559,-756,1772,-2528,-611
"44140",NA,25011,"Franklin County, MA","County or equivalent",2001,71669,176,51,711,660,198,120,78,-73
"44140",NA,25013,"Hampden County, MA","County or equivalent",2001,456361,-204,1088,5747,4659,-899,1325,-2224,-393
"44140",NA,25015,"Hampshire County, MA","County or equivalent",2001,152265,-114,86,1326,1240,-55,327,-382,-145
"44180",NA,NA,"Springfield, MO","Metropolitan Statistical Area",2001,374723,4952,1521,4995,3474,3756,227,3529,-325
"44180",NA,29043,"Christian County, MO","County or equivalent",2001,56930,1978,446,863,417,1564,9,1555,-32
"44180",NA,29059,"Dallas County, MO","County or equivalent",2001,15734,44,37,207,170,22,3,19,-15
"44180",NA,29077,"Greene County, MO","County or equivalent",2001,242665,1862,699,3062,2363,1389,177,1212,-226
"44180",NA,29167,"Polk County, MO","County or equivalent",2001,27432,367,88,345,257,308,30,278,-29
"44180",NA,29225,"Webster County, MO","County or equivalent",2001,31962,701,251,518,267,473,8,465,-23
"44220",NA,NA,"Springfield, OH","Metropolitan Statistical Area",2001,143926,-734,335,1997,1662,-954,31,-985,-115
"44220",NA,39023,"Clark County, OH","County or equivalent",2001,143926,-734,335,1997,1662,-954,31,-985,-115
"44300",NA,NA,"State College, PA","Metropolitan Statistical Area",2001,136836,925,412,1272,860,648,671,-23,-135
"44300",NA,42027,"Centre County, PA","County or equivalent",2001,136836,925,412,1272,860,648,671,-23,-135
"44700",NA,NA,"Stockton, CA","Metropolitan Statistical Area",2001,591263,23240,5410,9841,4431,18078,3261,14817,-248
"44700",NA,6077,"San Joaquin County, CA","County or equivalent",2001,591263,23240,5410,9841,4431,18078,3261,14817,-248
"44940",NA,NA,"Sumter, SC","Metropolitan Statistical Area",2001,104212,-442,862,1775,913,-1232,14,-1246,-72
"44940",NA,45085,"Sumter County, SC","County or equivalent",2001,104212,-442,862,1775,913,-1232,14,-1246,-72
"45060",NA,NA,"Syracuse, NY","Metropolitan Statistical Area",2001,648902,-880,2422,8088,5666,-2728,1100,-3828,-574
"45060",NA,36053,"Madison County, NY","County or equivalent",2001,69445,24,211,780,569,-123,31,-154,-64
"45060",NA,36067,"Onondaga County, NY","County or equivalent",2001,457283,-591,1854,5909,4055,-2042,1039,-3081,-403
"45060",NA,36075,"Oswego County, NY","County or equivalent",2001,122174,-313,357,1399,1042,-563,30,-593,-107
"45220",NA,NA,"Tallahassee, FL","Metropolitan Statistical Area",2001,324521,3187,1870,4148,2278,1594,628,966,-277
"45220",NA,12039,"Gadsden County, FL","County or equivalent",2001,45463,402,280,706,426,165,77,88,-43
"45220",NA,12065,"Jefferson County, FL","County or equivalent",2001,13386,480,-36,141,177,516,0,516,0
"45220",NA,12073,"Leon County, FL","County or equivalent",2001,241590,1212,1506,3006,1500,-63,544,-607,-231
"45220",NA,12129,"Wakulla County, FL","County or equivalent",2001,24082,1093,120,295,175,976,7,969,-3
"45300",NA,NA,"Tampa-St. Petersburg-Clearwater, FL","Metropolitan Statistical Area",2001,2442259,37978,218,29404,29186,39439,8927,30512,-1679
"45300",NA,12053,"Hernando County, FL","County or equivalent",2001,134077,2644,-867,1201,2068,3541,91,3450,-30
"45300",NA,12057,"Hillsborough County, FL","County or equivalent",2001,1026388,23122,5994,14845,8851,17807,5049,12758,-679
"45300",NA,12101,"Pasco County, FL","County or equivalent",2001,358541,11267,-1440,3777,5217,12754,683,12071,-47
"45300",NA,12103,"Pinellas County, FL","County or equivalent",2001,923253,945,-3469,9581,13050,5337,3104,2233,-923
"45460",NA,NA,"Terre Haute, IN","Metropolitan Statistical Area",2001,170197,-616,83,2081,1998,-543,133,-676,-156
"45460",NA,18021,"Clay County, IN","County or equivalent",2001,26559,-6,25,338,313,-4,11,-15,-27
"45460",NA,18153,"Sullivan County, IN","County or equivalent",2001,21725,-17,-11,254,265,15,2,13,-21
"45460",NA,18165,"Vermillion County, IN","County or equivalent",2001,16611,-159,-26,191,217,-120,6,-126,-13
"45460",NA,18167,"Vigo County, IN","County or equivalent",2001,105302,-434,95,1298,1203,-434,114,-548,-95
"45500",NA,NA,"Texarkana, TX-Texarkana, AR","Metropolitan Statistical Area",2001,129868,184,362,1766,1404,-54,81,-135,-124
"45500",NA,5091,"Miller County, AR","County or equivalent",2001,40638,202,207,573,366,36,26,10,-41
"45500",NA,48037,"Bowie County, TX","County or equivalent",2001,89230,-18,155,1193,1038,-90,55,-145,-83
"45780",NA,NA,"Toledo, OH","Metropolitan Statistical Area",2001,659407,205,2479,9015,6536,-1701,672,-2373,-573
"45780",NA,39051,"Fulton County, OH","County or equivalent",2001,42152,18,232,592,360,-174,10,-184,-40
"45780",NA,39095,"Lucas County, OH","County or equivalent",2001,454392,-480,1749,6585,4836,-1838,533,-2371,-391
"45780",NA,39123,"Ottawa County, OH","County or equivalent",2001,40972,-32,16,428,412,-31,4,-35,-17
"45780",NA,39173,"Wood County, OH","County or equivalent",2001,121891,699,482,1410,928,342,125,217,-125
"45820",NA,NA,"Topeka, KS","Metropolitan Statistical Area",2001,224883,96,712,3035,2323,-412,230,-642,-204
"45820",NA,20085,"Jackson County, KS","County or equivalent",2001,12687,23,34,159,125,1,1,0,-12
"45820",NA,20087,"Jefferson County, KS","County or equivalent",2001,18463,20,37,199,162,2,5,-3,-19
"45820",NA,20139,"Osage County, KS","County or equivalent",2001,16641,-117,-19,174,193,-84,3,-87,-14
"45820",NA,20177,"Shawnee County, KS","County or equivalent",2001,170310,261,651,2421,1770,-235,220,-455,-155
"45820",NA,20197,"Wabaunsee County, KS","County or equivalent",2001,6782,-91,9,82,73,-96,1,-97,-4
"45940",NA,NA,"Trenton-Ewing, NJ","Metropolitan Statistical Area",2001,353994,2460,1795,4745,2950,1000,2287,-1287,-335
"45940",NA,34021,"Mercer County, NJ","County or equivalent",2001,353994,2460,1795,4745,2950,1000,2287,-1287,-335
"46060",NA,NA,"Tucson, AZ","Metropolitan Statistical Area",2001,865660,17111,4974,12383,7409,7978,3405,4573,4159
"46060",NA,4019,"Pima County, AZ","County or equivalent",2001,865660,17111,4974,12383,7409,7978,3405,4573,4159
"46140",NA,NA,"Tulsa, OK","Metropolitan Statistical Area",2001,867570,6237,5152,13113,7961,1860,1948,-88,-775
"46140",NA,40037,"Creek County, OK","County or equivalent",2001,67910,340,153,850,697,260,10,250,-73
"46140",NA,40111,"Okmulgee County, OK","County or equivalent",2001,39580,-57,80,539,459,-99,12,-111,-38
"46140",NA,40113,"Osage County, OK","County or equivalent",2001,44936,384,125,492,367,307,22,285,-48
"46140",NA,40117,"Pawnee County, OK","County or equivalent",2001,16767,80,24,209,185,71,1,70,-15
"46140",NA,40131,"Rogers County, OK","County or equivalent",2001,72965,1595,383,932,549,1260,35,1225,-48
"46140",NA,40143,"Tulsa County, OK","County or equivalent",2001,566657,2838,4011,9338,5327,-665,1822,-2487,-508
"46140",NA,40145,"Wagoner County, OK","County or equivalent",2001,58755,1057,376,753,377,726,46,680,-45
"46220",NA,NA,"Tuscaloosa, AL","Metropolitan Statistical Area",2001,193981,573,917,2672,1755,-158,247,-405,-186
"46220",NA,1063,"Greene County, AL","County or equivalent",2001,9861,-81,43,142,99,-117,1,-118,-7
"46220",NA,1065,"Hale County, AL","County or equivalent",2001,18256,-18,79,271,192,-80,1,-81,-17
"46220",NA,1125,"Tuscaloosa County, AL","County or equivalent",2001,165864,672,795,2259,1464,39,245,-206,-162
"46340",NA,NA,"Tyler, TX","Metropolitan Statistical Area",2001,177488,1993,834,2658,1824,1336,592,744,-177
"46340",NA,48423,"Smith County, TX","County or equivalent",2001,177488,1993,834,2658,1824,1336,592,744,-177
"46540",NA,NA,"Utica-Rome, NY","Metropolitan Statistical Area",2001,297658,-1757,-255,3158,3413,-1253,786,-2039,-249
"46540",NA,36043,"Herkimer County, NY","County or equivalent",2001,63957,-426,-77,675,752,-293,19,-312,-56
"46540",NA,36065,"Oneida County, NY","County or equivalent",2001,233701,-1331,-178,2483,2661,-960,767,-1727,-193
"46660",NA,NA,"Valdosta, GA","Metropolitan Statistical Area",2001,119749,12,764,1763,999,-641,134,-775,-111
"46660",NA,13027,"Brooks County, GA","County or equivalent",2001,16309,-150,18,222,204,-151,13,-164,-17
"46660",NA,13101,"Echols County, GA","County or equivalent",2001,3811,20,11,41,30,14,54,-40,-5
"46660",NA,13173,"Lanier County, GA","County or equivalent",2001,7105,-147,2,72,70,-145,6,-151,-4
"46660",NA,13185,"Lowndes County, GA","County or equivalent",2001,92524,289,733,1428,695,-359,61,-420,-85
"46700",NA,NA,"Vallejo-Fairfield, CA","Metropolitan Statistical Area",2001,403955,6984,3308,5879,2571,4040,1628,2412,-364
"46700",NA,6095,"Solano County, CA","County or equivalent",2001,403955,6984,3308,5879,2571,4040,1628,2412,-364
"47020",NA,NA,"Victoria, TX","Metropolitan Statistical Area",2001,112310,670,868,1772,904,-85,213,-298,-113
"47020",NA,48057,"Calhoun County, TX","County or equivalent",2001,20648,-11,155,318,163,-149,93,-242,-17
"47020",NA,48175,"Goliad County, TX","County or equivalent",2001,6997,23,22,81,59,9,4,5,-8
"47020",NA,48469,"Victoria County, TX","County or equivalent",2001,84665,658,691,1373,682,55,116,-61,-88
"47220",NA,NA,"Vineland-Millville-Bridgeton, NJ","Metropolitan Statistical Area",2001,146635,284,613,2075,1462,-203,488,-691,-126
"47220",NA,34011,"Cumberland County, NJ","County or equivalent",2001,146635,284,613,2075,1462,-203,488,-691,-126
"47260",NA,NA,"Virginia Beach-Norfolk-Newport News, VA-NC","Metropolitan Statistical Area",2001,1587133,6839,11410,23363,11953,-3665,1046,-4711,-906
"47260",NA,37053,"Currituck County, NC","County or equivalent",2001,18757,463,70,234,164,402,0,402,-9
"47260",NA,51073,"Gloucester County, VA","County or equivalent",2001,35170,307,83,393,310,256,2,254,-32
"47260",NA,51093,"Isle of Wight County, VA","County or equivalent",2001,30202,329,50,324,274,308,7,301,-29
"47260",NA,51095,"James City County, VA","County or equivalent",2001,49570,1076,116,465,349,1004,57,947,-44
"47260",NA,51115,"Mathews County, VA","County or equivalent",2001,9265,77,-56,74,130,139,1,138,-6
"47260",NA,51181,"Surry County, VA","County or equivalent",2001,6841,0,19,80,61,-11,0,-11,-8
"47260",NA,51199,"York County, VA","County or equivalent",2001,57626,1093,342,683,341,801,47,754,-50
"47260",NA,51550,"Chesapeake city, VA","County or equivalent",2001,202510,2236,1457,2789,1332,984,66,918,-205
"47260",NA,51650,"Hampton city, VA","County or equivalent",2001,145196,-1220,866,2009,1143,-1989,82,-2071,-97
"47260",NA,51700,"Newport News city, VA","County or equivalent",2001,180192,-387,1753,3191,1438,-2015,214,-2229,-125
"47260",NA,51710,"Norfolk city, VA","County or equivalent",2001,234688,424,2018,4075,2057,-1793,106,-1899,199
"47260",NA,51735,"Poquoson city, VA","County or equivalent",2001,11479,-95,26,95,69,-113,3,-116,-8
"47260",NA,51740,"Portsmouth city, VA","County or equivalent",2001,99737,-692,473,1568,1095,-1082,-22,-1060,-83
"47260",NA,51800,"Suffolk city, VA","County or equivalent",2001,66414,2219,352,979,627,1890,23,1867,-23
"47260",NA,51810,"Virginia Beach city, VA","County or equivalent",2001,427578,1090,3898,6332,2434,-2436,432,-2868,-372
"47260",NA,51830,"Williamsburg city, VA","County or equivalent",2001,11908,-81,-57,72,129,-10,28,-38,-14
"47300",NA,NA,"Visalia-Porterville, CA","Metropolitan Statistical Area",2001,372869,4174,4589,7282,2693,-110,2537,-2647,-305
"47300",NA,6107,"Tulare County, CA","County or equivalent",2001,372869,4174,4589,7282,2693,-110,2537,-2647,-305
"47380",NA,NA,"Waco, TX","Metropolitan Statistical Area",2001,215569,1484,1319,3291,1972,368,635,-267,-203
"47380",NA,48309,"McLennan County, TX","County or equivalent",2001,215569,1484,1319,3291,1972,368,635,-267,-203
"47580",NA,NA,"Warner Robins, GA","Metropolitan Statistical Area",2001,113274,2025,894,1668,774,1241,104,1137,-110
"47580",NA,13153,"Houston County, GA","County or equivalent",2001,113274,2025,894,1668,774,1241,104,1137,-110
"47900",NA,NA,"Washington-Arlington-Alexandria, DC-VA-MD-WV","Metropolitan Statistical Area",2001,4928115,106920,44296,74082,29786,54054,38132,15922,8570
"47900",13644,NA,"Bethesda-Frederick-Gaithersburg, MD","Metropolitan Division",2001,1096820,22824,9452,16129,6677,11270,10152,1118,2102
"47900",13644,24021,"Frederick County, MD","County or equivalent",2001,201942,5441,1591,2902,1311,3989,289,3700,-139
"47900",13644,24031,"Montgomery County, MD","County or equivalent",2001,894878,17383,7861,13227,5366,7281,9863,-2582,2241
"47900",47894,NA,"Washington-Arlington-Alexandria, DC-VA-MD-WV","Metropolitan Division",2001,3831295,84096,34844,57953,23109,42784,27980,14804,6468
"47900",47894,11001,"District of Columbia, DC","County or equivalent",2001,577678,5955,1699,7618,5919,-423,3854,-4277,4679
"47900",47894,24009,"Calvert County, MD","County or equivalent",2001,77333,2169,491,993,502,1726,45,1681,-48
"47900",47894,24017,"Charles County, MD","County or equivalent",2001,124691,3487,1002,1763,761,2553,57,2496,-68
"47900",47894,24033,"Prince George's County, MD","County or equivalent",2001,814689,11482,7393,12411,5018,4910,4760,150,-821
"47900",47894,51013,"Arlington County, VA","County or equivalent",2001,193550,3968,1705,2835,1130,106,3260,-3154,2157
"47900",47894,51043,"Clarke County, VA","County or equivalent",2001,12954,253,1,117,116,260,11,249,-8
"47900",47894,51059,"Fairfax County, VA","County or equivalent",2001,984667,9749,10524,14714,4190,15,10925,-10910,-790
"47900",47894,51061,"Fauquier County, VA","County or equivalent",2001,57280,1692,269,684,415,1452,75,1377,-29
"47900",47894,51107,"Loudoun County, VA","County or equivalent",2001,189649,15778,3021,3766,745,12673,899,11774,84
"47900",47894,51153,"Prince William County, VA","County or equivalent",2001,297080,13284,4089,5181,1092,9313,1231,8082,-118
"47900",47894,51177,"Spotsylvania County, VA","County or equivalent",2001,96403,4897,843,1362,519,4053,60,3993,1
"47900",47894,51179,"Stafford County, VA","County or equivalent",2001,98101,4577,965,1387,422,3620,33,3587,-8
"47900",47894,51187,"Warren County, VA","County or equivalent",2001,32052,502,132,418,286,393,7,386,-23
"47900",47894,51510,"Alexandria city, VA","County or equivalent",2001,133090,3750,1581,2445,864,573,2017,-1444,1596
"47900",47894,51600,"Fairfax city, VA","County or equivalent",2001,21899,263,128,297,169,154,303,-149,-19
"47900",47894,51610,"Falls Church city, VA","County or equivalent",2001,10508,116,18,95,77,111,70,41,-13
"47900",47894,51630,"Fredericksburg city, VA","County or equivalent",2001,19904,540,135,364,229,430,48,382,-25
"47900",47894,51683,"Manassas city, VA","County or equivalent",2001,35828,473,497,719,222,13,231,-218,-37
"47900",47894,51685,"Manassas Park city, VA","County or equivalent",2001,10647,308,176,218,42,143,73,70,-11
"47900",47894,54037,"Jefferson County, WV","County or equivalent",2001,43292,853,175,566,391,709,21,688,-31
"47940",NA,NA,"Waterloo-Cedar Falls, IA","Metropolitan Statistical Area",2001,163314,-327,386,1929,1543,-584,422,-1006,-129
"47940",NA,19013,"Black Hawk County, IA","County or equivalent",2001,127624,-373,341,1535,1194,-616,414,-1030,-98
"47940",NA,19017,"Bremer County, IA","County or equivalent",2001,23403,121,43,264,221,98,7,91,-20
"47940",NA,19075,"Grundy County, IA","County or equivalent",2001,12287,-75,2,130,128,-66,1,-67,-11
"48140",NA,NA,"Wausau, WI","Metropolitan Statistical Area",2001,126135,226,658,1566,908,-318,110,-428,-114
"48140",NA,55073,"Marathon County, WI","County or equivalent",2001,126135,226,658,1566,908,-318,110,-428,-114
"48260",NA,NA,"Weirton-Steubenville, WV-OH","Metropolitan Statistical Area",2001,130245,-1386,-399,1374,1773,-882,19,-901,-105
"48260",NA,39081,"Jefferson County, OH","County or equivalent",2001,72798,-839,-237,793,1030,-545,19,-564,-57
"48260",NA,54009,"Brooke County, WV","County or equivalent",2001,25153,-220,-59,246,305,-141,0,-141,-20
"48260",NA,54029,"Hancock County, WV","County or equivalent",2001,32294,-327,-103,335,438,-196,0,-196,-28
"48300",NA,NA,"Wenatchee, WA","Metropolitan Statistical Area",2001,99428,67,627,1413,786,-485,466,-951,-75
"48300",NA,53007,"Chelan County, WA","County or equivalent",2001,66656,-22,414,981,567,-388,311,-699,-48
"48300",NA,53017,"Douglas County, WA","County or equivalent",2001,32772,89,213,432,219,-97,155,-252,-27
"48540",NA,NA,"Wheeling, WV-OH","Metropolitan Statistical Area",2001,151315,-1523,-402,1510,1912,-992,40,-1032,-129
"48540",NA,39013,"Belmont County, OH","County or equivalent",2001,69566,-547,-256,677,933,-228,12,-240,-63
"48540",NA,54051,"Marshall County, WV","County or equivalent",2001,35161,-234,-5,359,364,-198,2,-200,-31
"48540",NA,54069,"Ohio County, WV","County or equivalent",2001,46588,-742,-141,474,615,-566,26,-592,-35
"48620",NA,NA,"Wichita, KS","Metropolitan Statistical Area",2001,574496,2480,4332,9198,4866,-1351,1517,-2868,-501
"48620",NA,20015,"Butler County, KS","County or equivalent",2001,59731,53,196,754,558,-86,44,-130,-57
"48620",NA,20079,"Harvey County, KS","County or equivalent",2001,32909,36,103,427,324,-36,57,-93,-31
"48620",NA,20173,"Sedgwick County, KS","County or equivalent",2001,456222,2704,3994,7694,3700,-893,1412,-2305,-397
"48620",NA,20191,"Sumner County, KS","County or equivalent",2001,25634,-313,39,323,284,-336,4,-340,-16
"48660",NA,NA,"Wichita Falls, TX","Metropolitan Statistical Area",2001,150115,-1469,519,2040,1521,-1888,137,-2025,-100
"48660",NA,48009,"Archer County, TX","County or equivalent",2001,8794,-123,1,84,83,-117,0,-117,-7
"48660",NA,48077,"Clay County, TX","County or equivalent",2001,11156,80,-17,86,103,108,2,106,-11
"48660",NA,48485,"Wichita County, TX","County or equivalent",2001,130165,-1426,535,1870,1335,-1879,135,-2014,-82
"48700",NA,NA,"Williamsport, PA","Metropolitan Statistical Area",2001,119115,-843,76,1294,1218,-815,19,-834,-104
"48700",NA,42081,"Lycoming County, PA","County or equivalent",2001,119115,-843,76,1294,1218,-815,19,-834,-104
"48900",NA,NA,"Wilmington, NC","Metropolitan Statistical Area",2001,281675,5835,962,3461,2499,5048,490,4558,-175
"48900",NA,37019,"Brunswick County, NC","County or equivalent",2001,76137,2367,125,863,738,2263,119,2144,-21
"48900",NA,37129,"New Hanover County, NC","County or equivalent",2001,163806,2988,714,2090,1376,2395,264,2131,-121
"48900",NA,37141,"Pender County, NC","County or equivalent",2001,41732,480,123,508,385,390,107,283,-33
"49020",NA,NA,"Winchester, VA-WV","Metropolitan Statistical Area",2001,105865,2301,459,1367,908,1916,191,1725,-74
"49020",NA,51069,"Frederick County, VA","County or equivalent",2001,61082,1502,353,793,440,1183,46,1137,-34
"49020",NA,51840,"Winchester city, VA","County or equivalent",2001,24223,530,82,350,268,475,141,334,-27
"49020",NA,54027,"Hampshire County, WV","County or equivalent",2001,20560,269,24,224,200,258,4,254,-13
"49180",NA,NA,"Winston-Salem, NC","Metropolitan Statistical Area",2001,428103,4771,2186,6081,3895,2983,1708,1275,-398
"49180",NA,37059,"Davie County, NC","County or equivalent",2001,35948,890,124,462,338,787,79,708,-21
"49180",NA,37067,"Forsyth County, NC","County or equivalent",2001,310506,3573,1836,4593,2757,2032,1478,554,-295
"49180",NA,37169,"Stokes County, NC","County or equivalent",2001,44871,38,99,520,421,-15,48,-63,-46
"49180",NA,37197,"Yadkin County, NC","County or equivalent",2001,36778,270,127,506,379,179,103,76,-36
"49340",NA,NA,"Worcester, MA","Metropolitan Statistical Area",2001,760816,8160,3321,10182,6861,5522,2664,2858,-683
"49340",NA,25027,"Worcester County, MA","County or equivalent",2001,760816,8160,3321,10182,6861,5522,2664,2858,-683
"49420",NA,NA,"Yakima, WA","Metropolitan Statistical Area",2001,222879,153,2659,4276,1617,-2365,1171,-3536,-141
"49420",NA,53077,"Yakima County, WA","County or equivalent",2001,222879,153,2659,4276,1617,-2365,1171,-3536,-141
"49620",NA,NA,"York-Hanover, PA","Metropolitan Statistical Area",2001,385297,2588,1173,4581,3408,1757,308,1449,-342
"49620",NA,42133,"York County, PA","County or equivalent",2001,385297,2588,1173,4581,3408,1757,308,1449,-342
"49660",NA,NA,"Youngstown-Warren-Boardman, OH-PA","Metropolitan Statistical Area",2001,598490,-3667,30,7058,7028,-3186,198,-3384,-511
"49660",NA,39099,"Mahoning County, OH","County or equivalent",2001,254850,-2192,-209,2968,3177,-1768,112,-1880,-215
"49660",NA,39155,"Trumbull County, OH","County or equivalent",2001,223893,-1053,374,2769,2395,-1240,53,-1293,-187
"49660",NA,42085,"Mercer County, PA","County or equivalent",2001,119747,-422,-135,1321,1456,-178,33,-211,-109
"49700",NA,NA,"Yuba City, CA","Metropolitan Statistical Area",2001,141266,1809,985,2247,1262,957,783,174,-133
"49700",NA,6101,"Sutter County, CA","County or equivalent",2001,79931,804,457,1163,706,425,560,-135,-78
"49700",NA,6115,"Yuba County, CA","County or equivalent",2001,61335,1005,528,1084,556,532,223,309,-55
"49740",NA,NA,"Yuma, AZ","Metropolitan Statistical Area",2001,163218,2505,1961,2963,1002,706,1119,-413,-162
"49740",NA,4027,"Yuma County, AZ","County or equivalent",2001,163218,2505,1961,2963,1002,706,1119,-413,-162
" ",NA,NA,"","",2001,NA,NA,NA,NA,NA,NA,NA,NA,NA
" ",NA,NA,"Micropolitan Statistical Area","",2001,NA,NA,NA,NA,NA,NA,NA,NA,NA
" ",NA,NA,"","",2001,NA,NA,NA,NA,NA,NA,NA,NA,NA
"10020",NA,NA,"Abbeville, LA","Micropolitan Statistical Area",2001,53938,-26,286,802,516,-266,57,-323,-46
"10020",NA,22113,"Vermilion Parish, LA","County or equivalent",2001,53938,-26,286,802,516,-266,57,-323,-46
"10100",NA,NA,"Aberdeen, SD","Micropolitan Statistical Area",2001,39406,-331,51,504,453,-350,13,-363,-32
"10100",NA,46013,"Brown County, SD","County or equivalent",2001,35115,-269,75,457,382,-318,11,-329,-26
"10100",NA,46045,"Edmunds County, SD","County or equivalent",2001,4291,-62,-24,47,71,-32,2,-34,-6
"10140",NA,NA,"Aberdeen, WA","Micropolitan Statistical Area",2001,67997,850,-98,772,870,995,99,896,-47
"10140",NA,53027,"Grays Harbor County, WA","County or equivalent",2001,67997,850,-98,772,870,995,99,896,-47
"10220",NA,NA,"Ada, OK","Micropolitan Statistical Area",2001,34928,-236,52,494,442,-259,26,-285,-29
"10220",NA,40123,"Pontotoc County, OK","County or equivalent",2001,34928,-236,52,494,442,-259,26,-285,-29
"10300",NA,NA,"Adrian, MI","Micropolitan Statistical Area",2001,99586,511,374,1251,877,234,57,177,-97
"10300",NA,26091,"Lenawee County, MI","County or equivalent",2001,99586,511,374,1251,877,234,57,177,-97
"10460",NA,NA,"Alamogordo, NM","Micropolitan Statistical Area",2001,61373,-843,406,854,448,-1227,367,-1594,-22
"10460",NA,35035,"Otero County, NM","County or equivalent",2001,61373,-843,406,854,448,-1227,367,-1594,-22
"10540",NA,NA,"Albany-Lebanon, OR","Micropolitan Statistical Area",2001,103597,584,345,1320,975,347,106,241,-108
"10540",NA,41043,"Linn County, OR","County or equivalent",2001,103597,584,345,1320,975,347,106,241,-108
"10620",NA,NA,"Albemarle, NC","Micropolitan Statistical Area",2001,58590,344,149,762,613,248,100,148,-53
"10620",NA,37167,"Stanly County, NC","County or equivalent",2001,58590,344,149,762,613,248,100,148,-53
"10660",NA,NA,"Albert Lea, MN","Micropolitan Statistical Area",2001,32436,-108,12,390,378,-90,47,-137,-30
"10660",NA,27047,"Freeborn County, MN","County or equivalent",2001,32436,-108,12,390,378,-90,47,-137,-30
"10700",NA,NA,"Albertville, AL","Micropolitan Statistical Area",2001,82151,-173,277,1190,913,-380,268,-648,-70
"10700",NA,1095,"Marshall County, AL","County or equivalent",2001,82151,-173,277,1190,913,-380,268,-648,-70
"10760",NA,NA,"Alexander City, AL","Micropolitan Statistical Area",2001,53131,-453,-31,642,673,-379,6,-385,-43
"10760",NA,1037,"Coosa County, AL","County or equivalent",2001,11765,-97,-1,112,113,-85,1,-86,-11
"10760",NA,1123,"Tallapoosa County, AL","County or equivalent",2001,41366,-356,-30,530,560,-294,5,-299,-32
"10820",NA,NA,"Alexandria, MN","Micropolitan Statistical Area",2001,33244,326,29,359,330,325,3,322,-28
"10820",NA,27041,"Douglas County, MN","County or equivalent",2001,33244,326,29,359,330,325,3,322,-28
"10860",NA,NA,"Alice, TX","Micropolitan Statistical Area",2001,39749,377,344,673,329,72,17,55,-39
"10860",NA,48249,"Jim Wells County, TX","County or equivalent",2001,39749,377,344,673,329,72,17,55,-39
"10880",NA,NA,"Allegan, MI","Micropolitan Statistical Area",2001,107736,1688,658,1505,847,1122,119,1003,-92
"10880",NA,26005,"Allegan County, MI","County or equivalent",2001,107736,1688,658,1505,847,1122,119,1003,-92
"10940",NA,NA,"Alma, MI","Micropolitan Statistical Area",2001,42469,-7,93,522,429,-57,14,-71,-43
"10940",NA,26057,"Gratiot County, MI","County or equivalent",2001,42469,-7,93,522,429,-57,14,-71,-43
"10980",NA,NA,"Alpena, MI","Micropolitan Statistical Area",2001,31128,-151,-25,350,375,-93,12,-105,-33
"10980",NA,26007,"Alpena County, MI","County or equivalent",2001,31128,-151,-25,350,375,-93,12,-105,-33
"11060",NA,NA,"Altus, OK","Micropolitan Statistical Area",2001,27885,-366,186,447,261,-537,32,-569,-15
"11060",NA,40065,"Jackson County, OK","County or equivalent",2001,27885,-366,186,447,261,-537,32,-569,-15
"11140",NA,NA,"Americus, GA","Micropolitan Statistical Area",2001,37007,-32,170,555,385,-166,42,-208,-36
"11140",NA,13249,"Schley County, GA","County or equivalent",2001,3795,11,2,48,46,14,7,7,-5
"11140",NA,13261,"Sumter County, GA","County or equivalent",2001,33212,-43,168,507,339,-180,35,-215,-31
"11220",NA,NA,"Amsterdam, NY","Micropolitan Statistical Area",2001,49339,-317,-41,572,613,-230,20,-250,-46
"11220",NA,36057,"Montgomery County, NY","County or equivalent",2001,49339,-317,-41,572,613,-230,20,-250,-46
"11380",NA,NA,"Andrews, TX","Micropolitan Statistical Area",2001,12761,-152,112,206,94,-256,16,-272,-8
"11380",NA,48003,"Andrews County, TX","County or equivalent",2001,12761,-152,112,206,94,-256,16,-272,-8
"11420",NA,NA,"Angola, IN","Micropolitan Statistical Area",2001,33472,158,161,455,294,30,26,4,-33
"11420",NA,18151,"Steuben County, IN","County or equivalent",2001,33472,158,161,455,294,30,26,4,-33
"11580",NA,NA,"Arcadia, FL","Micropolitan Statistical Area",2001,32566,304,126,435,309,222,419,-197,-44
"11580",NA,12027,"DeSoto County, FL","County or equivalent",2001,32566,304,126,435,309,222,419,-197,-44
"11620",NA,NA,"Ardmore, OK","Micropolitan Statistical Area",2001,54321,-101,31,726,695,-80,36,-116,-52
"11620",NA,40019,"Carter County, OK","County or equivalent",2001,45593,-2,44,631,587,-2,25,-27,-44
"11620",NA,40085,"Love County, OK","County or equivalent",2001,8728,-99,-13,95,108,-78,11,-89,-8
"11660",NA,NA,"Arkadelphia, AR","Micropolitan Statistical Area",2001,23651,140,19,292,273,143,31,112,-22
"11660",NA,5019,"Clark County, AR","County or equivalent",2001,23651,140,19,292,273,143,31,112,-22
"11740",NA,NA,"Ashland, OH","Micropolitan Statistical Area",2001,52827,243,238,705,467,57,21,36,-52
"11740",NA,39005,"Ashland County, OH","County or equivalent",2001,52827,243,238,705,467,57,21,36,-52
"11780",NA,NA,"Ashtabula, OH","Micropolitan Statistical Area",2001,102663,-83,145,1355,1210,-130,44,-174,-98
"11780",NA,39007,"Ashtabula County, OH","County or equivalent",2001,102663,-83,145,1355,1210,-130,44,-174,-98
"11820",NA,NA,"Astoria, OR","Micropolitan Statistical Area",2001,35538,-30,-39,374,413,43,75,-32,-34
"11820",NA,41007,"Clatsop County, OR","County or equivalent",2001,35538,-30,-39,374,413,43,75,-32,-34
"11860",NA,NA,"Atchison, KS","Micropolitan Statistical Area",2001,16794,29,45,229,184,2,5,-3,-18
"11860",NA,20005,"Atchison County, KS","County or equivalent",2001,16794,29,45,229,184,2,5,-3,-18
"11900",NA,NA,"Athens, OH","Micropolitan Statistical Area",2001,62832,513,179,657,478,393,174,219,-59
"11900",NA,39009,"Athens County, OH","County or equivalent",2001,62832,513,179,657,478,393,174,219,-59
"11940",NA,NA,"Athens, TN","Micropolitan Statistical Area",2001,49775,605,147,630,483,497,31,466,-39
"11940",NA,47107,"McMinn County, TN","County or equivalent",2001,49775,605,147,630,483,497,31,466,-39
"11980",NA,NA,"Athens, TX","Micropolitan Statistical Area",2001,74042,500,-18,914,932,585,103,482,-67
"11980",NA,48213,"Henderson County, TX","County or equivalent",2001,74042,500,-18,914,932,585,103,482,-67
"12140",NA,NA,"Auburn, IN","Micropolitan Statistical Area",2001,40451,49,241,571,330,-156,19,-175,-36
"12140",NA,18033,"DeKalb County, IN","County or equivalent",2001,40451,49,241,571,330,-156,19,-175,-36
"12180",NA,NA,"Auburn, NY","Micropolitan Statistical Area",2001,81280,-645,181,920,739,-761,33,-794,-65
"12180",NA,36011,"Cayuga County, NY","County or equivalent",2001,81280,-645,181,920,739,-761,33,-794,-65
"12300",NA,NA,"Augusta-Waterville, ME","Micropolitan Statistical Area",2001,117965,752,191,1267,1076,659,47,612,-98
"12300",NA,23011,"Kennebec County, ME","County or equivalent",2001,117965,752,191,1267,1076,659,47,612,-98
"12380",NA,NA,"Austin, MN","Micropolitan Statistical Area",2001,38670,-1,141,530,389,-104,105,-209,-38
"12380",NA,27099,"Mower County, MN","County or equivalent",2001,38670,-1,141,530,389,-104,105,-209,-38
"12460",NA,NA,"Bainbridge, GA","Micropolitan Statistical Area",2001,27972,-271,131,446,315,-373,47,-420,-29
"12460",NA,13087,"Decatur County, GA","County or equivalent",2001,27972,-271,131,446,315,-373,47,-420,-29
"12660",NA,NA,"Baraboo, WI","Micropolitan Statistical Area",2001,55404,64,70,567,497,49,40,9,-55
"12660",NA,55111,"Sauk County, WI","County or equivalent",2001,55404,64,70,567,497,49,40,9,-55
"12740",NA,NA,"Barre, VT","Micropolitan Statistical Area",2001,58442,375,76,588,512,350,79,271,-51
"12740",NA,50023,"Washington County, VT","County or equivalent",2001,58442,375,76,588,512,350,79,271,-51
"12780",NA,NA,"Bartlesville, OK","Micropolitan Statistical Area",2001,48860,-118,26,601,575,-100,76,-176,-44
"12780",NA,40147,"Washington County, OK","County or equivalent",2001,48860,-118,26,601,575,-100,76,-176,-44
"12820",NA,NA,"Bastrop, LA","Micropolitan Statistical Area",2001,30630,-331,155,486,331,-466,2,-468,-20
"12820",NA,22067,"Morehouse Parish, LA","County or equivalent",2001,30630,-331,155,486,331,-466,2,-468,-20
"12860",NA,NA,"Batavia, NY","Micropolitan Statistical Area",2001,59898,-431,161,737,576,-546,34,-580,-46
"12860",NA,36037,"Genesee County, NY","County or equivalent",2001,59898,-431,161,737,576,-546,34,-580,-46
"12900",NA,NA,"Batesville, AR","Micropolitan Statistical Area",2001,34157,-112,9,397,388,-90,20,-110,-31
"12900",NA,5063,"Independence County, AR","County or equivalent",2001,34157,-112,9,397,388,-90,20,-110,-31
"13060",NA,NA,"Bay City, TX","Micropolitan Statistical Area",2001,37894,-52,155,554,399,-174,167,-341,-33
"13060",NA,48321,"Matagorda County, TX","County or equivalent",2001,37894,-52,155,554,399,-174,167,-341,-33
"13100",NA,NA,"Beatrice, NE","Micropolitan Statistical Area",2001,23092,117,-13,281,294,152,3,149,-22
"13100",NA,31067,"Gage County, NE","County or equivalent",2001,23092,117,-13,281,294,152,3,149,-22
"13180",NA,NA,"Beaver Dam, WI","Micropolitan Statistical Area",2001,86265,260,125,980,855,222,39,183,-87
"13180",NA,55027,"Dodge County, WI","County or equivalent",2001,86265,260,125,980,855,222,39,183,-87
"13220",NA,NA,"Beckley, WV","Micropolitan Statistical Area",2001,78328,-720,-118,830,948,-536,36,-572,-66
"13220",NA,54081,"Raleigh County, WV","County or equivalent",2001,78328,-720,-118,830,948,-536,36,-572,-66
"13260",NA,NA,"Bedford, IN","Micropolitan Statistical Area",2001,45936,11,115,606,491,-60,13,-73,-44
"13260",NA,18093,"Lawrence County, IN","County or equivalent",2001,45936,11,115,606,491,-60,13,-73,-44
"13300",NA,NA,"Beeville, TX","Micropolitan Statistical Area",2001,31818,-433,198,425,227,-616,5,-621,-15
"13300",NA,48025,"Bee County, TX","County or equivalent",2001,31818,-433,198,425,227,-616,5,-621,-15
"13340",NA,NA,"Bellefontaine, OH","Micropolitan Statistical Area",2001,45947,-69,148,590,442,-175,24,-199,-42
"13340",NA,39091,"Logan County, OH","County or equivalent",2001,45947,-69,148,590,442,-175,24,-199,-42
"13420",NA,NA,"Bemidji, MN","Micropolitan Statistical Area",2001,40426,627,257,587,330,407,25,382,-37
"13420",NA,27007,"Beltrami County, MN","County or equivalent",2001,40426,627,257,587,330,407,25,382,-37
"13500",NA,NA,"Bennettsville, SC","Micropolitan Statistical Area",2001,28547,-250,51,415,364,-275,3,-278,-26
"13500",NA,45069,"Marlboro County, SC","County or equivalent",2001,28547,-250,51,415,364,-275,3,-278,-26
"13540",NA,NA,"Bennington, VT","Micropolitan Statistical Area",2001,36907,-72,-51,367,418,16,31,-15,-37
"13540",NA,50003,"Bennington County, VT","County or equivalent",2001,36907,-72,-51,367,418,16,31,-15,-37
"13620",NA,NA,"Berlin, NH-VT","Micropolitan Statistical Area",2001,39396,-206,-123,358,481,-49,15,-64,-34
"13620",NA,33007,"Coos County, NH","County or equivalent",2001,32910,-234,-120,303,423,-85,12,-97,-29
"13620",NA,50009,"Essex County, VT","County or equivalent",2001,6486,28,-3,55,58,36,3,33,-5
"13660",NA,NA,"Big Rapids, MI","Micropolitan Statistical Area",2001,40888,237,114,481,367,161,53,108,-38
"13660",NA,26107,"Mecosta County, MI","County or equivalent",2001,40888,237,114,481,367,161,53,108,-38
"13700",NA,NA,"Big Spring, TX","Micropolitan Statistical Area",2001,33027,-422,55,425,370,-455,28,-483,-22
"13700",NA,48227,"Howard County, TX","County or equivalent",2001,33027,-422,55,425,370,-455,28,-483,-22
"13860",NA,NA,"Bishop, CA","Micropolitan Statistical Area",2001,17942,26,-45,171,216,88,43,45,-17
"13860",NA,6027,"Inyo County, CA","County or equivalent",2001,17942,26,-45,171,216,88,43,45,-17
"13940",NA,NA,"Blackfoot, ID","Micropolitan Statistical Area",2001,42019,275,479,777,298,-167,77,-244,-37
"13940",NA,16011,"Bingham County, ID","County or equivalent",2001,42019,275,479,777,298,-167,77,-244,-37
"14100",NA,NA,"Bloomsburg-Berwick, PA","Micropolitan Statistical Area",2001,82507,122,-98,779,877,304,27,277,-84
"14100",NA,42037,"Columbia County, PA","County or equivalent",2001,64256,149,-50,582,632,262,19,243,-63
"14100",NA,42093,"Montour County, PA","County or equivalent",2001,18251,-27,-48,197,245,42,8,34,-21
"14140",NA,NA,"Bluefield, WV-VA","Micropolitan Statistical Area",2001,105833,-1520,-208,1165,1373,-1236,24,-1260,-76
"14140",NA,51185,"Tazewell County, VA","County or equivalent",2001,43983,-443,-109,445,554,-299,11,-310,-35
"14140",NA,54055,"Mercer County, WV","County or equivalent",2001,61850,-1077,-99,720,819,-937,13,-950,-41
"14180",NA,NA,"Blytheville, AR","Micropolitan Statistical Area",2001,50966,-863,343,923,580,-1180,31,-1211,-26
"14180",NA,5093,"Mississippi County, AR","County or equivalent",2001,50966,-863,343,923,580,-1180,31,-1211,-26
"14220",NA,NA,"Bogalusa, LA","Micropolitan Statistical Area",2001,43775,-116,93,641,548,-170,1,-171,-39
"14220",NA,22117,"Washington Parish, LA","County or equivalent",2001,43775,-116,93,641,548,-170,1,-171,-39
"14300",NA,NA,"Bonham, TX","Micropolitan Statistical Area",2001,31301,-39,-56,354,410,48,31,17,-31
"14300",NA,48147,"Fannin County, TX","County or equivalent",2001,31301,-39,-56,354,410,48,31,17,-31
"14340",NA,NA,"Boone, IA","Micropolitan Statistical Area",2001,26220,-35,-11,293,304,4,9,-5,-28
"14340",NA,19015,"Boone County, IA","County or equivalent",2001,26220,-35,-11,293,304,4,9,-5,-28
"14380",NA,NA,"Boone, NC","Micropolitan Statistical Area",2001,43226,431,71,364,293,396,49,347,-36
"14380",NA,37189,"Watauga County, NC","County or equivalent",2001,43226,431,71,364,293,396,49,347,-36
"14420",NA,NA,"Borger, TX","Micropolitan Statistical Area",2001,23167,-596,33,323,290,-618,46,-664,-11
"14420",NA,48233,"Hutchinson County, TX","County or equivalent",2001,23167,-596,33,323,290,-618,46,-664,-11
"14580",NA,NA,"Bozeman, MT","Micropolitan Statistical Area",2001,70170,1812,473,812,339,1379,87,1292,-40
"14580",NA,30031,"Gallatin County, MT","County or equivalent",2001,70170,1812,473,812,339,1379,87,1292,-40
"14620",NA,NA,"Bradford, PA","Micropolitan Statistical Area",2001,45219,-561,-109,473,582,-416,4,-420,-36
"14620",NA,42083,"McKean County, PA","County or equivalent",2001,45219,-561,-109,473,582,-416,4,-420,-36
"14660",NA,NA,"Brainerd, MN","Micropolitan Statistical Area",2001,83749,1160,188,1014,826,1033,20,1013,-61
"14660",NA,27021,"Cass County, MN","County or equivalent",2001,27613,336,33,334,301,324,3,321,-21
"14660",NA,27035,"Crow Wing County, MN","County or equivalent",2001,56136,824,155,680,525,709,17,692,-40
"14700",NA,NA,"Branson, MO","Micropolitan Statistical Area",2001,69135,456,138,884,746,381,42,339,-63
"14700",NA,29209,"Stone County, MO","County or equivalent",2001,28904,164,18,322,304,172,12,160,-26
"14700",NA,29213,"Taney County, MO","County or equivalent",2001,40231,292,120,562,442,209,30,179,-37
"14780",NA,NA,"Brenham, TX","Micropolitan Statistical Area",2001,30447,38,80,416,336,-15,71,-86,-27
"14780",NA,48477,"Washington County, TX","County or equivalent",2001,30447,38,80,416,336,-15,71,-86,-27
"14820",NA,NA,"Brevard, NC","Micropolitan Statistical Area",2001,29299,-82,-60,292,352,7,32,-25,-29
"14820",NA,37175,"Transylvania County, NC","County or equivalent",2001,29299,-82,-60,292,352,7,32,-25,-29
"14940",NA,NA,"Brigham City, UT","Micropolitan Statistical Area",2001,43623,752,506,783,277,-70,53,-123,316
"14940",NA,49003,"Box Elder County, UT","County or equivalent",2001,43623,752,506,783,277,-70,53,-123,316
"15020",NA,NA,"Brookhaven, MS","Micropolitan Statistical Area",2001,33166,17,104,475,371,-52,5,-57,-35
"15020",NA,28085,"Lincoln County, MS","County or equivalent",2001,33166,17,104,475,371,-52,5,-57,-35
"15060",NA,NA,"Brookings, OR","Micropolitan Statistical Area",2001,21100,-5,-152,175,327,163,14,149,-16
"15060",NA,41015,"Curry County, OR","County or equivalent",2001,21100,-5,-152,175,327,163,14,149,-16
"15100",NA,NA,"Brookings, SD","Micropolitan Statistical Area",2001,28339,50,97,307,210,-20,44,-64,-27
"15100",NA,46011,"Brookings County, SD","County or equivalent",2001,28339,50,97,307,210,-20,44,-64,-27
"15140",NA,NA,"Brownsville, TN","Micropolitan Statistical Area",2001,19839,19,58,291,233,-17,19,-36,-22
"15140",NA,47075,"Haywood County, TN","County or equivalent",2001,19839,19,58,291,233,-17,19,-36,-22
"15220",NA,NA,"Brownwood, TX","Micropolitan Statistical Area",2001,37618,-92,23,501,478,-80,27,-107,-35
"15220",NA,48049,"Brown County, TX","County or equivalent",2001,37618,-92,23,501,478,-80,27,-107,-35
"15340",NA,NA,"Bucyrus, OH","Micropolitan Statistical Area",2001,46509,-372,51,588,537,-384,4,-388,-39
"15340",NA,39033,"Crawford County, OH","County or equivalent",2001,46509,-372,51,588,537,-384,4,-388,-39
"15420",NA,NA,"Burley, ID","Micropolitan Statistical Area",2001,40973,-505,332,720,388,-818,132,-950,-19
"15420",NA,16031,"Cassia County, ID","County or equivalent",2001,21467,76,190,384,194,-96,55,-151,-18
"15420",NA,16067,"Minidoka County, ID","County or equivalent",2001,19506,-581,142,336,194,-722,77,-799,-1
"15460",NA,NA,"Burlington, IA-IL","Micropolitan Statistical Area",2001,50098,-397,120,612,492,-470,28,-498,-47
"15460",NA,17071,"Henderson County, IL","County or equivalent",2001,8182,-28,3,81,78,-23,1,-24,-8
"15460",NA,19057,"Des Moines County, IA","County or equivalent",2001,41916,-369,117,531,414,-447,27,-474,-39
"15580",NA,NA,"Butte-Silver Bow, MT","Micropolitan Statistical Area",2001,33711,-804,-74,354,428,-715,7,-722,-15
"15580",NA,30093,"Silver Bow County, MT","County or equivalent",2001,33711,-804,-74,354,428,-715,7,-722,-15
"15620",NA,NA,"Cadillac, MI","Micropolitan Statistical Area",2001,45286,217,107,566,459,149,12,137,-39
"15620",NA,26113,"Missaukee County, MI","County or equivalent",2001,14594,50,35,178,143,28,0,28,-13
"15620",NA,26165,"Wexford County, MI","County or equivalent",2001,30692,167,72,388,316,121,12,109,-26
"15660",NA,NA,"Calhoun, GA","Micropolitan Statistical Area",2001,45541,1162,445,833,388,751,217,534,-34
"15660",NA,13129,"Gordon County, GA","County or equivalent",2001,45541,1162,445,833,388,751,217,534,-34
"15700",NA,NA,"Cambridge, MD","Micropolitan Statistical Area",2001,30602,16,-33,366,399,77,9,68,-28
"15700",NA,24019,"Dorchester County, MD","County or equivalent",2001,30602,16,-33,366,399,77,9,68,-28
"15740",NA,NA,"Cambridge, OH","Micropolitan Statistical Area",2001,40833,42,127,528,401,-46,4,-50,-39
"15740",NA,39059,"Guernsey County, OH","County or equivalent",2001,40833,42,127,528,401,-46,4,-50,-39
"15780",NA,NA,"Camden, AR","Micropolitan Statistical Area",2001,33627,-776,-75,405,480,-682,16,-698,-19
"15780",NA,5013,"Calhoun County, AR","County or equivalent",2001,5579,-138,-28,55,83,-104,6,-110,-6
"15780",NA,5103,"Ouachita County, AR","County or equivalent",2001,28048,-638,-47,350,397,-578,10,-588,-13
"15820",NA,NA,"Campbellsville, KY","Micropolitan Statistical Area",2001,22936,19,6,272,266,36,8,28,-23
"15820",NA,21217,"Taylor County, KY","County or equivalent",2001,22936,19,6,272,266,36,8,28,-23
"15860",NA,NA,"Canon City, CO","Micropolitan Statistical Area",2001,46750,471,-30,447,477,542,23,519,-41
"15860",NA,8043,"Fremont County, CO","County or equivalent",2001,46750,471,-30,447,477,542,23,519,-41
"15900",NA,NA,"Canton, IL","Micropolitan Statistical Area",2001,37849,-391,-67,431,498,-291,0,-291,-33
"15900",NA,17057,"Fulton County, IL","County or equivalent",2001,37849,-391,-67,431,498,-291,0,-291,-33
"16020",NA,NA,"Cape Girardeau-Jackson, MO-IL","Micropolitan Statistical Area",2001,90904,473,245,1144,899,315,40,275,-87
"16020",NA,17003,"Alexander County, IL","County or equivalent",2001,9444,-140,15,139,124,-148,1,-149,-7
"16020",NA,29017,"Bollinger County, MO","County or equivalent",2001,12240,187,0,130,130,194,0,194,-7
"16020",NA,29031,"Cape Girardeau County, MO","County or equivalent",2001,69220,426,230,875,645,269,39,230,-73
"16060",NA,NA,"Carbondale, IL","Micropolitan Statistical Area",2001,59351,-258,163,658,495,-375,288,-663,-46
"16060",NA,17077,"Jackson County, IL","County or equivalent",2001,59351,-258,163,658,495,-375,288,-663,-46
"16100",NA,NA,"Carlsbad-Artesia, NM","Micropolitan Statistical Area",2001,50676,-738,169,731,562,-875,44,-919,-32
"16100",NA,35015,"Eddy County, NM","County or equivalent",2001,50676,-738,169,731,562,-875,44,-919,-32
"16260",NA,NA,"Cedar City, UT","Micropolitan Statistical Area",2001,34730,738,614,774,160,158,69,89,-34
"16260",NA,49021,"Iron County, UT","County or equivalent",2001,34730,738,614,774,160,158,69,89,-34
"16340",NA,NA,"Cedartown, GA","Micropolitan Statistical Area",2001,38758,509,220,629,409,323,146,177,-34
"16340",NA,13233,"Polk County, GA","County or equivalent",2001,38758,509,220,629,409,323,146,177,-34
"16380",NA,NA,"Celina, OH","Micropolitan Statistical Area",2001,40787,-122,216,558,342,-306,10,-316,-32
"16380",NA,39107,"Mercer County, OH","County or equivalent",2001,40787,-122,216,558,342,-306,10,-316,-32
"16420",NA,NA,"Central City, KY","Micropolitan Statistical Area",2001,31709,-87,31,423,392,-89,1,-90,-29
"16420",NA,21177,"Muhlenberg County, KY","County or equivalent",2001,31709,-87,31,423,392,-89,1,-90,-29
"16460",NA,NA,"Centralia, IL","Micropolitan Statistical Area",2001,41367,-321,31,561,530,-320,1,-321,-32
"16460",NA,17121,"Marion County, IL","County or equivalent",2001,41367,-321,31,561,530,-320,1,-321,-32
"16500",NA,NA,"Centralia, WA","Micropolitan Statistical Area",2001,68891,275,158,912,754,184,123,61,-67
"16500",NA,53041,"Lewis County, WA","County or equivalent",2001,68891,275,158,912,754,184,123,61,-67
"16540",NA,NA,"Chambersburg, PA","Micropolitan Statistical Area",2001,130149,608,321,1658,1337,420,136,284,-133
"16540",NA,42055,"Franklin County, PA","County or equivalent",2001,130149,608,321,1658,1337,420,136,284,-133
"16660",NA,NA,"Charleston-Mattoon, IL","Micropolitan Statistical Area",2001,63471,-869,84,710,626,-914,39,-953,-39
"16660",NA,17029,"Coles County, IL","County or equivalent",2001,52319,-765,92,588,496,-827,35,-862,-30
"16660",NA,17035,"Cumberland County, IL","County or equivalent",2001,11152,-104,-8,122,130,-87,4,-91,-9
"16900",NA,NA,"Chester, SC","Micropolitan Statistical Area",2001,33934,-174,142,503,361,-284,12,-296,-32
"16900",NA,45023,"Chester County, SC","County or equivalent",2001,33934,-174,142,503,361,-284,12,-296,-32
"17060",NA,NA,"Chillicothe, OH","Micropolitan Statistical Area",2001,73592,142,160,880,720,54,22,32,-72
"17060",NA,39141,"Ross County, OH","County or equivalent",2001,73592,142,160,880,720,54,22,32,-72
"17180",NA,NA,"City of The Dalles, OR","Micropolitan Statistical Area",2001,23699,-121,4,308,304,-105,40,-145,-20
"17180",NA,41065,"Wasco County, OR","County or equivalent",2001,23699,-121,4,308,304,-105,40,-145,-20
"17200",NA,NA,"Claremont, NH","Micropolitan Statistical Area",2001,40866,313,41,451,410,306,25,281,-34
"17200",NA,33019,"Sullivan County, NH","County or equivalent",2001,40866,313,41,451,410,306,25,281,-34
"17220",NA,NA,"Clarksburg, WV","Micropolitan Statistical Area",2001,91396,-657,-148,1031,1179,-440,35,-475,-69
"17220",NA,54017,"Doddridge County, WV","County or equivalent",2001,7498,90,-19,65,84,114,0,114,-5
"17220",NA,54033,"Harrison County, WV","County or equivalent",2001,67861,-703,-83,812,895,-570,34,-604,-50
"17220",NA,54091,"Taylor County, WV","County or equivalent",2001,16037,-44,-46,154,200,16,1,15,-14
"17260",NA,NA,"Clarksdale, MS","Micropolitan Statistical Area",2001,30268,-282,247,597,350,-506,12,-518,-23
"17260",NA,28027,"Coahoma County, MS","County or equivalent",2001,30268,-282,247,597,350,-506,12,-518,-23
"17340",NA,NA,"Clearlake, CA","Micropolitan Statistical Area",2001,60308,1761,-193,599,792,1968,109,1859,-14
"17340",NA,6033,"Lake County, CA","County or equivalent",2001,60308,1761,-193,599,792,1968,109,1859,-14
"17380",NA,NA,"Cleveland, MS","Micropolitan Statistical Area",2001,40064,-407,195,656,461,-571,6,-577,-31
"17380",NA,28011,"Bolivar County, MS","County or equivalent",2001,40064,-407,195,656,461,-571,6,-577,-31
"17500",NA,NA,"Clewiston, FL","Micropolitan Statistical Area",2001,36165,-166,364,654,290,-519,435,-954,-11
"17500",NA,12051,"Hendry County, FL","County or equivalent",2001,36165,-166,364,654,290,-519,435,-954,-11
"17540",NA,NA,"Clinton, IA","Micropolitan Statistical Area",2001,49841,-207,109,601,492,-273,34,-307,-43
"17540",NA,19045,"Clinton County, IA","County or equivalent",2001,49841,-207,109,601,492,-273,34,-307,-43
"17580",NA,NA,"Clovis, NM","Micropolitan Statistical Area",2001,44631,-264,440,774,334,-677,75,-752,-27
"17580",NA,35009,"Curry County, NM","County or equivalent",2001,44631,-264,440,774,334,-677,75,-752,-27
"17700",NA,NA,"Coffeyville, KS","Micropolitan Statistical Area",2001,35755,-451,-8,455,463,-419,24,-443,-24
"17700",NA,20125,"Montgomery County, KS","County or equivalent",2001,35755,-451,-8,455,463,-419,24,-443,-24
"17740",NA,NA,"Coldwater, MI","Micropolitan Statistical Area",2001,46009,135,266,653,387,-88,84,-172,-43
"17740",NA,26023,"Branch County, MI","County or equivalent",2001,46009,135,266,653,387,-88,84,-172,-43
"17940",NA,NA,"Columbia, TN","Micropolitan Statistical Area",2001,70135,443,300,1028,728,219,113,106,-76
"17940",NA,47119,"Maury County, TN","County or equivalent",2001,70135,443,300,1028,728,219,113,106,-76
"18060",NA,NA,"Columbus, MS","Micropolitan Statistical Area",2001,60967,-535,451,933,482,-946,10,-956,-40
"18060",NA,28087,"Lowndes County, MS","County or equivalent",2001,60967,-535,451,933,482,-946,10,-956,-40
"18100",NA,NA,"Columbus, NE","Micropolitan Statistical Area",2001,31396,-125,214,464,250,-305,66,-371,-34
"18100",NA,31141,"Platte County, NE","County or equivalent",2001,31396,-125,214,464,250,-305,66,-371,-34
"18180",NA,NA,"Concord, NH","Micropolitan Statistical Area",2001,138597,1959,350,1498,1148,1706,159,1547,-97
"18180",NA,33013,"Merrimack County, NH","County or equivalent",2001,138597,1959,350,1498,1148,1706,159,1547,-97
"18220",NA,NA,"Connersville, IN","Micropolitan Statistical Area",2001,25251,-305,35,339,304,-323,2,-325,-17
"18220",NA,18041,"Fayette County, IN","County or equivalent",2001,25251,-305,35,339,304,-323,2,-325,-17
"18260",NA,NA,"Cookeville, TN","Micropolitan Statistical Area",2001,94506,803,191,1183,992,700,163,537,-88
"18260",NA,47087,"Jackson County, TN","County or equivalent",2001,11114,83,-50,106,156,141,4,137,-8
"18260",NA,47133,"Overton County, TN","County or equivalent",2001,20183,12,25,241,216,7,0,7,-20
"18260",NA,47141,"Putnam County, TN","County or equivalent",2001,63209,708,216,836,620,552,159,393,-60
"18300",NA,NA,"Coos Bay, OR","Micropolitan Statistical Area",2001,62169,-502,-192,624,816,-259,48,-307,-51
"18300",NA,41011,"Coos County, OR","County or equivalent",2001,62169,-502,-192,624,816,-259,48,-307,-51
"18340",NA,NA,"Corbin, KY","Micropolitan Statistical Area",2001,36446,475,95,489,394,412,9,403,-32
"18340",NA,21235,"Whitley County, KY","County or equivalent",2001,36446,475,95,489,394,412,9,403,-32
"18380",NA,NA,"Cordele, GA","Micropolitan Statistical Area",2001,22019,46,118,367,249,-51,36,-87,-21
"18380",NA,13081,"Crisp County, GA","County or equivalent",2001,22019,46,118,367,249,-51,36,-87,-21
"18420",NA,NA,"Corinth, MS","Micropolitan Statistical Area",2001,34653,46,-10,458,468,92,24,68,-36
"18420",NA,28003,"Alcorn County, MS","County or equivalent",2001,34653,46,-10,458,468,92,24,68,-36
"18460",NA,NA,"Cornelia, GA","Micropolitan Statistical Area",2001,36989,871,198,550,352,698,149,549,-25
"18460",NA,13137,"Habersham County, GA","County or equivalent",2001,36989,871,198,550,352,698,149,549,-25
"18500",NA,NA,"Corning, NY","Micropolitan Statistical Area",2001,98939,162,124,1189,1065,135,53,82,-97
"18500",NA,36101,"Steuben County, NY","County or equivalent",2001,98939,162,124,1189,1065,135,53,82,-97
"18620",NA,NA,"Corsicana, TX","Micropolitan Statistical Area",2001,45978,673,164,730,566,546,260,286,-37
"18620",NA,48349,"Navarro County, TX","County or equivalent",2001,45978,673,164,730,566,546,260,286,-37
"18660",NA,NA,"Cortland, NY","Micropolitan Statistical Area",2001,48609,35,94,537,443,-8,34,-42,-51
"18660",NA,36023,"Cortland County, NY","County or equivalent",2001,48609,35,94,537,443,-8,34,-42,-51
"18740",NA,NA,"Coshocton, OH","Micropolitan Statistical Area",2001,36814,124,118,489,371,44,27,17,-38
"18740",NA,39031,"Coshocton County, OH","County or equivalent",2001,36814,124,118,489,371,44,27,17,-38
"18820",NA,NA,"Crawfordsville, IN","Micropolitan Statistical Area",2001,37764,164,86,477,391,115,54,61,-37
"18820",NA,18107,"Montgomery County, IN","County or equivalent",2001,37764,164,86,477,391,115,54,61,-37
"18860",NA,NA,"Crescent City, CA","Micropolitan Statistical Area",2001,27344,-127,-19,280,299,-84,66,-150,-24
"18860",NA,6015,"Del Norte County, CA","County or equivalent",2001,27344,-127,-19,280,299,-84,66,-150,-24
"18900",NA,NA,"Crossville, TN","Micropolitan Statistical Area",2001,47693,669,-35,515,550,739,10,729,-35
"18900",NA,47035,"Cumberland County, TN","County or equivalent",2001,47693,669,-35,515,550,739,10,729,-35
"18940",NA,NA,"Crowley, LA","Micropolitan Statistical Area",2001,58732,-87,273,904,631,-310,8,-318,-50
"18940",NA,22001,"Acadia Parish, LA","County or equivalent",2001,58732,-87,273,904,631,-310,8,-318,-50
"18980",NA,NA,"Cullman, AL","Micropolitan Statistical Area",2001,77652,74,133,993,860,20,96,-76,-79
"18980",NA,1043,"Cullman County, AL","County or equivalent",2001,77652,74,133,993,860,20,96,-76,-79
"19020",NA,NA,"Culpeper, VA","Micropolitan Statistical Area",2001,35317,843,145,472,327,725,72,653,-27
"19020",NA,51047,"Culpeper County, VA","County or equivalent",2001,35317,843,145,472,327,725,72,653,-27
"19220",NA,NA,"Danville, KY","Micropolitan Statistical Area",2001,51403,234,146,669,523,129,64,65,-41
"19220",NA,21021,"Boyle County, KY","County or equivalent",2001,27608,-94,32,334,302,-103,51,-154,-23
"19220",NA,21137,"Lincoln County, KY","County or equivalent",2001,23795,328,114,335,221,232,13,219,-18
"19300",NA,NA,"Daphne-Fairhope-Foley, AL","Micropolitan Statistical Area",2001,144936,3582,550,1890,1340,2997,179,2818,35
"19300",NA,1003,"Baldwin County, AL","County or equivalent",2001,144936,3582,550,1890,1340,2997,179,2818,35
"19540",NA,NA,"Decatur, IN","Micropolitan Statistical Area",2001,33554,-58,253,599,346,-285,10,-295,-26
"19540",NA,18001,"Adams County, IN","County or equivalent",2001,33554,-58,253,599,346,-285,10,-295,-26
"19580",NA,NA,"Defiance, OH","Micropolitan Statistical Area",2001,39371,-81,160,504,344,-207,17,-224,-34
"19580",NA,39039,"Defiance County, OH","County or equivalent",2001,39371,-81,160,504,344,-207,17,-224,-34
"19620",NA,NA,"Del Rio, TX","Micropolitan Statistical Area",2001,45098,90,536,855,319,-412,226,-638,-34
"19620",NA,48465,"Val Verde County, TX","County or equivalent",2001,45098,90,536,855,319,-412,226,-638,-34
"19700",NA,NA,"Deming, NM","Micropolitan Statistical Area",2001,24840,-138,141,392,251,-266,174,-440,-13
"19700",NA,35029,"Luna County, NM","County or equivalent",2001,24840,-138,141,392,251,-266,174,-440,-13
"19760",NA,NA,"De Ridder, LA","Micropolitan Statistical Area",2001,33063,36,96,421,325,-24,4,-28,-36
"19760",NA,22011,"Beauregard Parish, LA","County or equivalent",2001,33063,36,96,421,325,-24,4,-28,-36
"19860",NA,NA,"Dickinson, ND","Micropolitan Statistical Area",2001,23241,-189,30,248,218,-202,13,-215,-17
"19860",NA,38007,"Billings County, ND","County or equivalent",2001,883,6,3,8,5,3,2,1,0
"19860",NA,38089,"Stark County, ND","County or equivalent",2001,22358,-195,27,240,213,-205,11,-216,-17
"19900",NA,NA,"Dillon, SC","Micropolitan Statistical Area",2001,30883,204,241,553,312,-6,21,-27,-31
"19900",NA,45033,"Dillon County, SC","County or equivalent",2001,30883,204,241,553,312,-6,21,-27,-31
"19940",NA,NA,"Dixon, IL","Micropolitan Statistical Area",2001,35916,-139,-15,379,394,-91,16,-107,-33
"19940",NA,17103,"Lee County, IL","County or equivalent",2001,35916,-139,-15,379,394,-91,16,-107,-33
"19980",NA,NA,"Dodge City, KS","Micropolitan Statistical Area",2001,32281,-284,343,632,289,-621,447,-1068,-6
"19980",NA,20057,"Ford County, KS","County or equivalent",2001,32281,-284,343,632,289,-621,447,-1068,-6
"20060",NA,NA,"Douglas, GA","Micropolitan Statistical Area",2001,45804,634,396,770,374,279,195,84,-41
"20060",NA,13003,"Atkinson County, GA","County or equivalent",2001,7628,19,87,144,57,-61,58,-119,-7
"20060",NA,13069,"Coffee County, GA","County or equivalent",2001,38176,615,309,626,317,340,137,203,-34
"20140",NA,NA,"Dublin, GA","Micropolitan Statistical Area",2001,53617,101,219,782,563,-65,33,-98,-53
"20140",NA,13167,"Johnson County, GA","County or equivalent",2001,8476,-82,-3,110,113,-73,2,-75,-6
"20140",NA,13175,"Laurens County, GA","County or equivalent",2001,45141,183,222,672,450,8,31,-23,-47
"20180",NA,NA,"DuBois, PA","Micropolitan Statistical Area",2001,82981,-388,-102,820,922,-209,14,-223,-77
"20180",NA,42033,"Clearfield County, PA","County or equivalent",2001,82981,-388,-102,820,922,-209,14,-223,-77
"20300",NA,NA,"Dumas, TX","Micropolitan Statistical Area",2001,20180,88,280,409,129,-178,160,-338,-14
"20300",NA,48341,"Moore County, TX","County or equivalent",2001,20180,88,280,409,129,-178,160,-338,-14
"20340",NA,NA,"Duncan, OK","Micropolitan Statistical Area",2001,42624,-448,-126,504,630,-276,1,-277,-46
"20340",NA,40137,"Stephens County, OK","County or equivalent",2001,42624,-448,-126,504,630,-276,1,-277,-46
"20380",NA,NA,"Dunn, NC","Micropolitan Statistical Area",2001,93590,2127,692,1478,786,1495,247,1248,-60
"20380",NA,37085,"Harnett County, NC","County or equivalent",2001,93590,2127,692,1478,786,1495,247,1248,-60
"20420",NA,NA,"Durango, CO","Micropolitan Statistical Area",2001,45093,881,253,471,218,658,33,625,-30
"20420",NA,8067,"La Plata County, CO","County or equivalent",2001,45093,881,253,471,218,658,33,625,-30
"20460",NA,NA,"Durant, OK","Micropolitan Statistical Area",2001,36459,-139,99,489,390,-210,48,-258,-28
"20460",NA,40013,"Bryan County, OK","County or equivalent",2001,36459,-139,99,489,390,-210,48,-258,-28
"20540",NA,NA,"Dyersburg, TN","Micropolitan Statistical Area",2001,37107,-214,73,522,449,-256,39,-295,-31
"20540",NA,47045,"Dyer County, TN","County or equivalent",2001,37107,-214,73,522,449,-256,39,-295,-31
"20580",NA,NA,"Eagle Pass, TX","Micropolitan Statistical Area",2001,47579,236,731,1001,270,-467,316,-783,-28
"20580",NA,48323,"Maverick County, TX","County or equivalent",2001,47579,236,731,1001,270,-467,316,-783,-28
"20620",NA,NA,"East Liverpool-Salem, OH","Micropolitan Statistical Area",2001,111398,-694,50,1306,1256,-652,19,-671,-92
"20620",NA,39029,"Columbiana County, OH","County or equivalent",2001,111398,-694,50,1306,1256,-652,19,-671,-92
"20660",NA,NA,"Easton, MD","Micropolitan Statistical Area",2001,34098,206,-71,340,411,311,30,281,-34
"20660",NA,24041,"Talbot County, MD","County or equivalent",2001,34098,206,-71,340,411,311,30,281,-34
"20700",NA,NA,"East Stroudsburg, PA","Micropolitan Statistical Area",2001,143543,3778,314,1520,1206,3518,149,3369,-54
"20700",NA,42089,"Monroe County, PA","County or equivalent",2001,143543,3778,314,1520,1206,3518,149,3369,-54
"20780",NA,NA,"Edwards, CO","Micropolitan Statistical Area",2001,51195,1390,812,922,110,626,736,-110,-48
"20780",NA,8037,"Eagle County, CO","County or equivalent",2001,43383,1400,721,787,66,722,633,89,-43
"20780",NA,8065,"Lake County, CO","County or equivalent",2001,7812,-10,91,135,44,-96,103,-199,-5
"20820",NA,NA,"Effingham, IL","Micropolitan Statistical Area",2001,34359,99,142,454,312,-7,14,-21,-36
"20820",NA,17049,"Effingham County, IL","County or equivalent",2001,34359,99,142,454,312,-7,14,-21,-36
"20900",NA,NA,"El Campo, TX","Micropolitan Statistical Area",2001,40982,-233,215,614,399,-422,129,-551,-26
"20900",NA,48481,"Wharton County, TX","County or equivalent",2001,40982,-233,215,614,399,-422,129,-551,-26
"20980",NA,NA,"El Dorado, AR","Micropolitan Statistical Area",2001,45050,-525,-36,581,617,-451,34,-485,-38
"20980",NA,5139,"Union County, AR","County or equivalent",2001,45050,-525,-36,581,617,-451,34,-485,-38
"21020",NA,NA,"Elizabeth City, NC","Micropolitan Statistical Area",2001,53449,220,96,708,612,168,25,143,-44
"21020",NA,37029,"Camden County, NC","County or equivalent",2001,7081,159,12,73,61,150,-2,152,-3
"21020",NA,37139,"Pasquotank County, NC","County or equivalent",2001,34900,-6,111,516,405,-86,26,-112,-31
"21020",NA,37143,"Perquimans County, NC","County or equivalent",2001,11468,67,-27,119,146,104,1,103,-10
"21120",NA,NA,"Elk City, OK","Micropolitan Statistical Area",2001,19776,31,12,266,254,40,10,30,-21
"21120",NA,40009,"Beckham County, OK","County or equivalent",2001,19776,31,12,266,254,40,10,30,-21
"21220",NA,NA,"Elko, NV","Micropolitan Statistical Area",2001,46622,-240,408,632,224,-620,165,-785,-28
"21220",NA,32007,"Elko County, NV","County or equivalent",2001,45003,-232,404,618,214,-610,154,-764,-26
"21220",NA,32011,"Eureka County, NV","County or equivalent",2001,1619,-8,4,14,10,-10,11,-21,-2
"21260",NA,NA,"Ellensburg, WA","Micropolitan Statistical Area",2001,33888,380,129,384,255,280,81,199,-29
"21260",NA,53037,"Kittitas County, WA","County or equivalent",2001,33888,380,129,384,255,280,81,199,-29
"21380",NA,NA,"Emporia, KS","Micropolitan Statistical Area",2001,38981,-6,266,605,339,-238,198,-436,-34
"21380",NA,20017,"Chase County, KS","County or equivalent",2001,2980,-49,15,58,43,-62,6,-68,-2
"21380",NA,20111,"Lyon County, KS","County or equivalent",2001,36001,43,251,547,296,-176,192,-368,-32
"21420",NA,NA,"Enid, OK","Micropolitan Statistical Area",2001,57181,-509,154,822,668,-625,44,-669,-38
"21420",NA,40047,"Garfield County, OK","County or equivalent",2001,57181,-509,154,822,668,-625,44,-669,-38
"21460",NA,NA,"Enterprise-Ozark, AL","Micropolitan Statistical Area",2001,92569,-44,453,1339,886,-415,65,-480,-82
"21460",NA,1031,"Coffee County, AL","County or equivalent",2001,43579,36,96,540,444,-19,41,-60,-41
"21460",NA,1045,"Dale County, AL","County or equivalent",2001,48990,-80,357,799,442,-396,24,-420,-41
"21540",NA,NA,"Escanaba, MI","Micropolitan Statistical Area",2001,38339,-209,40,453,413,-214,8,-222,-35
"21540",NA,26041,"Delta County, MI","County or equivalent",2001,38339,-209,40,453,413,-214,8,-222,-35
"21580",NA,NA,"Espanola, NM","Micropolitan Statistical Area",2001,40981,-255,385,704,319,-613,97,-710,-27
"21580",NA,35039,"Rio Arriba County, NM","County or equivalent",2001,40981,-255,385,704,319,-613,97,-710,-27
"21640",NA,NA,"Eufaula, AL-GA","Micropolitan Statistical Area",2001,31840,205,112,468,356,-138,48,-186,231
"21640",NA,1005,"Barbour County, AL","County or equivalent",2001,29210,178,106,429,323,-161,44,-205,233
"21640",NA,13239,"Quitman County, GA","County or equivalent",2001,2630,27,6,39,33,23,4,19,-2
"21700",NA,NA,"Eureka-Arcata-Fortuna, CA","Micropolitan Statistical Area",2001,127003,603,182,1447,1265,543,148,395,-122
"21700",NA,6023,"Humboldt County, CA","County or equivalent",2001,127003,603,182,1447,1265,543,148,395,-122
"21740",NA,NA,"Evanston, WY","Micropolitan Statistical Area",2001,19405,-257,184,292,108,-431,12,-443,-10
"21740",NA,56041,"Uinta County, WY","County or equivalent",2001,19405,-257,184,292,108,-431,12,-443,-10
"21860",NA,NA,"Fairmont, MN","Micropolitan Statistical Area",2001,21421,-350,4,232,228,-344,6,-350,-10
"21860",NA,27091,"Martin County, MN","County or equivalent",2001,21421,-350,4,232,228,-344,6,-350,-10
"21900",NA,NA,"Fairmont, WV","Micropolitan Statistical Area",2001,56163,-341,-188,600,788,-99,19,-118,-54
"21900",NA,54049,"Marion County, WV","County or equivalent",2001,56163,-341,-188,600,788,-99,19,-118,-54
"21980",NA,NA,"Fallon, NV","Micropolitan Statistical Area",2001,24310,302,336,543,207,-10,29,-39,-24
"21980",NA,32001,"Churchill County, NV","County or equivalent",2001,24310,302,336,543,207,-10,29,-39,-24
"22060",NA,NA,"Faribault-Northfield, MN","Micropolitan Statistical Area",2001,57701,890,254,712,458,685,170,515,-49
"22060",NA,27131,"Rice County, MN","County or equivalent",2001,57701,890,254,712,458,685,170,515,-49
"22100",NA,NA,"Farmington, MO","Micropolitan Statistical Area",2001,56089,345,-3,704,707,397,18,379,-49
"22100",NA,29187,"St. Francois County, MO","County or equivalent",2001,56089,345,-3,704,707,397,18,379,-49
"22260",NA,NA,"Fergus Falls, MN","Micropolitan Statistical Area",2001,57093,-59,-80,547,627,75,85,-10,-54
"22260",NA,27111,"Otter Tail County, MN","County or equivalent",2001,57093,-59,-80,547,627,75,85,-10,-54
"22280",NA,NA,"Fernley, NV","Micropolitan Statistical Area",2001,36130,1288,120,432,312,1186,51,1135,-18
"22280",NA,32019,"Lyon County, NV","County or equivalent",2001,36130,1288,120,432,312,1186,51,1135,-18
"22300",NA,NA,"Findlay, OH","Micropolitan Statistical Area",2001,71929,602,353,952,599,317,82,235,-68
"22300",NA,39063,"Hancock County, OH","County or equivalent",2001,71929,602,353,952,599,317,82,235,-68
"22340",NA,NA,"Fitzgerald, GA","Micropolitan Statistical Area",2001,27282,-149,102,436,334,-230,53,-283,-21
"22340",NA,13017,"Ben Hill County, GA","County or equivalent",2001,17298,-174,87,310,223,-251,35,-286,-10
"22340",NA,13155,"Irwin County, GA","County or equivalent",2001,9984,25,15,126,111,21,18,3,-11
"22580",NA,NA,"Forest City, NC","Micropolitan Statistical Area",2001,63155,197,149,907,758,112,30,82,-64
"22580",NA,37161,"Rutherford County, NC","County or equivalent",2001,63155,197,149,907,758,112,30,82,-64
"22620",NA,NA,"Forrest City, AR","Micropolitan Statistical Area",2001,28834,-450,85,447,362,-517,1,-518,-18
"22620",NA,5123,"St. Francis County, AR","County or equivalent",2001,28834,-450,85,447,362,-517,1,-518,-18
"22700",NA,NA,"Fort Dodge, IA","Micropolitan Statistical Area",2001,40036,-160,58,518,460,-184,27,-211,-34
"22700",NA,19187,"Webster County, IA","County or equivalent",2001,40036,-160,58,518,460,-184,27,-211,-34
"22780",NA,NA,"Fort Leonard Wood, MO","Micropolitan Statistical Area",2001,42853,1141,336,597,261,823,-90,913,-18
"22780",NA,29169,"Pulaski County, MO","County or equivalent",2001,42853,1141,336,597,261,823,-90,913,-18
"22800",NA,NA,"Fort Madison-Keokuk, IA-MO","Micropolitan Statistical Area",2001,44814,-493,-20,490,510,-441,16,-457,-32
"22800",NA,19111,"Lee County, IA","County or equivalent",2001,37381,-537,-33,399,432,-479,16,-495,-25
"22800",NA,29045,"Clark County, MO","County or equivalent",2001,7433,44,13,91,78,38,0,38,-7
"22820",NA,NA,"Fort Morgan, CO","Micropolitan Statistical Area",2001,27276,33,200,477,277,-145,196,-341,-22
"22820",NA,8087,"Morgan County, CO","County or equivalent",2001,27276,33,200,477,277,-145,196,-341,-22
"22840",NA,NA,"Fort Payne, AL","Micropolitan Statistical Area",2001,65488,861,244,942,698,670,187,483,-53
"22840",NA,1049,"DeKalb County, AL","County or equivalent",2001,65488,861,244,942,698,670,187,483,-53
"22860",NA,NA,"Fort Polk South, LA","Micropolitan Statistical Area",2001,52223,-300,675,1025,350,-942,-10,-932,-33
"22860",NA,22115,"Vernon Parish, LA","County or equivalent",2001,52223,-300,675,1025,350,-942,-10,-932,-33
"22980",NA,NA,"Fort Valley, GA","Micropolitan Statistical Area",2001,23969,137,138,356,218,24,72,-48,-25
"22980",NA,13225,"Peach County, GA","County or equivalent",2001,23969,137,138,356,218,24,72,-48,-25
"23140",NA,NA,"Frankfort, IN","Micropolitan Statistical Area",2001,33934,-27,180,549,369,-179,174,-353,-28
"23140",NA,18023,"Clinton County, IN","County or equivalent",2001,33934,-27,180,549,369,-179,174,-353,-28
"23180",NA,NA,"Frankfort, KY","Micropolitan Statistical Area",2001,67574,537,236,845,609,361,73,288,-60
"23180",NA,21005,"Anderson County, KY","County or equivalent",2001,19458,274,69,228,159,220,5,215,-15
"23180",NA,21073,"Franklin County, KY","County or equivalent",2001,48116,263,167,617,450,141,68,73,-45
"23240",NA,NA,"Fredericksburg, TX","Micropolitan Statistical Area",2001,21099,186,-62,233,295,267,42,225,-19
"23240",NA,48171,"Gillespie County, TX","County or equivalent",2001,21099,186,-62,233,295,267,42,225,-19
"23300",NA,NA,"Freeport, IL","Micropolitan Statistical Area",2001,48445,-441,67,621,554,-474,62,-536,-34
"23300",NA,17177,"Stephenson County, IL","County or equivalent",2001,48445,-441,67,621,554,-474,62,-536,-34
"23340",NA,NA,"Fremont, NE","Micropolitan Statistical Area",2001,36019,-201,65,468,403,-238,34,-272,-28
"23340",NA,31053,"Dodge County, NE","County or equivalent",2001,36019,-201,65,468,403,-238,34,-272,-28
"23380",NA,NA,"Fremont, OH","Micropolitan Statistical Area",2001,61675,-133,302,868,566,-378,12,-390,-57
"23380",NA,39143,"Sandusky County, OH","County or equivalent",2001,61675,-133,302,868,566,-378,12,-390,-57
"23500",NA,NA,"Gaffney, SC","Micropolitan Statistical Area",2001,52986,319,265,801,536,105,34,71,-51
"23500",NA,45021,"Cherokee County, SC","County or equivalent",2001,52986,319,265,801,536,105,34,71,-51
"23620",NA,NA,"Gainesville, TX","Micropolitan Statistical Area",2001,36895,437,137,532,395,334,127,207,-34
"23620",NA,48097,"Cooke County, TX","County or equivalent",2001,36895,437,137,532,395,334,127,207,-34
"23660",NA,NA,"Galesburg, IL","Micropolitan Statistical Area",2001,73612,-825,-88,857,945,-684,18,-702,-53
"23660",NA,17095,"Knox County, IL","County or equivalent",2001,55170,-587,-75,653,728,-472,15,-487,-40
"23660",NA,17187,"Warren County, IL","County or equivalent",2001,18442,-238,-13,204,217,-212,3,-215,-13
"23700",NA,NA,"Gallup, NM","Micropolitan Statistical Area",2001,74412,-171,858,1357,499,-973,47,-1020,-56
"23700",NA,35031,"McKinley County, NM","County or equivalent",2001,74412,-171,858,1357,499,-973,47,-1020,-56
"23780",NA,NA,"Garden City, KS","Micropolitan Statistical Area",2001,40638,54,664,901,237,-1097,443,-1540,487
"23780",NA,20055,"Finney County, KS","County or equivalent",2001,40638,54,664,901,237,-1097,443,-1540,487
"23820",NA,NA,"Gardnerville Ranchos, NV","Micropolitan Statistical Area",2001,42133,707,4,295,291,732,47,685,-29
"23820",NA,32005,"Douglas County, NV","County or equivalent",2001,42133,707,4,295,291,732,47,685,-29
"23860",NA,NA,"Georgetown, SC","Micropolitan Statistical Area",2001,56785,743,185,750,565,615,60,555,-57
"23860",NA,45043,"Georgetown County, SC","County or equivalent",2001,56785,743,185,750,565,615,60,555,-57
"23900",NA,NA,"Gettysburg, PA","Micropolitan Statistical Area",2001,92768,1183,291,1080,789,978,143,835,-86
"23900",NA,42001,"Adams County, PA","County or equivalent",2001,92768,1183,291,1080,789,978,143,835,-86
"23940",NA,NA,"Gillette, WY","Micropolitan Statistical Area",2001,34519,581,371,516,145,240,18,222,-30
"23940",NA,56005,"Campbell County, WY","County or equivalent",2001,34519,581,371,516,145,240,18,222,-30
"23980",NA,NA,"Glasgow, KY","Micropolitan Statistical Area",2001,48546,408,67,635,568,380,27,353,-39
"23980",NA,21009,"Barren County, KY","County or equivalent",2001,38458,340,56,503,447,315,26,289,-31
"23980",NA,21169,"Metcalfe County, KY","County or equivalent",2001,10088,68,11,132,121,65,1,64,-8
"24100",NA,NA,"Gloversville, NY","Micropolitan Statistical Area",2001,54864,-143,1,631,630,-94,32,-126,-50
"24100",NA,36035,"Fulton County, NY","County or equivalent",2001,54864,-143,1,631,630,-94,32,-126,-50
"24180",NA,NA,"Granbury, TX","Micropolitan Statistical Area",2001,49545,1252,-31,536,567,1301,75,1226,-18
"24180",NA,48221,"Hood County, TX","County or equivalent",2001,42644,1181,-42,447,489,1232,61,1171,-9
"24180",NA,48425,"Somervell County, TX","County or equivalent",2001,6901,71,11,89,78,69,14,55,-9
"24260",NA,NA,"Grand Island, NE","Micropolitan Statistical Area",2001,67918,-280,412,1041,629,-647,270,-917,-45
"24260",NA,31079,"Hall County, NE","County or equivalent",2001,53397,-95,405,893,488,-464,265,-729,-36
"24260",NA,31093,"Howard County, NE","County or equivalent",2001,6483,-59,-1,65,66,-53,2,-55,-5
"24260",NA,31121,"Merrick County, NE","County or equivalent",2001,8038,-126,8,83,75,-130,3,-133,-4
"24380",NA,NA,"Grants, NM","Micropolitan Statistical Area",2001,26629,984,251,445,194,745,13,732,-12
"24380",NA,35006,"Cibola County, NM","County or equivalent",2001,26629,984,251,445,194,745,13,732,-12
"24420",NA,NA,"Grants Pass, OR","Micropolitan Statistical Area",2001,76307,465,-184,777,961,712,22,690,-63
"24420",NA,41033,"Josephine County, OR","County or equivalent",2001,76307,465,-184,777,961,712,22,690,-63
"24460",NA,NA,"Great Bend, KS","Micropolitan Statistical Area",2001,27923,-203,-25,312,337,-340,78,-418,162
"24460",NA,20009,"Barton County, KS","County or equivalent",2001,27923,-203,-25,312,337,-340,78,-418,162
"24620",NA,NA,"Greeneville, TN","Micropolitan Statistical Area",2001,63262,225,47,748,701,235,49,186,-57
"24620",NA,47059,"Greene County, TN","County or equivalent",2001,63262,225,47,748,701,235,49,186,-57
"24700",NA,NA,"Greensburg, IN","Micropolitan Statistical Area",2001,24510,-57,157,380,223,-196,34,-230,-18
"24700",NA,18031,"Decatur County, IN","County or equivalent",2001,24510,-57,157,380,223,-196,34,-230,-18
"24740",NA,NA,"Greenville, MS","Micropolitan Statistical Area",2001,61651,-1040,432,1109,677,-1441,26,-1467,-31
"24740",NA,28151,"Washington County, MS","County or equivalent",2001,61651,-1040,432,1109,677,-1441,26,-1467,-31
"24820",NA,NA,"Greenville, OH","Micropolitan Statistical Area",2001,53029,-263,104,644,540,-321,5,-326,-46
"24820",NA,39037,"Darke County, OH","County or equivalent",2001,53029,-263,104,644,540,-321,5,-326,-46
"24900",NA,NA,"Greenwood, MS","Micropolitan Statistical Area",2001,47700,-904,151,685,534,-1029,19,-1048,-26
"24900",NA,28015,"Carroll County, MS","County or equivalent",2001,10657,-116,10,118,108,-114,4,-118,-12
"24900",NA,28083,"Leflore County, MS","County or equivalent",2001,37043,-788,141,567,426,-915,15,-930,-14
"24940",NA,NA,"Greenwood, SC","Micropolitan Statistical Area",2001,66553,267,287,957,670,44,160,-116,-64
"24940",NA,45047,"Greenwood County, SC","County or equivalent",2001,66553,267,287,957,670,44,160,-116,-64
"24980",NA,NA,"Grenada, MS","Micropolitan Statistical Area",2001,23042,-149,23,339,316,-154,14,-168,-18
"24980",NA,28043,"Grenada County, MS","County or equivalent",2001,23042,-149,23,339,316,-154,14,-168,-18
"25100",NA,NA,"Guymon, OK","Micropolitan Statistical Area",2001,20069,-113,271,404,133,-376,244,-620,-8
"25100",NA,40139,"Texas County, OK","County or equivalent",2001,20069,-113,271,404,133,-376,244,-620,-8
"25220",NA,NA,"Hammond, LA","Micropolitan Statistical Area",2001,101608,781,687,1633,946,197,29,168,-103
"25220",NA,22105,"Tangipahoa Parish, LA","County or equivalent",2001,101608,781,687,1633,946,197,29,168,-103
"25300",NA,NA,"Hannibal, MO","Micropolitan Statistical Area",2001,37741,-221,85,495,410,-274,14,-288,-32
"25300",NA,29127,"Marion County, MO","County or equivalent",2001,28105,-204,99,422,323,-281,12,-293,-22
"25300",NA,29173,"Ralls County, MO","County or equivalent",2001,9636,-17,-14,73,87,7,2,5,-10
"25340",NA,NA,"Harriman, TN","Micropolitan Statistical Area",2001,52048,105,12,629,617,139,24,115,-46
"25340",NA,47145,"Roane County, TN","County or equivalent",2001,52048,105,12,629,617,139,24,115,-46
"25380",NA,NA,"Harrisburg, IL","Micropolitan Statistical Area",2001,26370,-261,-177,269,446,-61,6,-67,-23
"25380",NA,17165,"Saline County, IL","County or equivalent",2001,26370,-261,-177,269,446,-61,6,-67,-23
"25460",NA,NA,"Harrison, AR","Micropolitan Statistical Area",2001,42775,77,36,512,476,77,12,65,-36
"25460",NA,5009,"Boone County, AR","County or equivalent",2001,34251,200,21,409,388,209,11,198,-30
"25460",NA,5101,"Newton County, AR","County or equivalent",2001,8524,-123,15,103,88,-132,1,-133,-6
"25580",NA,NA,"Hastings, NE","Micropolitan Statistical Area",2001,38484,309,93,449,356,-273,113,-386,489
"25580",NA,31001,"Adams County, NE","County or equivalent",2001,31578,428,92,371,279,-157,108,-265,493
"25580",NA,31035,"Clay County, NE","County or equivalent",2001,6906,-119,1,78,77,-116,5,-121,-4
"25660",NA,NA,"Havre, MT","Micropolitan Statistical Area",2001,16467,-161,123,273,150,-274,1,-275,-10
"25660",NA,30041,"Hill County, MT","County or equivalent",2001,16467,-161,123,273,150,-274,1,-275,-10
"25700",NA,NA,"Hays, KS","Micropolitan Statistical Area",2001,27532,74,113,345,232,-14,33,-47,-25
"25700",NA,20051,"Ellis County, KS","County or equivalent",2001,27532,74,113,345,232,-14,33,-47,-25
"25720",NA,NA,"Heber, UT","Micropolitan Statistical Area",2001,16091,675,220,296,76,460,49,411,-5
"25720",NA,49051,"Wasatch County, UT","County or equivalent",2001,16091,675,220,296,76,460,49,411,-5
"25740",NA,NA,"Helena, MT","Micropolitan Statistical Area",2001,66311,353,215,762,547,206,25,181,-68
"25740",NA,30043,"Jefferson County, MT","County or equivalent",2001,10120,43,-8,87,95,61,0,61,-10
"25740",NA,30049,"Lewis and Clark County, MT","County or equivalent",2001,56191,310,223,675,452,145,25,120,-58
"25760",NA,NA,"Helena-West Helena, AR","Micropolitan Statistical Area",2001,25662,-606,137,474,337,-728,6,-734,-15
"25760",NA,5107,"Phillips County, AR","County or equivalent",2001,25662,-606,137,474,337,-728,6,-734,-15
"25780",NA,NA,"Henderson, NC","Micropolitan Statistical Area",2001,43642,524,258,750,492,305,115,190,-39
"25780",NA,37181,"Vance County, NC","County or equivalent",2001,43642,524,258,750,492,305,115,190,-39
"25820",NA,NA,"Hereford, TX","Micropolitan Statistical Area",2001,18293,-202,204,346,142,-399,61,-460,-7
"25820",NA,48117,"Deaf Smith County, TX","County or equivalent",2001,18293,-202,204,346,142,-399,61,-460,-7
"25900",NA,NA,"Hilo, HI","Micropolitan Statistical Area",2001,150806,1746,775,2008,1233,1102,461,641,-131
"25900",NA,15001,"Hawaii County, HI","County or equivalent",2001,150806,1746,775,2008,1233,1102,461,641,-131
"25940",NA,NA,"Hilton Head Island-Beaufort, SC","Micropolitan Statistical Area",2001,145607,2836,1134,2178,1044,1816,484,1332,-114
"25940",NA,45013,"Beaufort County, SC","County or equivalent",2001,124740,2672,951,1864,913,1814,371,1443,-93
"25940",NA,45053,"Jasper County, SC","County or equivalent",2001,20867,164,183,314,131,2,113,-111,-21
"26020",NA,NA,"Hobbs, NM","Micropolitan Statistical Area",2001,54841,-307,422,927,505,-690,98,-788,-39
"26020",NA,35025,"Lea County, NM","County or equivalent",2001,54841,-307,422,927,505,-690,98,-788,-39
"26140",NA,NA,"Homosassa Springs, FL","Micropolitan Statistical Area",2001,121070,2430,-1205,849,2054,3665,68,3597,-30
"26140",NA,12017,"Citrus County, FL","County or equivalent",2001,121070,2430,-1205,849,2054,3665,68,3597,-30
"26220",NA,NA,"Hood River, OR","Micropolitan Statistical Area",2001,20394,-73,148,325,177,-210,116,-326,-11
"26220",NA,41027,"Hood River County, OR","County or equivalent",2001,20394,-73,148,325,177,-210,116,-326,-11
"26260",NA,NA,"Hope, AR","Micropolitan Statistical Area",2001,33108,-370,65,476,411,-409,131,-540,-26
"26260",NA,5057,"Hempstead County, AR","County or equivalent",2001,23298,-259,80,341,261,-321,118,-439,-18
"26260",NA,5099,"Nevada County, AR","County or equivalent",2001,9810,-111,-15,135,150,-88,13,-101,-8
"26340",NA,NA,"Houghton, MI","Micropolitan Statistical Area",2001,37853,-409,-22,408,430,-359,63,-422,-28
"26340",NA,26061,"Houghton County, MI","County or equivalent",2001,35559,-393,-31,379,410,-338,62,-400,-24
"26340",NA,26083,"Keweenaw County, MI","County or equivalent",2001,2294,-16,9,29,20,-21,1,-22,-4
"26460",NA,NA,"Hudson, NY","Micropolitan Statistical Area",2001,62813,-245,-104,598,702,-73,68,-141,-68
"26460",NA,36021,"Columbia County, NY","County or equivalent",2001,62813,-245,-104,598,702,-73,68,-141,-68
"26480",NA,NA,"Humboldt, TN","Micropolitan Statistical Area",2001,48000,-157,-84,633,717,-28,23,-51,-45
"26480",NA,47053,"Gibson County, TN","County or equivalent",2001,48000,-157,-84,633,717,-28,23,-51,-45
"26500",NA,NA,"Huntingdon, PA","Micropolitan Statistical Area",2001,45562,-47,95,519,424,-96,5,-101,-46
"26500",NA,42061,"Huntingdon County, PA","County or equivalent",2001,45562,-47,95,519,424,-96,5,-101,-46
"26540",NA,NA,"Huntington, IN","Micropolitan Statistical Area",2001,37973,-126,82,483,401,-171,11,-182,-37
"26540",NA,18069,"Huntington County, IN","County or equivalent",2001,37973,-126,82,483,401,-171,11,-182,-37
"26660",NA,NA,"Huntsville, TX","Micropolitan Statistical Area",2001,62220,476,195,626,431,338,108,230,-57
"26660",NA,48471,"Walker County, TX","County or equivalent",2001,62220,476,195,626,431,338,108,230,-57
"26700",NA,NA,"Huron, SD","Micropolitan Statistical Area",2001,16805,-178,-51,171,222,-114,5,-119,-13
"26700",NA,46005,"Beadle County, SD","County or equivalent",2001,16805,-178,-51,171,222,-114,5,-119,-13
"26740",NA,NA,"Hutchinson, KS","Micropolitan Statistical Area",2001,64469,-219,201,887,686,-369,55,-424,-51
"26740",NA,20155,"Reno County, KS","County or equivalent",2001,64469,-219,201,887,686,-369,55,-424,-51
"26780",NA,NA,"Hutchinson, MN","Micropolitan Statistical Area",2001,35170,305,237,526,289,106,31,75,-38
"26780",NA,27085,"McLeod County, MN","County or equivalent",2001,35170,305,237,526,289,106,31,75,-38
"26860",NA,NA,"Indiana, PA","Micropolitan Statistical Area",2001,89170,-365,-16,876,892,-269,54,-323,-80
"26860",NA,42063,"Indiana County, PA","County or equivalent",2001,89170,-365,-16,876,892,-269,54,-323,-80
"26940",NA,NA,"Indianola, MS","Micropolitan Statistical Area",2001,33954,-278,182,508,326,-430,15,-445,-30
"26940",NA,28133,"Sunflower County, MS","County or equivalent",2001,33954,-278,182,508,326,-430,15,-445,-30
"27020",NA,NA,"Iron Mountain, MI-WI","Micropolitan Statistical Area",2001,32236,-328,-44,308,352,-260,5,-265,-24
"27020",NA,26043,"Dickinson County, MI","County or equivalent",2001,27184,-292,-31,272,303,-241,4,-245,-20
"27020",NA,55037,"Florence County, WI","County or equivalent",2001,5052,-36,-13,36,49,-19,1,-20,-4
"27220",NA,NA,"Jackson, WY-ID","Micropolitan Statistical Area",2001,24977,508,215,325,110,316,149,167,-23
"27220",NA,16081,"Teton County, ID","County or equivalent",2001,6399,295,103,138,35,196,53,143,-4
"27220",NA,56039,"Teton County, WY","County or equivalent",2001,18578,213,112,187,75,120,96,24,-19
"27300",NA,NA,"Jacksonville, IL","Micropolitan Statistical Area",2001,41811,-347,46,498,452,-358,13,-371,-35
"27300",NA,17137,"Morgan County, IL","County or equivalent",2001,36300,-319,39,428,389,-328,13,-341,-30
"27300",NA,17171,"Scott County, IL","County or equivalent",2001,5511,-28,7,70,63,-30,0,-30,-5
"27380",NA,NA,"Jacksonville, TX","Micropolitan Statistical Area",2001,46721,24,157,692,535,-91,211,-302,-42
"27380",NA,48073,"Cherokee County, TX","County or equivalent",2001,46721,24,157,692,535,-91,211,-302,-42
"27420",NA,NA,"Jamestown, ND","Micropolitan Statistical Area",2001,21563,-280,-43,198,241,-220,6,-226,-17
"27420",NA,38093,"Stutsman County, ND","County or equivalent",2001,21563,-280,-43,198,241,-220,6,-226,-17
"27460",NA,NA,"Jamestown-Dunkirk-Fredonia, NY","Micropolitan Statistical Area",2001,138604,-1057,70,1580,1510,-1016,62,-1078,-111
"27460",NA,36013,"Chautauqua County, NY","County or equivalent",2001,138604,-1057,70,1580,1510,-1016,62,-1078,-111
"27540",NA,NA,"Jasper, IN","Micropolitan Statistical Area",2001,52726,217,195,685,490,76,62,14,-54
"27540",NA,18037,"Dubois County, IN","County or equivalent",2001,39894,201,175,531,356,67,60,7,-41
"27540",NA,18125,"Pike County, IN","County or equivalent",2001,12832,16,20,154,134,9,2,7,-13
"27660",NA,NA,"Jennings, LA","Micropolitan Statistical Area",2001,31100,-299,162,512,350,-443,4,-447,-18
"27660",NA,22053,"Jefferson Davis Parish, LA","County or equivalent",2001,31100,-299,162,512,350,-443,4,-447,-18
"27700",NA,NA,"Jesup, GA","Micropolitan Statistical Area",2001,26847,253,120,370,250,156,20,136,-23
"27700",NA,13305,"Wayne County, GA","County or equivalent",2001,26847,253,120,370,250,156,20,136,-23
"27940",NA,NA,"Juneau, AK","Micropolitan Statistical Area",2001,30475,-195,266,412,146,-441,48,-489,-20
"27940",NA,2110,"Juneau City and Borough, AK","County or equivalent",2001,30475,-195,266,412,146,-441,48,-489,-20
"27980",NA,NA,"Kahului-Wailuku, HI","Micropolitan Statistical Area",2001,131265,2551,904,1780,876,1745,598,1147,-98
"27980",NA,15009,"Maui County, HI","County or equivalent",2001,131265,2551,904,1780,876,1745,598,1147,-98
"28060",NA,NA,"Kalispell, MT","Micropolitan Statistical Area",2001,75987,1277,291,964,673,1047,33,1014,-61
"28060",NA,30029,"Flathead County, MT","County or equivalent",2001,75987,1277,291,964,673,1047,33,1014,-61
"28180",NA,NA,"Kapaa, HI","Micropolitan Statistical Area",2001,58722,216,315,764,449,-42,148,-190,-57
"28180",NA,15007,"Kauai County, HI","County or equivalent",2001,58722,216,315,764,449,-42,148,-190,-57
"28260",NA,NA,"Kearney, NE","Micropolitan Statistical Area",2001,49252,23,238,634,396,-170,45,-215,-45
"28260",NA,31019,"Buffalo County, NE","County or equivalent",2001,42422,79,245,570,325,-128,45,-173,-38
"28260",NA,31099,"Kearney County, NE","County or equivalent",2001,6830,-56,-7,64,71,-42,0,-42,-7
"28300",NA,NA,"Keene, NH","Micropolitan Statistical Area",2001,74384,396,102,782,680,361,36,325,-67
"28300",NA,33005,"Cheshire County, NH","County or equivalent",2001,74384,396,102,782,680,361,36,325,-67
"28340",NA,NA,"Kendallville, IN","Micropolitan Statistical Area",2001,46965,507,392,776,384,161,168,-7,-46
"28340",NA,18113,"Noble County, IN","County or equivalent",2001,46965,507,392,776,384,161,168,-7,-46
"28380",NA,NA,"Kennett, MO","Micropolitan Statistical Area",2001,32873,-234,21,488,467,-222,24,-246,-33
"28380",NA,29069,"Dunklin County, MO","County or equivalent",2001,32873,-234,21,488,467,-222,24,-246,-33
"28500",NA,NA,"Kerrville, TX","Micropolitan Statistical Area",2001,44205,374,-110,494,604,525,94,431,-41
"28500",NA,48265,"Kerr County, TX","County or equivalent",2001,44205,374,-110,494,604,525,94,431,-41
"28540",NA,NA,"Ketchikan, AK","Micropolitan Statistical Area",2001,13762,-223,64,170,106,-280,16,-296,-7
"28540",NA,2130,"Ketchikan Gateway Borough, AK","County or equivalent",2001,13762,-223,64,170,106,-280,16,-296,-7
"28580",NA,NA,"Key West, FL","Micropolitan Statistical Area",2001,78999,-439,68,759,691,-415,417,-832,-92
"28580",NA,12087,"Monroe County, FL","County or equivalent",2001,78999,-439,68,759,691,-415,417,-832,-92
"28620",NA,NA,"Kill Devil Hills, NC","Micropolitan Statistical Area",2001,30924,731,94,337,243,652,40,612,-15
"28620",NA,37055,"Dare County, NC","County or equivalent",2001,30924,731,94,337,243,652,40,612,-15
"28780",NA,NA,"Kingsville, TX","Micropolitan Statistical Area",2001,31545,-379,255,516,261,-617,63,-680,-17
"28780",NA,48261,"Kenedy County, TX","County or equivalent",2001,416,-3,4,7,3,-7,2,-9,0
"28780",NA,48273,"Kleberg County, TX","County or equivalent",2001,31129,-376,251,509,258,-610,61,-671,-17
"28820",NA,NA,"Kinston, NC","Micropolitan Statistical Area",2001,58978,-515,127,834,707,-602,81,-683,-40
"28820",NA,37107,"Lenoir County, NC","County or equivalent",2001,58978,-515,127,834,707,-602,81,-683,-40
"28860",NA,NA,"Kirksville, MO","Micropolitan Statistical Area",2001,29058,-71,53,341,288,-95,31,-126,-29
"28860",NA,29001,"Adair County, MO","County or equivalent",2001,24915,-45,52,290,238,-73,29,-102,-24
"28860",NA,29197,"Schuyler County, MO","County or equivalent",2001,4143,-26,1,51,50,-22,2,-24,-5
"28900",NA,NA,"Klamath Falls, OR","Micropolitan Statistical Area",2001,64102,217,171,828,657,113,71,42,-67
"28900",NA,41035,"Klamath County, OR","County or equivalent",2001,64102,217,171,828,657,113,71,42,-67
"28980",NA,NA,"Kodiak, AK","Micropolitan Statistical Area",2001,13693,-262,182,232,50,-440,83,-523,-4
"28980",NA,2150,"Kodiak Island Borough, AK","County or equivalent",2001,13693,-262,182,232,50,-440,83,-523,-4
"29060",NA,NA,"Laconia, NH","Micropolitan Statistical Area",2001,57844,1262,55,587,532,1240,44,1196,-33
"29060",NA,33001,"Belknap County, NH","County or equivalent",2001,57844,1262,55,587,532,1240,44,1196,-33
"29220",NA,NA,"La Follette, TN","Micropolitan Statistical Area",2001,39807,-56,55,493,438,-69,28,-97,-42
"29220",NA,47013,"Campbell County, TN","County or equivalent",2001,39807,-56,55,493,438,-69,28,-97,-42
"29260",NA,NA,"La Grande, OR","Micropolitan Statistical Area",2001,24347,-199,32,283,251,-213,32,-245,-18
"29260",NA,41061,"Union County, OR","County or equivalent",2001,24347,-199,32,283,251,-213,32,-245,-18
"29300",NA,NA,"LaGrange, GA","Micropolitan Statistical Area",2001,59633,710,245,913,668,514,79,435,-49
"29300",NA,13285,"Troup County, GA","County or equivalent",2001,59633,710,245,913,668,514,79,435,-49
"29380",NA,NA,"Lake City, FL","Micropolitan Statistical Area",2001,57316,587,126,742,616,517,38,479,-56
"29380",NA,12023,"Columbia County, FL","County or equivalent",2001,57316,587,126,742,616,517,38,479,-56
"29500",NA,NA,"Lamesa, TX","Micropolitan Statistical Area",2001,14857,-85,68,219,151,-142,30,-172,-11
"29500",NA,48115,"Dawson County, TX","County or equivalent",2001,14857,-85,68,219,151,-142,30,-172,-11
"29580",NA,NA,"Lancaster, SC","Micropolitan Statistical Area",2001,63100,1707,298,886,588,-163,65,-228,1572
"29580",NA,45057,"Lancaster County, SC","County or equivalent",2001,63100,1707,298,886,588,-163,65,-228,1572
"29660",NA,NA,"Laramie, WY","Micropolitan Statistical Area",2001,32201,288,207,397,190,113,66,47,-32
"29660",NA,56001,"Albany County, WY","County or equivalent",2001,32201,288,207,397,190,113,66,47,-32
"29780",NA,NA,"Las Vegas, NM","Micropolitan Statistical Area",2001,29699,-373,100,385,285,-450,11,-461,-23
"29780",NA,35047,"San Miguel County, NM","County or equivalent",2001,29699,-373,100,385,285,-450,11,-461,-23
"29860",NA,NA,"Laurel, MS","Micropolitan Statistical Area",2001,83156,37,460,1382,922,-353,163,-516,-70
"29860",NA,28061,"Jasper County, MS","County or equivalent",2001,18319,188,97,304,207,108,5,103,-17
"29860",NA,28067,"Jones County, MS","County or equivalent",2001,64837,-151,363,1078,715,-461,158,-619,-53
"29900",NA,NA,"Laurinburg, NC","Micropolitan Statistical Area",2001,35933,-77,92,480,388,-137,23,-160,-32
"29900",NA,37165,"Scotland County, NC","County or equivalent",2001,35933,-77,92,480,388,-137,23,-160,-32
"29980",NA,NA,"Lawrenceburg, TN","Micropolitan Statistical Area",2001,39994,32,234,633,399,-164,14,-178,-38
"29980",NA,47099,"Lawrence County, TN","County or equivalent",2001,39994,32,234,633,399,-164,14,-178,-38
"30060",NA,NA,"Lebanon, MO","Micropolitan Statistical Area",2001,32886,297,139,459,320,188,7,181,-30
"30060",NA,29105,"Laclede County, MO","County or equivalent",2001,32886,297,139,459,320,188,7,181,-30
"30100",NA,NA,"Lebanon, NH-VT","Micropolitan Statistical Area",2001,168025,440,189,1570,1381,415,156,259,-164
"30100",NA,33009,"Grafton County, NH","County or equivalent",2001,81887,91,79,757,678,94,110,-16,-82
"30100",NA,50017,"Orange County, VT","County or equivalent",2001,28625,319,79,275,196,264,8,256,-24
"30100",NA,50027,"Windsor County, VT","County or equivalent",2001,57513,30,31,538,507,57,38,19,-58
"30220",NA,NA,"Levelland, TX","Micropolitan Statistical Area",2001,22567,-88,162,341,179,-226,29,-255,-24
"30220",NA,48219,"Hockley County, TX","County or equivalent",2001,22567,-88,162,341,179,-226,29,-255,-24
"30260",NA,NA,"Lewisburg, PA","Micropolitan Statistical Area",2001,41953,305,37,383,346,309,18,291,-41
"30260",NA,42119,"Union County, PA","County or equivalent",2001,41953,305,37,383,346,309,18,291,-41
"30280",NA,NA,"Lewisburg, TN","Micropolitan Statistical Area",2001,27124,247,98,358,260,175,43,132,-26
"30280",NA,47117,"Marshall County, TN","County or equivalent",2001,27124,247,98,358,260,175,43,132,-26
"30380",NA,NA,"Lewistown, PA","Micropolitan Statistical Area",2001,46476,-15,35,599,564,-3,5,-8,-47
"30380",NA,42087,"Mifflin County, PA","County or equivalent",2001,46476,-15,35,599,564,-3,5,-8,-47
"30420",NA,NA,"Lexington, NE","Micropolitan Statistical Area",2001,26456,-71,218,475,257,-273,208,-481,-16
"30420",NA,31047,"Dawson County, NE","County or equivalent",2001,24383,-3,222,448,226,-209,207,-416,-16
"30420",NA,31073,"Gosper County, NE","County or equivalent",2001,2073,-68,-4,27,31,-64,1,-65,0
"30500",NA,NA,"Lexington Park, MD","Micropolitan Statistical Area",2001,87451,931,635,1230,595,382,34,348,-86
"30500",NA,24037,"St. Mary's County, MD","County or equivalent",2001,87451,931,635,1230,595,382,34,348,-86
"30580",NA,NA,"Liberal, KS","Micropolitan Statistical Area",2001,22519,-14,394,535,141,-403,369,-772,-5
"30580",NA,20175,"Seward County, KS","County or equivalent",2001,22519,-14,394,535,141,-403,369,-772,-5
"30660",NA,NA,"Lincoln, IL","Micropolitan Statistical Area",2001,30880,-269,0,333,333,-246,7,-253,-23
"30660",NA,17107,"Logan County, IL","County or equivalent",2001,30880,-269,0,333,333,-246,7,-253,-23
"30740",NA,NA,"Lincolnton, NC","Micropolitan Statistical Area",2001,65125,1036,336,904,568,760,284,476,-60
"30740",NA,37109,"Lincoln County, NC","County or equivalent",2001,65125,1036,336,904,568,760,284,476,-60
"30820",NA,NA,"Lock Haven, PA","Micropolitan Statistical Area",2001,37712,-205,3,440,437,-174,14,-188,-34
"30820",NA,42035,"Clinton County, PA","County or equivalent",2001,37712,-205,3,440,437,-174,14,-188,-34
"30900",NA,NA,"Logansport, IN","Micropolitan Statistical Area",2001,40907,-52,151,585,434,-163,98,-261,-40
"30900",NA,18017,"Cass County, IN","County or equivalent",2001,40907,-52,151,585,434,-163,98,-261,-40
"30940",NA,NA,"London, KY","Micropolitan Statistical Area",2001,53537,614,298,822,524,364,29,335,-48
"30940",NA,21125,"Laurel County, KY","County or equivalent",2001,53537,614,298,822,524,364,29,335,-48
"31060",NA,NA,"Los Alamos, NM","Micropolitan Statistical Area",2001,17650,-622,56,200,144,-678,65,-743,0
"31060",NA,35028,"Los Alamos County, NM","County or equivalent",2001,17650,-622,56,200,144,-678,65,-743,0
"31260",NA,NA,"Lufkin, TX","Micropolitan Statistical Area",2001,79950,-279,417,1261,844,-624,181,-805,-72
"31260",NA,48005,"Angelina County, TX","County or equivalent",2001,79950,-279,417,1261,844,-624,181,-805,-72
"31300",NA,NA,"Lumberton, NC","Micropolitan Statistical Area",2001,123562,216,918,2081,1163,-609,488,-1097,-93
"31300",NA,37155,"Robeson County, NC","County or equivalent",2001,123562,216,918,2081,1163,-609,488,-1097,-93
"31380",NA,NA,"Macomb, IL","Micropolitan Statistical Area",2001,32791,-61,5,312,307,-36,73,-109,-30
"31380",NA,17109,"McDonough County, IL","County or equivalent",2001,32791,-61,5,312,307,-36,73,-109,-30
"31500",NA,NA,"Madison, IN","Micropolitan Statistical Area",2001,31936,208,75,388,313,160,11,149,-27
"31500",NA,18077,"Jefferson County, IN","County or equivalent",2001,31936,208,75,388,313,160,11,149,-27
"31580",NA,NA,"Madisonville, KY","Micropolitan Statistical Area",2001,46074,-384,40,588,548,-390,12,-402,-34
"31580",NA,21107,"Hopkins County, KY","County or equivalent",2001,46074,-384,40,588,548,-390,12,-402,-34
"31620",NA,NA,"Magnolia, AR","Micropolitan Statistical Area",2001,25314,-252,10,300,290,-244,15,-259,-18
"31620",NA,5027,"Columbia County, AR","County or equivalent",2001,25314,-252,10,300,290,-244,15,-259,-18
"31660",NA,NA,"Malone, NY","Micropolitan Statistical Area",2001,50789,-259,1,452,451,-210,9,-219,-50
"31660",NA,36033,"Franklin County, NY","County or equivalent",2001,50789,-259,1,452,451,-210,9,-219,-50
"31740",NA,NA,"Manhattan, KS","Micropolitan Statistical Area",2001,109586,549,1080,1767,687,-1919,236,-2155,1388
"31740",NA,20061,"Geary County, KS","County or equivalent",2001,27986,303,351,555,204,-781,30,-811,733
"31740",NA,20149,"Pottawatomie County, KS","County or equivalent",2001,18273,-4,91,253,162,-77,0,-77,-18
"31740",NA,20161,"Riley County, KS","County or equivalent",2001,63327,250,638,959,321,-1061,206,-1267,673
"31820",NA,NA,"Manitowoc, WI","Micropolitan Statistical Area",2001,82643,-282,64,886,822,-270,97,-367,-76
"31820",NA,55071,"Manitowoc County, WI","County or equivalent",2001,82643,-282,64,886,822,-270,97,-367,-76
"31860",NA,NA,"Mankato-North Mankato, MN","Micropolitan Statistical Area",2001,86672,824,428,1032,604,479,126,353,-83
"31860",NA,27013,"Blue Earth County, MN","County or equivalent",2001,56501,553,216,644,428,390,88,302,-53
"31860",NA,27103,"Nicollet County, MN","County or equivalent",2001,30171,271,212,388,176,89,38,51,-30
"31940",NA,NA,"Marinette, WI-MI","Micropolitan Statistical Area",2001,68372,-351,-107,717,824,-185,21,-206,-59
"31940",NA,26109,"Menominee County, MI","County or equivalent",2001,25155,-131,-27,276,303,-82,8,-90,-22
"31940",NA,55075,"Marinette County, WI","County or equivalent",2001,43217,-220,-80,441,521,-103,13,-116,-37
"31980",NA,NA,"Marion, IN","Micropolitan Statistical Area",2001,72739,-551,70,884,814,-566,18,-584,-55
"31980",NA,18053,"Grant County, IN","County or equivalent",2001,72739,-551,70,884,814,-566,18,-584,-55
"32020",NA,NA,"Marion, OH","Micropolitan Statistical Area",2001,66005,-145,212,844,632,-298,18,-316,-59
"32020",NA,39101,"Marion County, OH","County or equivalent",2001,66005,-145,212,844,632,-298,18,-316,-59
"32060",NA,NA,"Marion-Herrin, IL","Micropolitan Statistical Area",2001,61737,471,-2,734,736,510,14,496,-37
"32060",NA,17199,"Williamson County, IL","County or equivalent",2001,61737,471,-2,734,736,510,14,496,-37
"32100",NA,NA,"Marquette, MI","Micropolitan Statistical Area",2001,64624,19,-17,609,626,102,21,81,-66
"32100",NA,26103,"Marquette County, MI","County or equivalent",2001,64624,19,-17,609,626,102,21,81,-66
"32140",NA,NA,"Marshall, MN","Micropolitan Statistical Area",2001,25368,-69,128,363,235,-179,65,-244,-18
"32140",NA,27083,"Lyon County, MN","County or equivalent",2001,25368,-69,128,363,235,-179,65,-244,-18
"32180",NA,NA,"Marshall, MO","Micropolitan Statistical Area",2001,23403,-343,-28,283,311,-300,46,-346,-15
"32180",NA,29195,"Saline County, MO","County or equivalent",2001,23403,-343,-28,283,311,-300,46,-346,-15
"32220",NA,NA,"Marshall, TX","Micropolitan Statistical Area",2001,62274,220,122,781,659,162,96,66,-64
"32220",NA,48203,"Harrison County, TX","County or equivalent",2001,62274,220,122,781,659,162,96,66,-64
"32260",NA,NA,"Marshalltown, IA","Micropolitan Statistical Area",2001,39263,-50,39,556,517,-52,142,-194,-37
"32260",NA,19127,"Marshall County, IA","County or equivalent",2001,39263,-50,39,556,517,-52,142,-194,-37
"32270",NA,NA,"Marshfield-Wisconsin Rapids, WI","Micropolitan Statistical Area",2001,75348,-205,162,876,714,-299,70,-369,-68
"32270",NA,55141,"Wood County, WI","County or equivalent",2001,75348,-205,162,876,714,-299,70,-369,-68
"32280",NA,NA,"Martin, TN","Micropolitan Statistical Area",2001,34345,-550,47,407,360,-575,44,-619,-22
"32280",NA,47183,"Weakley County, TN","County or equivalent",2001,34345,-550,47,407,360,-575,44,-619,-22
"32300",NA,NA,"Martinsville, VA","Micropolitan Statistical Area",2001,72728,-546,-6,819,825,-466,203,-669,-74
"32300",NA,51089,"Henry County, VA","County or equivalent",2001,57451,-468,88,611,523,-501,161,-662,-55
"32300",NA,51690,"Martinsville city, VA","County or equivalent",2001,15277,-78,-94,208,302,35,42,-7,-19
"32340",NA,NA,"Maryville, MO","Micropolitan Statistical Area",2001,21938,63,44,231,187,40,20,20,-21
"32340",NA,29147,"Nodaway County, MO","County or equivalent",2001,21938,63,44,231,187,40,20,20,-21
"32380",NA,NA,"Mason City, IA","Micropolitan Statistical Area",2001,53543,-709,-71,578,649,-597,28,-625,-41
"32380",NA,19033,"Cerro Gordo County, IA","County or equivalent",2001,45741,-610,-39,504,543,-537,24,-561,-34
"32380",NA,19195,"Worth County, IA","County or equivalent",2001,7802,-99,-32,74,106,-60,4,-64,-7
"32460",NA,NA,"Mayfield, KY","Micropolitan Statistical Area",2001,36981,-103,46,505,459,-117,70,-187,-32
"32460",NA,21083,"Graves County, KY","County or equivalent",2001,36981,-103,46,505,459,-117,70,-187,-32
"32500",NA,NA,"Maysville, KY","Micropolitan Statistical Area",2001,30782,-127,68,403,335,-167,16,-183,-28
"32500",NA,21135,"Lewis County, KY","County or equivalent",2001,13986,-138,46,184,138,-173,2,-175,-11
"32500",NA,21161,"Mason County, KY","County or equivalent",2001,16796,11,22,219,197,6,14,-8,-17
"32540",NA,NA,"McAlester, OK","Micropolitan Statistical Area",2001,43356,-595,-95,491,586,-467,19,-486,-33
"32540",NA,40121,"Pittsburg County, OK","County or equivalent",2001,43356,-595,-95,491,586,-467,19,-486,-33
"32620",NA,NA,"McComb, MS","Micropolitan Statistical Area",2001,52211,-349,209,823,614,-522,4,-526,-36
"32620",NA,28005,"Amite County, MS","County or equivalent",2001,13511,-67,28,182,154,-85,0,-85,-10
"32620",NA,28113,"Pike County, MS","County or equivalent",2001,38700,-282,181,641,460,-437,4,-441,-26
"32660",NA,NA,"McMinnville, TN","Micropolitan Statistical Area",2001,38651,255,161,541,380,134,118,16,-40
"32660",NA,47177,"Warren County, TN","County or equivalent",2001,38651,255,161,541,380,134,118,16,-40
"32700",NA,NA,"McPherson, KS","Micropolitan Statistical Area",2001,29483,-88,2,372,370,-60,4,-64,-30
"32700",NA,20113,"McPherson County, KS","County or equivalent",2001,29483,-88,2,372,370,-60,4,-64,-30
"32740",NA,NA,"Meadville, PA","Micropolitan Statistical Area",2001,90106,-233,149,1092,943,-300,11,-311,-82
"32740",NA,42039,"Crawford County, PA","County or equivalent",2001,90106,-233,149,1092,943,-300,11,-311,-82
"32860",NA,NA,"Menomonie, WI","Micropolitan Statistical Area",2001,40536,583,196,460,264,419,36,383,-32
"32860",NA,55033,"Dunn County, WI","County or equivalent",2001,40536,583,196,460,264,419,36,383,-32
"32940",NA,NA,"Meridian, MS","Micropolitan Statistical Area",2001,105915,-544,271,1553,1282,-732,3,-735,-83
"32940",NA,28023,"Clarke County, MS","County or equivalent",2001,17812,-140,41,247,206,-168,0,-168,-13
"32940",NA,28069,"Kemper County, MS","County or equivalent",2001,10592,166,52,152,100,122,2,120,-8
"32940",NA,28075,"Lauderdale County, MS","County or equivalent",2001,77511,-570,178,1154,976,-686,1,-687,-62
"32980",NA,NA,"Merrill, WI","Micropolitan Statistical Area",2001,29645,-57,-7,322,329,-23,19,-42,-27
"32980",NA,55069,"Lincoln County, WI","County or equivalent",2001,29645,-57,-7,322,329,-23,19,-42,-27
"33020",NA,NA,"Mexico, MO","Micropolitan Statistical Area",2001,25723,-85,126,410,284,-191,1,-192,-20
"33020",NA,29007,"Audrain County, MO","County or equivalent",2001,25723,-85,126,410,284,-191,1,-192,-20
"33060",NA,NA,"Miami, OK","Micropolitan Statistical Area",2001,33037,-200,-1,431,432,-172,21,-193,-27
"33060",NA,40115,"Ottawa County, OK","County or equivalent",2001,33037,-200,-1,431,432,-172,21,-193,-27
"33180",NA,NA,"Middlesborough, KY","Micropolitan Statistical Area",2001,29621,-422,-8,365,373,-391,15,-406,-23
"33180",NA,21013,"Bell County, KY","County or equivalent",2001,29621,-422,-8,365,373,-391,15,-406,-23
"33220",NA,NA,"Midland, MI","Micropolitan Statistical Area",2001,83516,516,417,1054,637,183,147,36,-84
"33220",NA,26111,"Midland County, MI","County or equivalent",2001,83516,516,417,1054,637,183,147,36,-84
"33300",NA,NA,"Milledgeville, GA","Micropolitan Statistical Area",2001,54643,-151,156,663,507,-257,22,-279,-50
"33300",NA,13009,"Baldwin County, GA","County or equivalent",2001,44665,-81,111,523,412,-153,22,-175,-39
"33300",NA,13141,"Hancock County, GA","County or equivalent",2001,9978,-70,45,140,95,-104,0,-104,-11
"33380",NA,NA,"Minden, LA","Micropolitan Statistical Area",2001,41314,-396,5,564,559,-368,8,-376,-33
"33380",NA,22119,"Webster Parish, LA","County or equivalent",2001,41314,-396,5,564,559,-368,8,-376,-33
"33420",NA,NA,"Mineral Wells, TX","Micropolitan Statistical Area",2001,27082,-1,-5,384,389,34,47,-13,-30
"33420",NA,48363,"Palo Pinto County, TX","County or equivalent",2001,27082,-1,-5,384,389,34,47,-13,-30
"33500",NA,NA,"Minot, ND","Micropolitan Statistical Area",2001,66093,-1133,322,895,573,-1424,-12,-1412,-31
"33500",NA,38049,"McHenry County, ND","County or equivalent",2001,5818,-132,7,67,60,-134,-1,-133,-5
"33500",NA,38075,"Renville County, ND","County or equivalent",2001,2521,-70,-18,14,32,-50,-1,-49,-2
"33500",NA,38101,"Ward County, ND","County or equivalent",2001,57754,-931,333,814,481,-1240,-10,-1230,-24
"33580",NA,NA,"Mitchell, SD","Micropolitan Statistical Area",2001,22074,192,146,337,191,66,14,52,-20
"33580",NA,46035,"Davison County, SD","County or equivalent",2001,18784,56,91,265,174,-17,12,-29,-18
"33580",NA,46061,"Hanson County, SD","County or equivalent",2001,3290,136,55,72,17,83,2,81,-2
"33620",NA,NA,"Moberly, MO","Micropolitan Statistical Area",2001,24693,21,44,357,313,3,20,-17,-26
"33620",NA,29175,"Randolph County, MO","County or equivalent",2001,24693,21,44,357,313,3,20,-17,-26
"33820",NA,NA,"Monroe, WI","Micropolitan Statistical Area",2001,33836,113,60,406,346,85,14,71,-32
"33820",NA,55045,"Green County, WI","County or equivalent",2001,33836,113,60,406,346,85,14,71,-32
"33940",NA,NA,"Montrose, CO","Micropolitan Statistical Area",2001,34338,740,149,463,314,621,58,563,-30
"33940",NA,8085,"Montrose County, CO","County or equivalent",2001,34338,740,149,463,314,621,58,563,-30
"33980",NA,NA,"Morehead City, NC","Micropolitan Statistical Area",2001,59737,333,-48,630,678,349,30,319,32
"33980",NA,37031,"Carteret County, NC","County or equivalent",2001,59737,333,-48,630,678,349,30,319,32
"34020",NA,NA,"Morgan City, LA","Micropolitan Statistical Area",2001,52526,-732,315,798,483,-1021,32,-1053,-26
"34020",NA,22101,"St. Mary Parish, LA","County or equivalent",2001,52526,-732,315,798,483,-1021,32,-1053,-26
"34140",NA,NA,"Moscow, ID","Micropolitan Statistical Area",2001,35318,432,212,411,199,252,75,177,-32
"34140",NA,16057,"Latah County, ID","County or equivalent",2001,35318,432,212,411,199,252,75,177,-32
"34180",NA,NA,"Moses Lake, WA","Micropolitan Statistical Area",2001,76141,1175,887,1396,509,354,728,-374,-66
"34180",NA,53025,"Grant County, WA","County or equivalent",2001,76141,1175,887,1396,509,354,728,-374,-66
"34220",NA,NA,"Moultrie, GA","Micropolitan Statistical Area",2001,42271,147,241,700,459,-58,232,-290,-36
"34220",NA,13071,"Colquitt County, GA","County or equivalent",2001,42271,147,241,700,459,-58,232,-290,-36
"34260",NA,NA,"Mountain Home, AR","Micropolitan Statistical Area",2001,38418,-47,-288,344,632,269,4,265,-28
"34260",NA,5005,"Baxter County, AR","County or equivalent",2001,38418,-47,-288,344,632,269,4,265,-28
"34300",NA,NA,"Mountain Home, ID","Micropolitan Statistical Area",2001,29189,97,359,524,165,-239,51,-290,-23
"34300",NA,16039,"Elmore County, ID","County or equivalent",2001,29189,97,359,524,165,-239,51,-290,-23
"34340",NA,NA,"Mount Airy, NC","Micropolitan Statistical Area",2001,71652,366,213,941,728,224,224,0,-71
"34340",NA,37171,"Surry County, NC","County or equivalent",2001,71652,366,213,941,728,224,224,0,-71
"34380",NA,NA,"Mount Pleasant, MI","Micropolitan Statistical Area",2001,63875,454,262,681,419,253,105,148,-61
"34380",NA,26073,"Isabella County, MI","County or equivalent",2001,63875,454,262,681,419,253,105,148,-61
"34420",NA,NA,"Mount Pleasant, TX","Micropolitan Statistical Area",2001,27932,-170,256,542,286,-408,245,-653,-18
"34420",NA,48449,"Titus County, TX","County or equivalent",2001,27932,-170,256,542,286,-408,245,-653,-18
"34460",NA,NA,"Mount Sterling, KY","Micropolitan Statistical Area",2001,40794,408,134,571,437,307,4,303,-33
"34460",NA,21011,"Bath County, KY","County or equivalent",2001,11287,159,29,166,137,138,-1,139,-8
"34460",NA,21165,"Menifee County, KY","County or equivalent",2001,6692,97,21,77,56,80,1,79,-4
"34460",NA,21173,"Montgomery County, KY","County or equivalent",2001,22815,152,84,328,244,89,4,85,-21
"34500",NA,NA,"Mount Vernon, IL","Micropolitan Statistical Area",2001,48506,-154,32,568,536,-140,12,-152,-46
"34500",NA,17065,"Hamilton County, IL","County or equivalent",2001,8492,-112,-11,99,110,-92,1,-93,-9
"34500",NA,17081,"Jefferson County, IL","County or equivalent",2001,40014,-42,43,469,426,-48,11,-59,-37
"34540",NA,NA,"Mount Vernon, OH","Micropolitan Statistical Area",2001,55370,727,182,708,526,591,11,580,-46
"34540",NA,39083,"Knox County, OH","County or equivalent",2001,55370,727,182,708,526,591,11,580,-46
"34660",NA,NA,"Murray, KY","Micropolitan Statistical Area",2001,34393,219,-22,353,375,270,71,199,-29
"34660",NA,21035,"Calloway County, KY","County or equivalent",2001,34393,219,-22,353,375,270,71,199,-29
"34700",NA,NA,"Muscatine, IA","Micropolitan Statistical Area",2001,53953,-11,348,815,467,-316,115,-431,-43
"34700",NA,19115,"Louisa County, IA","County or equivalent",2001,12167,-1,57,175,118,-47,35,-82,-11
"34700",NA,19139,"Muscatine County, IA","County or equivalent",2001,41786,-10,291,640,349,-269,80,-349,-32
"34780",NA,NA,"Muskogee, OK","Micropolitan Statistical Area",2001,69494,83,176,952,776,-27,72,-99,-66
"34780",NA,40101,"Muskogee County, OK","County or equivalent",2001,69494,83,176,952,776,-27,72,-99,-66
"34860",NA,NA,"Nacogdoches, TX","Micropolitan Statistical Area",2001,59641,395,327,874,547,127,206,-79,-59
"34860",NA,48347,"Nacogdoches County, TX","County or equivalent",2001,59641,395,327,874,547,127,206,-79,-59
"35020",NA,NA,"Natchez, MS-LA","Micropolitan Statistical Area",2001,53677,-749,94,747,653,-802,8,-810,-41
"35020",NA,22029,"Concordia Parish, LA","County or equivalent",2001,19931,-281,61,280,219,-325,0,-325,-17
"35020",NA,28001,"Adams County, MS","County or equivalent",2001,33746,-468,33,467,434,-477,8,-485,-24
"35060",NA,NA,"Natchitoches, LA","Micropolitan Statistical Area",2001,38782,-315,253,634,381,-544,32,-576,-24
"35060",NA,22069,"Natchitoches Parish, LA","County or equivalent",2001,38782,-315,253,634,381,-544,32,-576,-24
"35100",NA,NA,"New Bern, NC","Micropolitan Statistical Area",2001,116139,1177,739,1857,1118,-139,18,-157,577
"35100",NA,37049,"Craven County, NC","County or equivalent",2001,93070,1419,814,1668,854,4,4,0,601
"35100",NA,37103,"Jones County, NC","County or equivalent",2001,10284,-92,-33,88,121,-45,8,-53,-14
"35100",NA,37137,"Pamlico County, NC","County or equivalent",2001,12785,-150,-42,101,143,-98,6,-104,-10
"35140",NA,NA,"Newberry, SC","Micropolitan Statistical Area",2001,36253,222,152,537,385,104,124,-20,-34
"35140",NA,45071,"Newberry County, SC","County or equivalent",2001,36253,222,152,537,385,104,124,-20,-34
"35220",NA,NA,"New Castle, IN","Micropolitan Statistical Area",2001,48236,-211,34,604,570,-201,4,-205,-44
"35220",NA,18065,"Henry County, IN","County or equivalent",2001,48236,-211,34,604,570,-201,4,-205,-44
"35260",NA,NA,"New Castle, PA","Micropolitan Statistical Area",2001,94024,-598,-211,1026,1237,-303,20,-323,-84
"35260",NA,42073,"Lawrence County, PA","County or equivalent",2001,94024,-598,-211,1026,1237,-303,20,-323,-84
"35340",NA,NA,"New Iberia, LA","Micropolitan Statistical Area",2001,73270,37,501,1167,666,-403,37,-440,-61
"35340",NA,22045,"Iberia Parish, LA","County or equivalent",2001,73270,37,501,1167,666,-403,37,-440,-61
"35420",NA,NA,"New Philadelphia-Dover, OH","Micropolitan Statistical Area",2001,91138,109,313,1204,891,-118,32,-150,-86
"35420",NA,39157,"Tuscarawas County, OH","County or equivalent",2001,91138,109,313,1204,891,-118,32,-150,-86
"35460",NA,NA,"Newport, TN","Micropolitan Statistical Area",2001,33667,40,-22,405,427,95,7,88,-33
"35460",NA,47029,"Cocke County, TN","County or equivalent",2001,33667,40,-22,405,427,95,7,88,-33
"35500",NA,NA,"Newton, IA","Micropolitan Statistical Area",2001,37269,54,108,483,375,-16,26,-42,-38
"35500",NA,19099,"Jasper County, IA","County or equivalent",2001,37269,54,108,483,375,-16,26,-42,-38
"35580",NA,NA,"New Ulm, MN","Micropolitan Statistical Area",2001,26896,20,43,294,251,3,6,-3,-26
"35580",NA,27015,"Brown County, MN","County or equivalent",2001,26896,20,43,294,251,3,6,-3,-26
"35700",NA,NA,"Nogales, AZ","Micropolitan Statistical Area",2001,38874,352,529,747,218,-146,283,-429,-31
"35700",NA,4023,"Santa Cruz County, AZ","County or equivalent",2001,38874,352,529,747,218,-146,283,-429,-31
"35740",NA,NA,"Norfolk, NE","Micropolitan Statistical Area",2001,49660,216,232,688,456,30,88,-58,-46
"35740",NA,31119,"Madison County, NE","County or equivalent",2001,35529,346,237,545,308,144,78,66,-35
"35740",NA,31139,"Pierce County, NE","County or equivalent",2001,7735,-102,-21,73,94,-75,2,-77,-6
"35740",NA,31167,"Stanton County, NE","County or equivalent",2001,6396,-28,16,70,54,-39,8,-47,-5
"35820",NA,NA,"North Platte, NE","Micropolitan Statistical Area",2001,35884,-55,173,513,340,-199,22,-221,-29
"35820",NA,31111,"Lincoln County, NE","County or equivalent",2001,34577,-58,168,497,329,-198,20,-218,-28
"35820",NA,31113,"Logan County, NE","County or equivalent",2001,779,6,2,12,10,4,1,3,0
"35820",NA,31117,"McPherson County, NE","County or equivalent",2001,528,-3,3,4,1,-5,1,-6,-1
"35860",NA,NA,"North Vernon, IN","Micropolitan Statistical Area",2001,27873,181,169,405,236,39,7,32,-27
"35860",NA,18079,"Jennings County, IN","County or equivalent",2001,27873,181,169,405,236,39,7,32,-27
"35900",NA,NA,"North Wilkesboro, NC","Micropolitan Statistical Area",2001,66329,552,268,932,664,348,178,170,-64
"35900",NA,37193,"Wilkes County, NC","County or equivalent",2001,66329,552,268,932,664,348,178,170,-64
"35940",NA,NA,"Norwalk, OH","Micropolitan Statistical Area",2001,59562,-15,370,892,522,-335,57,-392,-50
"35940",NA,39077,"Huron County, OH","County or equivalent",2001,59562,-15,370,892,522,-335,57,-392,-50
"36020",NA,NA,"Oak Harbor, WA","Micropolitan Statistical Area",2001,74143,2296,377,931,554,1940,11,1929,-21
"36020",NA,53029,"Island County, WA","County or equivalent",2001,74143,2296,377,931,554,1940,11,1929,-21
"36060",NA,NA,"Oak Hill, WV","Micropolitan Statistical Area",2001,47098,-400,-90,566,656,-272,19,-291,-38
"36060",NA,54019,"Fayette County, WV","County or equivalent",2001,47098,-400,-90,566,656,-272,19,-291,-38
"36180",NA,NA,"Ocean Pines, MD","Micropolitan Statistical Area",2001,47590,814,-37,529,566,882,58,824,-31
"36180",NA,24047,"Worcester County, MD","County or equivalent",2001,47590,814,-37,529,566,882,58,824,-31
"36300",NA,NA,"Ogdensburg-Massena, NY","Micropolitan Statistical Area",2001,111192,-675,203,1240,1037,-791,84,-875,-87
"36300",NA,36089,"St. Lawrence County, NY","County or equivalent",2001,111192,-675,203,1240,1037,-791,84,-875,-87
"36340",NA,NA,"Oil City, PA","Micropolitan Statistical Area",2001,57052,-417,-34,615,649,-332,4,-336,-51
"36340",NA,42121,"Venango County, PA","County or equivalent",2001,57052,-417,-34,615,649,-332,4,-336,-51
"36380",NA,NA,"Okeechobee, FL","Micropolitan Statistical Area",2001,36294,381,201,562,361,217,209,8,-37
"36380",NA,12093,"Okeechobee County, FL","County or equivalent",2001,36294,381,201,562,361,217,209,8,-37
"36460",NA,NA,"Olean, NY","Micropolitan Statistical Area",2001,83300,-716,187,1004,817,-834,15,-849,-69
"36460",NA,36009,"Cattaraugus County, NY","County or equivalent",2001,83300,-716,187,1004,817,-834,15,-849,-69
"36580",NA,NA,"Oneonta, NY","Micropolitan Statistical Area",2001,61683,12,-12,533,545,81,19,62,-57
"36580",NA,36077,"Otsego County, NY","County or equivalent",2001,61683,12,-12,533,545,81,19,62,-57
"36620",NA,NA,"Ontario, OR-ID","Micropolitan Statistical Area",2001,52323,169,392,845,453,-183,137,-320,-40
"36620",NA,16075,"Payette County, ID","County or equivalent",2001,20849,215,141,328,187,93,23,70,-19
"36620",NA,41045,"Malheur County, OR","County or equivalent",2001,31474,-46,251,517,266,-276,114,-390,-21
"36660",NA,NA,"Opelousas-Eunice, LA","Micropolitan Statistical Area",2001,87610,-103,453,1358,905,-477,13,-490,-79
"36660",NA,22097,"St. Landry Parish, LA","County or equivalent",2001,87610,-103,453,1358,905,-477,13,-490,-79
"36700",NA,NA,"Orangeburg, SC","Micropolitan Statistical Area",2001,91260,-228,392,1329,937,-541,38,-579,-79
"36700",NA,45075,"Orangeburg County, SC","County or equivalent",2001,91260,-228,392,1329,937,-541,38,-579,-79
"36820",NA,NA,"Oskaloosa, IA","Micropolitan Statistical Area",2001,22377,73,74,294,220,22,24,-2,-23
"36820",NA,19123,"Mahaska County, IA","County or equivalent",2001,22377,73,74,294,220,22,24,-2,-23
"36860",NA,NA,"Ottawa-Streator, IL","Micropolitan Statistical Area",2001,153102,43,327,2014,1687,-144,119,-263,-140
"36860",NA,17011,"Bureau County, IL","County or equivalent",2001,35170,-303,41,451,410,-318,19,-337,-26
"36860",NA,17099,"LaSalle County, IL","County or equivalent",2001,111869,358,283,1502,1219,182,97,85,-107
"36860",NA,17155,"Putnam County, IL","County or equivalent",2001,6063,-12,3,61,58,-8,3,-11,-7
"36900",NA,NA,"Ottumwa, IA","Micropolitan Statistical Area",2001,35952,-54,25,465,440,-40,34,-74,-39
"36900",NA,19179,"Wapello County, IA","County or equivalent",2001,35952,-54,25,465,440,-40,34,-74,-39
"36940",NA,NA,"Owatonna, MN","Micropolitan Statistical Area",2001,34169,368,217,488,271,182,98,84,-31
"36940",NA,27147,"Steele County, MN","County or equivalent",2001,34169,368,217,488,271,182,98,84,-31
"37020",NA,NA,"Owosso, MI","Micropolitan Statistical Area",2001,71933,226,301,908,607,-3,9,-12,-72
"37020",NA,26155,"Shiawassee County, MI","County or equivalent",2001,71933,226,301,908,607,-3,9,-12,-72
"37060",NA,NA,"Oxford, MS","Micropolitan Statistical Area",2001,39117,355,116,415,299,272,61,211,-33
"37060",NA,28071,"Lafayette County, MS","County or equivalent",2001,39117,355,116,415,299,272,61,211,-33
"37140",NA,NA,"Paducah, KY-IL","Micropolitan Statistical Area",2001,97902,-779,22,1246,1224,-725,21,-746,-76
"37140",NA,17127,"Massac County, IL","County or equivalent",2001,15025,-102,-34,199,233,-56,2,-58,-12
"37140",NA,21007,"Ballard County, KY","County or equivalent",2001,8219,-81,-22,84,106,-51,4,-55,-8
"37140",NA,21139,"Livingston County, KY","County or equivalent",2001,9810,-4,6,108,102,-1,0,-1,-9
"37140",NA,21145,"McCracken County, KY","County or equivalent",2001,64848,-592,72,855,783,-617,15,-632,-47
"37220",NA,NA,"Pahrump, NV","Micropolitan Statistical Area",2001,33868,751,-91,292,383,884,55,829,-42
"37220",NA,32023,"Nye County, NV","County or equivalent",2001,33868,751,-91,292,383,884,55,829,-42
"37260",NA,NA,"Palatka, FL","Micropolitan Statistical Area",2001,70353,-59,8,886,878,13,88,-75,-80
"37260",NA,12107,"Putnam County, FL","County or equivalent",2001,70353,-59,8,886,878,13,88,-75,-80
"37300",NA,NA,"Palestine, TX","Micropolitan Statistical Area",2001,54102,-958,53,648,595,-984,65,-1049,-27
"37300",NA,48001,"Anderson County, TX","County or equivalent",2001,54102,-958,53,648,595,-984,65,-1049,-27
"37420",NA,NA,"Pampa, TX","Micropolitan Statistical Area",2001,22962,-498,-57,244,301,-429,53,-482,-12
"37420",NA,48179,"Gray County, TX","County or equivalent",2001,22090,-487,-55,238,293,-420,52,-472,-12
"37420",NA,48393,"Roberts County, TX","County or equivalent",2001,872,-11,-2,6,8,-9,1,-10,0
"37500",NA,NA,"Paragould, AR","Micropolitan Statistical Area",2001,37807,302,137,542,405,197,10,187,-32
"37500",NA,5055,"Greene County, AR","County or equivalent",2001,37807,302,137,542,405,197,10,187,-32
"37540",NA,NA,"Paris, TN","Micropolitan Statistical Area",2001,31171,51,-62,373,435,143,14,129,-30
"37540",NA,47079,"Henry County, TN","County or equivalent",2001,31171,51,-62,373,435,143,14,129,-30
"37580",NA,NA,"Paris, TX","Micropolitan Statistical Area",2001,48571,-33,81,647,566,-69,74,-143,-45
"37580",NA,48277,"Lamar County, TX","County or equivalent",2001,48571,-33,81,647,566,-69,74,-143,-45
"37660",NA,NA,"Parsons, KS","Micropolitan Statistical Area",2001,22458,-279,-16,281,297,-246,2,-248,-17
"37660",NA,20099,"Labette County, KS","County or equivalent",2001,22458,-279,-16,281,297,-246,2,-248,-17
"37740",NA,NA,"Payson, AZ","Micropolitan Statistical Area",2001,51168,-191,60,684,624,-206,58,-264,-45
"37740",NA,4007,"Gila County, AZ","County or equivalent",2001,51168,-191,60,684,624,-206,58,-264,-45
"37780",NA,NA,"Pecos, TX","Micropolitan Statistical Area",2001,12678,-370,99,205,106,-465,26,-491,-4
"37780",NA,48389,"Reeves County, TX","County or equivalent",2001,12678,-370,99,205,106,-465,26,-491,-4
"37800",NA,NA,"Pella, IA","Micropolitan Statistical Area",2001,32506,404,42,373,331,385,8,377,-23
"37800",NA,19125,"Marion County, IA","County or equivalent",2001,32506,404,42,373,331,385,8,377,-23
"37820",NA,NA,"Pendleton-Hermiston, OR","Micropolitan Statistical Area",2001,81591,-126,579,1236,657,-646,284,-930,-59
"37820",NA,41049,"Morrow County, OR","County or equivalent",2001,11090,71,65,154,89,17,69,-52,-11
"37820",NA,41059,"Umatilla County, OR","County or equivalent",2001,70501,-197,514,1082,568,-663,215,-878,-48
"37940",NA,NA,"Peru, IN","Micropolitan Statistical Area",2001,36338,178,175,498,323,41,4,37,-38
"37940",NA,18103,"Miami County, IN","County or equivalent",2001,36338,178,175,498,323,41,4,37,-38
"38020",NA,NA,"Phoenix Lake-Cedar Ridge, CA","Micropolitan Statistical Area",2001,55158,507,-159,418,577,704,22,682,-38
"38020",NA,6109,"Tuolumne County, CA","County or equivalent",2001,55158,507,-159,418,577,704,22,682,-38
"38100",NA,NA,"Picayune, MS","Micropolitan Statistical Area",2001,49350,585,186,668,482,436,8,428,-37
"38100",NA,28109,"Pearl River County, MS","County or equivalent",2001,49350,585,186,668,482,436,8,428,-37
"38180",NA,NA,"Pierre, SD","Micropolitan Statistical Area",2001,19117,-146,42,224,182,-171,16,-187,-17
"38180",NA,46065,"Hughes County, SD","County or equivalent",2001,16386,-102,36,190,154,-124,14,-138,-14
"38180",NA,46117,"Stanley County, SD","County or equivalent",2001,2731,-44,6,34,28,-47,2,-49,-3
"38200",NA,NA,"Pierre Part, LA","Micropolitan Statistical Area",2001,23174,-205,115,324,209,-304,8,-312,-16
"38200",NA,22007,"Assumption Parish, LA","County or equivalent",2001,23174,-205,115,324,209,-304,8,-312,-16
"38260",NA,NA,"Pittsburg, KS","Micropolitan Statistical Area",2001,38393,158,95,548,453,100,97,3,-37
"38260",NA,20037,"Crawford County, KS","County or equivalent",2001,38393,158,95,548,453,100,97,3,-37
"38380",NA,NA,"Plainview, TX","Micropolitan Statistical Area",2001,35794,-785,333,650,317,-1107,92,-1199,-11
"38380",NA,48189,"Hale County, TX","County or equivalent",2001,35794,-785,333,650,317,-1107,92,-1199,-11
"38420",NA,NA,"Platteville, WI","Micropolitan Statistical Area",2001,49507,-27,39,552,513,-16,16,-32,-50
"38420",NA,55043,"Grant County, WI","County or equivalent",2001,49507,-27,39,552,513,-16,16,-32,-50
"38460",NA,NA,"Plattsburgh, NY","Micropolitan Statistical Area",2001,80244,347,112,774,662,312,56,256,-77
"38460",NA,36019,"Clinton County, NY","County or equivalent",2001,80244,347,112,774,662,312,56,256,-77
"38500",NA,NA,"Plymouth, IN","Micropolitan Statistical Area",2001,45500,256,317,732,415,-19,141,-160,-42
"38500",NA,18099,"Marshall County, IN","County or equivalent",2001,45500,256,317,732,415,-19,141,-160,-42
"38580",NA,NA,"Point Pleasant, WV-OH","Micropolitan Statistical Area",2001,57072,13,74,714,640,-11,3,-14,-50
"38580",NA,39053,"Gallia County, OH","County or equivalent",2001,31036,-58,90,424,334,-120,3,-123,-28
"38580",NA,54053,"Mason County, WV","County or equivalent",2001,26036,71,-16,290,306,109,0,109,-22
"38620",NA,NA,"Ponca City, OK","Micropolitan Statistical Area",2001,47427,-513,71,658,587,-550,53,-603,-34
"38620",NA,40071,"Kay County, OK","County or equivalent",2001,47427,-513,71,658,587,-550,53,-603,-34
"38700",NA,NA,"Pontiac, IL","Micropolitan Statistical Area",2001,39632,-18,174,550,376,-156,16,-172,-36
"38700",NA,17105,"Livingston County, IL","County or equivalent",2001,39632,-18,174,550,376,-156,16,-172,-36
"38740",NA,NA,"Poplar Bluff, MO","Micropolitan Statistical Area",2001,40678,-124,49,557,508,-133,19,-152,-40
"38740",NA,29023,"Butler County, MO","County or equivalent",2001,40678,-124,49,557,508,-133,19,-152,-40
"38780",NA,NA,"Portales, NM","Micropolitan Statistical Area",2001,18292,308,149,286,137,174,22,152,-15
"38780",NA,35041,"Roosevelt County, NM","County or equivalent",2001,18292,308,149,286,137,174,22,152,-15
"38820",NA,NA,"Port Angeles, WA","Micropolitan Statistical Area",2001,64791,505,-87,649,736,650,73,577,-58
"38820",NA,53009,"Clallam County, WA","County or equivalent",2001,64791,505,-87,649,736,650,73,577,-58
"39020",NA,NA,"Portsmouth, OH","Micropolitan Statistical Area",2001,78391,-707,103,1080,977,-746,16,-762,-64
"39020",NA,39145,"Scioto County, OH","County or equivalent",2001,78391,-707,103,1080,977,-746,16,-762,-64
"39060",NA,NA,"Pottsville, PA","Micropolitan Statistical Area",2001,149114,-973,-722,1458,2180,-105,21,-126,-146
"39060",NA,42107,"Schuylkill County, PA","County or equivalent",2001,149114,-973,-722,1458,2180,-105,21,-126,-146
"39220",NA,NA,"Price, UT","Micropolitan Statistical Area",2001,19691,-663,111,290,179,-773,13,-786,-1
"39220",NA,49007,"Carbon County, UT","County or equivalent",2001,19691,-663,111,290,179,-773,13,-786,-1
"39260",NA,NA,"Prineville, OR","Micropolitan Statistical Area",2001,19876,555,27,233,206,540,30,510,-12
"39260",NA,41013,"Crook County, OR","County or equivalent",2001,19876,555,27,233,206,540,30,510,-12
"39420",NA,NA,"Pullman, WA","Micropolitan Statistical Area",2001,40551,-170,175,404,229,-313,236,-549,-32
"39420",NA,53075,"Whitman County, WA","County or equivalent",2001,40551,-170,175,404,229,-313,236,-549,-32
"39500",NA,NA,"Quincy, IL-MO","Micropolitan Statistical Area",2001,78423,-298,-14,928,942,-209,19,-228,-75
"39500",NA,17001,"Adams County, IL","County or equivalent",2001,68044,-176,5,826,821,-115,17,-132,-66
"39500",NA,29111,"Lewis County, MO","County or equivalent",2001,10379,-122,-19,102,121,-94,2,-96,-9
"39700",NA,NA,"Raymondville, TX","Micropolitan Statistical Area",2001,19815,-233,310,413,103,-535,55,-590,-8
"39700",NA,48489,"Willacy County, TX","County or equivalent",2001,19815,-233,310,413,103,-535,55,-590,-8
"39780",NA,NA,"Red Bluff, CA","Micropolitan Statistical Area",2001,56476,341,26,675,649,366,95,271,-51
"39780",NA,6103,"Tehama County, CA","County or equivalent",2001,56476,341,26,675,649,366,95,271,-51
"39860",NA,NA,"Red Wing, MN","Micropolitan Statistical Area",2001,44560,404,48,507,459,395,23,372,-39
"39860",NA,27049,"Goodhue County, MN","County or equivalent",2001,44560,404,48,507,459,395,23,372,-39
"39940",NA,NA,"Rexburg, ID","Micropolitan Statistical Area",2001,39949,700,515,727,212,-176,78,-254,361
"39940",NA,16043,"Fremont County, ID","County or equivalent",2001,11841,57,102,212,110,-33,42,-75,-12
"39940",NA,16065,"Madison County, ID","County or equivalent",2001,28108,643,413,515,102,-143,36,-179,373
"39980",NA,NA,"Richmond, IN","Micropolitan Statistical Area",2001,70521,-496,59,886,827,-500,50,-550,-55
"39980",NA,18177,"Wayne County, IN","County or equivalent",2001,70521,-496,59,886,827,-500,50,-550,-55
"40080",NA,NA,"Richmond-Berea, KY","Micropolitan Statistical Area",2001,89162,1216,491,1164,673,789,53,736,-64
"40080",NA,21151,"Madison County, KY","County or equivalent",2001,72640,1330,474,967,493,906,54,852,-50
"40080",NA,21203,"Rockcastle County, KY","County or equivalent",2001,16522,-114,17,197,180,-117,-1,-116,-14
"40100",NA,NA,"Rio Grande City-Roma, TX","Micropolitan Statistical Area",2001,54570,766,1160,1427,267,-363,511,-874,-31
"40100",NA,48427,"Starr County, TX","County or equivalent",2001,54570,766,1160,1427,267,-363,511,-874,-31
"40180",NA,NA,"Riverton, WY","Micropolitan Statistical Area",2001,35607,-211,102,472,370,-285,8,-293,-28
"40180",NA,56013,"Fremont County, WY","County or equivalent",2001,35607,-211,102,472,370,-285,8,-293,-28
"40260",NA,NA,"Roanoke Rapids, NC","Micropolitan Statistical Area",2001,78555,-737,129,1039,910,-801,39,-840,-65
"40260",NA,37083,"Halifax County, NC","County or equivalent",2001,56700,-541,148,780,632,-643,31,-674,-46
"40260",NA,37131,"Northampton County, NC","County or equivalent",2001,21855,-196,-19,259,278,-158,8,-166,-19
"40300",NA,NA,"Rochelle, IL","Micropolitan Statistical Area",2001,51604,449,166,616,450,186,117,69,97
"40300",NA,17141,"Ogle County, IL","County or equivalent",2001,51604,449,166,616,450,186,117,69,97
"40460",NA,NA,"Rockingham, NC","Micropolitan Statistical Area",2001,46323,-221,174,701,527,-358,65,-423,-37
"40460",NA,37153,"Richmond County, NC","County or equivalent",2001,46323,-221,174,701,527,-358,65,-423,-37
"40500",NA,NA,"Rockland, ME","Micropolitan Statistical Area",2001,39964,280,-66,386,452,376,14,362,-30
"40500",NA,23013,"Knox County, ME","County or equivalent",2001,39964,280,-66,386,452,376,14,362,-30
"40540",NA,NA,"Rock Springs, WY","Micropolitan Statistical Area",2001,36568,-915,265,510,245,-1172,18,-1190,-8
"40540",NA,56037,"Sweetwater County, WY","County or equivalent",2001,36568,-915,265,510,245,-1172,18,-1190,-8
"40620",NA,NA,"Rolla, MO","Micropolitan Statistical Area",2001,39911,31,90,493,403,-24,105,-129,-35
"40620",NA,29161,"Phelps County, MO","County or equivalent",2001,39911,31,90,493,403,-24,105,-129,-35
"40700",NA,NA,"Roseburg, OR","Micropolitan Statistical Area",2001,100077,-349,-101,1049,1150,-155,43,-198,-93
"40700",NA,41019,"Douglas County, OR","County or equivalent",2001,100077,-349,-101,1049,1150,-155,43,-198,-93
"40740",NA,NA,"Roswell, NM","Micropolitan Statistical Area",2001,60792,-487,345,944,599,-786,160,-946,-46
"40740",NA,35005,"Chaves County, NM","County or equivalent",2001,60792,-487,345,944,599,-786,160,-946,-46
"40760",NA,NA,"Ruidoso, NM","Micropolitan Statistical Area",2001,19425,-106,66,226,160,-151,37,-188,-21
"40760",NA,35027,"Lincoln County, NM","County or equivalent",2001,19425,-106,66,226,160,-151,37,-188,-21
"40780",NA,NA,"Russellville, AR","Micropolitan Statistical Area",2001,76109,452,322,1097,775,115,173,-58,15
"40780",NA,5115,"Pope County, AR","County or equivalent",2001,54936,432,217,739,522,184,33,151,31
"40780",NA,5149,"Yell County, AR","County or equivalent",2001,21173,20,105,358,253,-69,140,-209,-16
"40820",NA,NA,"Ruston, LA","Micropolitan Statistical Area",2001,57556,-335,141,721,580,-429,50,-479,-47
"40820",NA,22049,"Jackson Parish, LA","County or equivalent",2001,15369,-12,-1,205,206,5,0,5,-16
"40820",NA,22061,"Lincoln Parish, LA","County or equivalent",2001,42187,-323,142,516,374,-434,50,-484,-31
"40860",NA,NA,"Rutland, VT","Micropolitan Statistical Area",2001,63290,-134,58,693,635,-134,11,-145,-58
"40860",NA,50021,"Rutland County, VT","County or equivalent",2001,63290,-134,58,693,635,-134,11,-145,-58
"40940",NA,NA,"Safford, AZ","Micropolitan Statistical Area",2001,41583,-500,277,580,303,-750,27,-777,-27
"40940",NA,4009,"Graham County, AZ","County or equivalent",2001,33302,-240,225,474,249,-438,16,-454,-27
"40940",NA,4011,"Greenlee County, AZ","County or equivalent",2001,8281,-260,52,106,54,-312,11,-323,0
"41220",NA,NA,"St. Marys, GA","Micropolitan Statistical Area",2001,44504,746,530,716,186,260,-31,291,-44
"41220",NA,13039,"Camden County, GA","County or equivalent",2001,44504,746,530,716,186,260,-31,291,-44
"41260",NA,NA,"St. Marys, PA","Micropolitan Statistical Area",2001,34760,-276,4,389,385,-250,8,-258,-30
"41260",NA,42047,"Elk County, PA","County or equivalent",2001,34760,-276,4,389,385,-250,8,-258,-30
"41460",NA,NA,"Salina, KS","Micropolitan Statistical Area",2001,59990,155,237,813,576,-25,100,-125,-57
"41460",NA,20143,"Ottawa County, KS","County or equivalent",2001,6122,-68,-21,64,85,-42,2,-44,-5
"41460",NA,20169,"Saline County, KS","County or equivalent",2001,53868,223,258,749,491,17,98,-81,-52
"41580",NA,NA,"Salisbury, NC","Micropolitan Statistical Area",2001,132158,1483,365,1723,1358,1238,387,851,-120
"41580",NA,37159,"Rowan County, NC","County or equivalent",2001,132158,1483,365,1723,1358,1238,387,851,-120
"41820",NA,NA,"Sanford, NC","Micropolitan Statistical Area",2001,51166,1759,298,800,502,-202,322,-524,1663
"41820",NA,37105,"Lee County, NC","County or equivalent",2001,51166,1759,298,800,502,-202,322,-524,1663
"42300",NA,NA,"Sault Ste. Marie, MI","Micropolitan Statistical Area",2001,38453,-147,83,391,308,-196,14,-210,-34
"42300",NA,26033,"Chippewa County, MI","County or equivalent",2001,38453,-147,83,391,308,-196,14,-210,-34
"42380",NA,NA,"Sayre, PA","Micropolitan Statistical Area",2001,62501,-260,47,691,644,-248,7,-255,-59
"42380",NA,42015,"Bradford County, PA","County or equivalent",2001,62501,-260,47,691,644,-248,7,-255,-59
"42420",NA,NA,"Scottsbluff, NE","Micropolitan Statistical Area",2001,37337,-452,122,537,415,-552,64,-616,-22
"42420",NA,31007,"Banner County, NE","County or equivalent",2001,810,-13,2,5,3,-13,1,-14,-2
"42420",NA,31157,"Scotts Bluff County, NE","County or equivalent",2001,36527,-439,120,532,412,-539,63,-602,-20
"42460",NA,NA,"Scottsboro, AL","Micropolitan Statistical Area",2001,53975,-54,73,632,559,-70,13,-83,-57
"42460",NA,1071,"Jackson County, AL","County or equivalent",2001,53975,-54,73,632,559,-70,13,-83,-57
"42500",NA,NA,"Scottsburg, IN","Micropolitan Statistical Area",2001,23270,236,84,316,232,175,2,173,-23
"42500",NA,18143,"Scott County, IN","County or equivalent",2001,23270,236,84,316,232,175,2,173,-23
"42580",NA,NA,"Seaford, DE","Micropolitan Statistical Area",2001,160271,2836,262,2065,1803,2688,368,2320,-114
"42580",NA,10005,"Sussex County, DE","County or equivalent",2001,160271,2836,262,2065,1803,2688,368,2320,-114
"42620",NA,NA,"Searcy, AR","Micropolitan Statistical Area",2001,68325,921,167,904,737,804,54,750,-50
"42620",NA,5145,"White County, AR","County or equivalent",2001,68325,921,167,904,737,804,54,750,-50
"42700",NA,NA,"Sebring, FL","Micropolitan Statistical Area",2001,88447,1041,-408,853,1261,1501,373,1128,-52
"42700",NA,12055,"Highlands County, FL","County or equivalent",2001,88447,1041,-408,853,1261,1501,373,1128,-52
"42740",NA,NA,"Sedalia, MO","Micropolitan Statistical Area",2001,39469,35,128,571,443,-54,82,-136,-39
"42740",NA,29159,"Pettis County, MO","County or equivalent",2001,39469,35,128,571,443,-54,82,-136,-39
"42780",NA,NA,"Selinsgrove, PA","Micropolitan Statistical Area",2001,37744,208,169,485,316,78,3,75,-39
"42780",NA,42109,"Snyder County, PA","County or equivalent",2001,37744,208,169,485,316,78,3,75,-39
"42820",NA,NA,"Selma, AL","Micropolitan Statistical Area",2001,45922,-272,270,812,542,-504,2,-506,-38
"42820",NA,1047,"Dallas County, AL","County or equivalent",2001,45922,-272,270,812,542,-504,2,-506,-38
"42860",NA,NA,"Seneca, SC","Micropolitan Statistical Area",2001,66915,505,103,781,678,459,78,381,-57
"42860",NA,45073,"Oconee County, SC","County or equivalent",2001,66915,505,103,781,678,459,78,381,-57
"42900",NA,NA,"Seneca Falls, NY","Micropolitan Statistical Area",2001,34634,1291,43,359,316,1249,24,1225,-1
"42900",NA,36099,"Seneca County, NY","County or equivalent",2001,34634,1291,43,359,316,1249,24,1225,-1
"42940",NA,NA,"Sevierville, TN","Micropolitan Statistical Area",2001,73200,1501,299,929,630,1251,53,1198,-49
"42940",NA,47155,"Sevier County, TN","County or equivalent",2001,73200,1501,299,929,630,1251,53,1198,-49
"42980",NA,NA,"Seymour, IN","Micropolitan Statistical Area",2001,41372,-31,214,624,410,-211,100,-311,-34
"42980",NA,18071,"Jackson County, IN","County or equivalent",2001,41372,-31,214,624,410,-211,100,-311,-34
"43060",NA,NA,"Shawnee, OK","Micropolitan Statistical Area",2001,66264,591,206,933,727,438,21,417,-53
"43060",NA,40125,"Pottawatomie County, OK","County or equivalent",2001,66264,591,206,933,727,438,21,417,-53
"43140",NA,NA,"Shelby, NC","Micropolitan Statistical Area",2001,97057,586,265,1307,1042,411,77,334,-90
"43140",NA,37045,"Cleveland County, NC","County or equivalent",2001,97057,586,265,1307,1042,411,77,334,-90
"43180",NA,NA,"Shelbyville, TN","Micropolitan Statistical Area",2001,38502,687,207,591,384,511,235,276,-31
"43180",NA,47003,"Bedford County, TN","County or equivalent",2001,38502,687,207,591,384,511,235,276,-31
"43220",NA,NA,"Shelton, WA","Micropolitan Statistical Area",2001,49989,438,42,549,507,435,67,368,-39
"43220",NA,53045,"Mason County, WA","County or equivalent",2001,49989,438,42,549,507,435,67,368,-39
"43260",NA,NA,"Sheridan, WY","Micropolitan Statistical Area",2001,26647,56,6,280,274,77,10,67,-27
"43260",NA,56033,"Sheridan County, WY","County or equivalent",2001,26647,56,6,280,274,77,10,67,-27
"43320",NA,NA,"Show Low, AZ","Micropolitan Statistical Area",2001,98551,678,922,1635,713,-150,73,-223,-94
"43320",NA,4017,"Navajo County, AZ","County or equivalent",2001,98551,678,922,1635,713,-150,73,-223,-94
"43380",NA,NA,"Sidney, OH","Micropolitan Statistical Area",2001,48263,273,341,785,444,-22,49,-71,-46
"43380",NA,39149,"Shelby County, OH","County or equivalent",2001,48263,273,341,785,444,-22,49,-71,-46
"43420",NA,NA,"Sierra Vista-Douglas, AZ","Micropolitan Statistical Area",2001,118535,522,597,1677,1080,37,282,-245,-112
"43420",NA,4003,"Cochise County, AZ","County or equivalent",2001,118535,522,597,1677,1080,37,282,-245,-112
"43460",NA,NA,"Sikeston, MO","Micropolitan Statistical Area",2001,40418,28,133,539,406,-65,13,-78,-40
"43460",NA,29201,"Scott County, MO","County or equivalent",2001,40418,28,133,539,406,-65,13,-78,-40
"43500",NA,NA,"Silver City, NM","Micropolitan Statistical Area",2001,30704,-186,84,396,312,-247,9,-256,-23
"43500",NA,35017,"Grant County, NM","County or equivalent",2001,30704,-186,84,396,312,-247,9,-256,-23
"43540",NA,NA,"Silverthorne, CO","Micropolitan Statistical Area",2001,24705,1012,286,331,45,740,274,466,-14
"43540",NA,8117,"Summit County, CO","County or equivalent",2001,24705,1012,286,331,45,740,274,466,-14
"43660",NA,NA,"Snyder, TX","Micropolitan Statistical Area",2001,15740,-500,31,207,176,-524,14,-538,-7
"43660",NA,48415,"Scurry County, TX","County or equivalent",2001,15740,-500,31,207,176,-524,14,-538,-7
"43700",NA,NA,"Somerset, KY","Micropolitan Statistical Area",2001,56660,323,101,729,628,274,24,250,-52
"43700",NA,21199,"Pulaski County, KY","County or equivalent",2001,56660,323,101,729,628,274,24,250,-52
"43740",NA,NA,"Somerset, PA","Micropolitan Statistical Area",2001,79444,-586,-106,827,933,-411,15,-426,-69
"43740",NA,42111,"Somerset County, PA","County or equivalent",2001,79444,-586,-106,827,933,-411,15,-426,-69
"43860",NA,NA,"Southern Pines-Pinehurst, NC","Micropolitan Statistical Area",2001,76304,1123,27,906,879,1148,185,963,-52
"43860",NA,37125,"Moore County, NC","County or equivalent",2001,76304,1123,27,906,879,1148,185,963,-52
"43940",NA,NA,"Spearfish, SD","Micropolitan Statistical Area",2001,21705,-58,53,236,183,-90,2,-92,-21
"43940",NA,46081,"Lawrence County, SD","County or equivalent",2001,21705,-58,53,236,183,-90,2,-92,-21
"43980",NA,NA,"Spencer, IA","Micropolitan Statistical Area",2001,17249,-121,34,198,164,-142,16,-158,-13
"43980",NA,19041,"Clay County, IA","County or equivalent",2001,17249,-121,34,198,164,-142,16,-158,-13
"44020",NA,NA,"Spirit Lake, IA","Micropolitan Statistical Area",2001,16476,15,-23,174,197,53,5,48,-15
"44020",NA,19059,"Dickinson County, IA","County or equivalent",2001,16476,15,-23,174,197,53,5,48,-15
"44260",NA,NA,"Starkville, MS","Micropolitan Statistical Area",2001,42817,-221,306,587,281,-500,124,-624,-27
"44260",NA,28105,"Oktibbeha County, MS","County or equivalent",2001,42817,-221,306,587,281,-500,124,-624,-27
"44340",NA,NA,"Statesboro, GA","Micropolitan Statistical Area",2001,57001,776,266,686,420,557,90,467,-47
"44340",NA,13031,"Bulloch County, GA","County or equivalent",2001,57001,776,266,686,420,557,90,467,-47
"44380",NA,NA,"Statesville-Mooresville, NC","Micropolitan Statistical Area",2001,127104,3495,768,1859,1091,2804,339,2465,-77
"44380",NA,37097,"Iredell County, NC","County or equivalent",2001,127104,3495,768,1859,1091,2804,339,2465,-77
"44420",NA,NA,"Staunton-Waynesboro, VA","Micropolitan Statistical Area",2001,109505,285,125,1201,1076,268,59,209,-108
"44420",NA,51015,"Augusta County, VA","County or equivalent",2001,66063,289,138,654,516,217,33,184,-66
"44420",NA,51790,"Staunton city, VA","County or equivalent",2001,23634,-209,-42,249,291,-146,4,-150,-21
"44420",NA,51820,"Waynesboro city, VA","County or equivalent",2001,19808,205,29,298,269,197,22,175,-21
"44500",NA,NA,"Stephenville, TX","Micropolitan Statistical Area",2001,32871,-179,130,463,333,-284,97,-381,-25
"44500",NA,48143,"Erath County, TX","County or equivalent",2001,32871,-179,130,463,333,-284,97,-381,-25
"44540",NA,NA,"Sterling, CO","Micropolitan Statistical Area",2001,21269,622,68,270,202,561,46,515,-7
"44540",NA,8075,"Logan County, CO","County or equivalent",2001,21269,622,68,270,202,561,46,515,-7
"44580",NA,NA,"Sterling, IL","Micropolitan Statistical Area",2001,60560,-71,146,789,643,-163,46,-209,-54
"44580",NA,17195,"Whiteside County, IL","County or equivalent",2001,60560,-71,146,789,643,-163,46,-209,-54
"44620",NA,NA,"Stevens Point, WI","Micropolitan Statistical Area",2001,67340,88,385,794,409,-237,53,-290,-60
"44620",NA,55097,"Portage County, WI","County or equivalent",2001,67340,88,385,794,409,-237,53,-290,-60
"44660",NA,NA,"Stillwater, OK","Micropolitan Statistical Area",2001,70465,2208,258,782,524,761,283,478,1189
"44660",NA,40119,"Payne County, OK","County or equivalent",2001,70465,2208,258,782,524,761,283,478,1189
"44740",NA,NA,"Storm Lake, IA","Micropolitan Statistical Area",2001,20193,-155,44,242,198,-184,156,-340,-15
"44740",NA,19021,"Buena Vista County, IA","County or equivalent",2001,20193,-155,44,242,198,-184,156,-340,-15
"44780",NA,NA,"Sturgis, MI","Micropolitan Statistical Area",2001,62461,-56,357,989,632,-360,130,-490,-53
"44780",NA,26149,"St. Joseph County, MI","County or equivalent",2001,62461,-56,357,989,632,-360,130,-490,-53
"44860",NA,NA,"Sulphur Springs, TX","Micropolitan Statistical Area",2001,32173,161,122,482,360,73,77,-4,-34
"44860",NA,48223,"Hopkins County, TX","County or equivalent",2001,32173,161,122,482,360,73,77,-4,-34
"44900",NA,NA,"Summerville, GA","Micropolitan Statistical Area",2001,25808,314,82,359,277,254,24,230,-22
"44900",NA,13055,"Chattooga County, GA","County or equivalent",2001,25808,314,82,359,277,254,24,230,-22
"44980",NA,NA,"Sunbury, PA","Micropolitan Statistical Area",2001,93531,-942,-241,978,1219,-608,19,-627,-93
"44980",NA,42097,"Northumberland County, PA","County or equivalent",2001,93531,-942,-241,978,1219,-608,19,-627,-93
"45000",NA,NA,"Susanville, CA","Micropolitan Statistical Area",2001,33505,-243,45,249,204,-257,6,-263,-31
"45000",NA,6035,"Lassen County, CA","County or equivalent",2001,33505,-243,45,249,204,-257,6,-263,-31
"45020",NA,NA,"Sweetwater, TX","Micropolitan Statistical Area",2001,15337,-413,58,247,189,-468,16,-484,-3
"45020",NA,48353,"Nolan County, TX","County or equivalent",2001,15337,-413,58,247,189,-468,16,-484,-3
"45140",NA,NA,"Tahlequah, OK","Micropolitan Statistical Area",2001,43026,354,247,623,376,149,90,59,-42
"45140",NA,40021,"Cherokee County, OK","County or equivalent",2001,43026,354,247,623,376,149,90,59,-42
"45180",NA,NA,"Talladega-Sylacauga, AL","Micropolitan Statistical Area",2001,80287,-53,244,1097,853,-224,24,-248,-73
"45180",NA,1121,"Talladega County, AL","County or equivalent",2001,80287,-53,244,1097,853,-224,24,-248,-73
"45260",NA,NA,"Tallulah, LA","Micropolitan Statistical Area",2001,13394,-313,76,240,164,-384,1,-385,-5
"45260",NA,22065,"Madison Parish, LA","County or equivalent",2001,13394,-313,76,240,164,-384,1,-385,-5
"45340",NA,NA,"Taos, NM","Micropolitan Statistical Area",2001,30094,31,119,358,239,-62,66,-128,-26
"45340",NA,35055,"Taos County, NM","County or equivalent",2001,30094,31,119,358,239,-62,66,-128,-26
"45380",NA,NA,"Taylorville, IL","Micropolitan Statistical Area",2001,35153,-202,-63,389,452,-107,13,-120,-32
"45380",NA,17021,"Christian County, IL","County or equivalent",2001,35153,-202,-63,389,452,-107,13,-120,-32
"45540",NA,NA,"The Villages, FL","Micropolitan Statistical Area",2001,54725,1168,-136,464,600,1340,67,1273,-36
"45540",NA,12119,"Sumter County, FL","County or equivalent",2001,54725,1168,-136,464,600,1340,67,1273,-36
"45580",NA,NA,"Thomaston, GA","Micropolitan Statistical Area",2001,27701,86,7,376,369,105,42,63,-26
"45580",NA,13293,"Upson County, GA","County or equivalent",2001,27701,86,7,376,369,105,42,63,-26
"45620",NA,NA,"Thomasville, GA","Micropolitan Statistical Area",2001,42868,55,140,629,489,-43,28,-71,-42
"45620",NA,13275,"Thomas County, GA","County or equivalent",2001,42868,55,140,629,489,-43,28,-71,-42
"45640",NA,NA,"Thomasville-Lexington, NC","Micropolitan Statistical Area",2001,149199,1542,592,1983,1391,1080,409,671,-130
"45640",NA,37057,"Davidson County, NC","County or equivalent",2001,149199,1542,592,1983,1391,1080,409,671,-130
"45660",NA,NA,"Tiffin, OH","Micropolitan Statistical Area",2001,58314,-293,120,704,584,-366,21,-387,-47
"45660",NA,39147,"Seneca County, OH","County or equivalent",2001,58314,-293,120,704,584,-366,21,-387,-47
"45700",NA,NA,"Tifton, GA","Micropolitan Statistical Area",2001,38517,83,227,612,385,-111,172,-283,-33
"45700",NA,13277,"Tift County, GA","County or equivalent",2001,38517,83,227,612,385,-111,172,-283,-33
"45740",NA,NA,"Toccoa, GA","Micropolitan Statistical Area",2001,25559,83,39,356,317,68,8,60,-24
"45740",NA,13257,"Stephens County, GA","County or equivalent",2001,25559,83,39,356,317,68,8,60,-24
"45860",NA,NA,"Torrington, CT","Micropolitan Statistical Area",2001,183925,1311,377,1973,1596,1102,198,904,-168
"45860",NA,9005,"Litchfield County, CT","County or equivalent",2001,183925,1311,377,1973,1596,1102,198,904,-168
"45900",NA,NA,"Traverse City, MI","Micropolitan Statistical Area",2001,134719,2698,485,1595,1110,2301,84,2217,-88
"45900",NA,26019,"Benzie County, MI","County or equivalent",2001,16465,359,24,187,163,345,7,338,-10
"45900",NA,26055,"Grand Traverse County, MI","County or equivalent",2001,79931,1906,363,989,626,1592,59,1533,-49
"45900",NA,26079,"Kalkaska County, MI","County or equivalent",2001,16813,186,59,228,169,139,1,138,-12
"45900",NA,26089,"Leelanau County, MI","County or equivalent",2001,21510,247,39,191,152,225,17,208,-17
"45980",NA,NA,"Troy, AL","Micropolitan Statistical Area",2001,29629,-105,124,445,321,-205,30,-235,-24
"45980",NA,1109,"Pike County, AL","County or equivalent",2001,29629,-105,124,445,321,-205,30,-235,-24
"46020",NA,NA,"Truckee-Grass Valley, CA","Micropolitan Statistical Area",2001,93595,1090,-122,800,922,1273,98,1175,-61
"46020",NA,6057,"Nevada County, CA","County or equivalent",2001,93595,1090,-122,800,922,1273,98,1175,-61
"46100",NA,NA,"Tullahoma, TN","Micropolitan Statistical Area",2001,93984,692,115,1163,1048,659,86,573,-82
"46100",NA,47031,"Coffee County, TN","County or equivalent",2001,48557,360,102,663,561,301,63,238,-43
"46100",NA,47051,"Franklin County, TN","County or equivalent",2001,39638,308,12,449,437,329,24,305,-33
"46100",NA,47127,"Moore County, TN","County or equivalent",2001,5789,24,1,51,50,29,-1,30,-6
"46180",NA,NA,"Tupelo, MS","Micropolitan Statistical Area",2001,126472,886,608,1950,1342,403,67,336,-125
"46180",NA,28057,"Itawamba County, MS","County or equivalent",2001,22825,-23,-24,275,299,23,1,22,-22
"46180",NA,28081,"Lee County, MS","County or equivalent",2001,76573,612,501,1284,783,187,44,143,-76
"46180",NA,28115,"Pontotoc County, MS","County or equivalent",2001,27074,297,131,391,260,193,22,171,-27
"46260",NA,NA,"Tuskegee, AL","Micropolitan Statistical Area",2001,23981,-95,-27,302,329,-46,17,-63,-22
"46260",NA,1087,"Macon County, AL","County or equivalent",2001,23981,-95,-27,302,329,-46,17,-63,-22
"46300",NA,NA,"Twin Falls, ID","Micropolitan Statistical Area",2001,82871,119,579,1319,740,-391,286,-677,-69
"46300",NA,16053,"Jerome County, ID","County or equivalent",2001,18448,21,177,313,136,-142,84,-226,-14
"46300",NA,16083,"Twin Falls County, ID","County or equivalent",2001,64423,98,402,1006,604,-249,202,-451,-55
"46380",NA,NA,"Ukiah, CA","Micropolitan Statistical Area",2001,86620,235,257,1070,813,59,345,-286,-81
"46380",NA,6045,"Mendocino County, CA","County or equivalent",2001,86620,235,257,1070,813,59,345,-286,-81
"46420",NA,NA,"Union, SC","Micropolitan Statistical Area",2001,29542,-335,16,362,346,-325,4,-329,-26
"46420",NA,45087,"Union County, SC","County or equivalent",2001,29542,-335,16,362,346,-325,4,-329,-26
"46460",NA,NA,"Union City, TN-KY","Micropolitan Statistical Area",2001,40050,-133,32,528,496,-130,29,-159,-35
"46460",NA,21075,"Fulton County, KY","County or equivalent",2001,7759,62,-5,104,109,72,0,72,-5
"46460",NA,47131,"Obion County, TN","County or equivalent",2001,32291,-195,37,424,387,-202,29,-231,-30
"46500",NA,NA,"Urbana, OH","Micropolitan Statistical Area",2001,38966,41,103,497,394,-23,2,-25,-39
"46500",NA,39021,"Champaign County, OH","County or equivalent",2001,38966,41,103,497,394,-23,2,-25,-39
"46620",NA,NA,"Uvalde, TX","Micropolitan Statistical Area",2001,25989,71,239,486,247,-148,49,-197,-20
"46620",NA,48463,"Uvalde County, TX","County or equivalent",2001,25989,71,239,486,247,-148,49,-197,-20
"46740",NA,NA,"Valley, AL","Micropolitan Statistical Area",2001,36251,-311,-48,460,508,-233,17,-250,-30
"46740",NA,1017,"Chambers County, AL","County or equivalent",2001,36251,-311,-48,460,508,-233,17,-250,-30
"46780",NA,NA,"Van Wert, OH","Micropolitan Statistical Area",2001,29393,-238,10,343,333,-225,6,-231,-23
"46780",NA,39161,"Van Wert County, OH","County or equivalent",2001,29393,-238,10,343,333,-225,6,-231,-23
"46820",NA,NA,"Vermillion, SD","Micropolitan Statistical Area",2001,13568,71,78,173,95,7,16,-9,-14
"46820",NA,46027,"Clay County, SD","County or equivalent",2001,13568,71,78,173,95,7,16,-9,-14
"46860",NA,NA,"Vernal, UT","Micropolitan Statistical Area",2001,25697,445,314,471,157,152,10,142,-21
"46860",NA,49047,"Uintah County, UT","County or equivalent",2001,25697,445,314,471,157,152,10,142,-21
"46900",NA,NA,"Vernon, TX","Micropolitan Statistical Area",2001,14364,-276,-5,194,199,-257,15,-272,-14
"46900",NA,48487,"Wilbarger County, TX","County or equivalent",2001,14364,-276,-5,194,199,-257,15,-272,-14
"46980",NA,NA,"Vicksburg, MS","Micropolitan Statistical Area",2001,49244,-338,284,804,520,-587,18,-605,-35
"46980",NA,28149,"Warren County, MS","County or equivalent",2001,49244,-338,284,804,520,-587,18,-605,-35
"47080",NA,NA,"Vidalia, GA","Micropolitan Statistical Area",2001,34566,196,193,561,368,25,122,-97,-22
"47080",NA,13209,"Montgomery County, GA","County or equivalent",2001,8510,242,38,111,73,207,15,192,-3
"47080",NA,13279,"Toombs County, GA","County or equivalent",2001,26056,-46,155,450,295,-182,107,-289,-19
"47180",NA,NA,"Vincennes, IN","Micropolitan Statistical Area",2001,38841,-353,-42,418,460,-280,36,-316,-31
"47180",NA,18083,"Knox County, IN","County or equivalent",2001,38841,-353,-42,418,460,-280,36,-316,-31
"47340",NA,NA,"Wabash, IN","Micropolitan Statistical Area",2001,34627,-350,41,414,373,-365,0,-365,-26
"47340",NA,18169,"Wabash County, IN","County or equivalent",2001,34627,-350,41,414,373,-365,0,-365,-26
"47420",NA,NA,"Wahpeton, ND-MN","Micropolitan Statistical Area",2001,24559,-504,51,288,237,-541,8,-549,-14
"47420",NA,27167,"Wilkin County, MN","County or equivalent",2001,6961,-158,4,87,83,-159,2,-161,-3
"47420",NA,38077,"Richland County, ND","County or equivalent",2001,17598,-346,47,201,154,-382,6,-388,-11
"47460",NA,NA,"Walla Walla, WA","Micropolitan Statistical Area",2001,55198,-26,167,705,538,-143,179,-322,-50
"47460",NA,53071,"Walla Walla County, WA","County or equivalent",2001,55198,-26,167,705,538,-143,179,-322,-50
"47500",NA,NA,"Walterboro, SC","Micropolitan Statistical Area",2001,38424,87,206,572,366,-77,24,-101,-42
"47500",NA,45029,"Colleton County, SC","County or equivalent",2001,38424,87,206,572,366,-77,24,-101,-42
"47540",NA,NA,"Wapakoneta, OH","Micropolitan Statistical Area",2001,46568,-25,160,616,456,-141,22,-163,-44
"47540",NA,39011,"Auglaize County, OH","County or equivalent",2001,46568,-25,160,616,456,-141,22,-163,-44
"47620",NA,NA,"Warren, PA","Micropolitan Statistical Area",2001,43528,-258,16,487,471,-238,2,-240,-36
"47620",NA,42123,"Warren County, PA","County or equivalent",2001,43528,-258,16,487,471,-238,2,-240,-36
"47660",NA,NA,"Warrensburg, MO","Micropolitan Statistical Area",2001,49294,819,374,690,316,492,69,423,-47
"47660",NA,29101,"Johnson County, MO","County or equivalent",2001,49294,819,374,690,316,492,69,423,-47
"47700",NA,NA,"Warsaw, IN","Micropolitan Statistical Area",2001,74725,513,648,1227,579,-65,131,-196,-70
"47700",NA,18085,"Kosciusko County, IN","County or equivalent",2001,74725,513,648,1227,579,-65,131,-196,-70
"47780",NA,NA,"Washington, IN","Micropolitan Statistical Area",2001,29627,-202,132,494,362,-312,49,-361,-22
"47780",NA,18027,"Daviess County, IN","County or equivalent",2001,29627,-202,132,494,362,-312,49,-361,-22
"47820",NA,NA,"Washington, NC","Micropolitan Statistical Area",2001,44962,-11,48,635,587,-18,71,-89,-41
"47820",NA,37013,"Beaufort County, NC","County or equivalent",2001,44962,-11,48,635,587,-18,71,-89,-41
"47920",NA,NA,"Washington Court House, OH","Micropolitan Statistical Area",2001,28170,-265,5,352,347,-248,10,-258,-22
"47920",NA,39047,"Fayette County, OH","County or equivalent",2001,28170,-265,5,352,347,-248,10,-258,-22
"47980",NA,NA,"Watertown, SD","Micropolitan Statistical Area",2001,31445,-8,128,429,301,-108,16,-124,-28
"47980",NA,46029,"Codington County, SD","County or equivalent",2001,25902,-2,103,341,238,-81,16,-97,-24
"47980",NA,46057,"Hamlin County, SD","County or equivalent",2001,5543,-6,25,88,63,-27,0,-27,-4
"48020",NA,NA,"Watertown-Fort Atkinson, WI","Micropolitan Statistical Area",2001,76347,409,347,954,607,141,114,27,-79
"48020",NA,55055,"Jefferson County, WI","County or equivalent",2001,76347,409,347,954,607,141,114,27,-79
"48060",NA,NA,"Watertown-Fort Drum, NY","Micropolitan Statistical Area",2001,111839,348,789,1655,866,-1842,-17,-1825,1401
"48060",NA,36045,"Jefferson County, NY","County or equivalent",2001,111839,348,789,1655,866,-1842,-17,-1825,1401
"48100",NA,NA,"Wauchula, FL","Micropolitan Statistical Area",2001,26671,-233,275,472,197,-492,257,-749,-16
"48100",NA,12049,"Hardee County, FL","County or equivalent",2001,26671,-233,275,472,197,-492,257,-749,-16
"48180",NA,NA,"Waycross, GA","Micropolitan Statistical Area",2001,51243,104,121,741,620,34,79,-45,-51
"48180",NA,13229,"Pierce County, GA","County or equivalent",2001,15814,110,78,241,163,49,21,28,-17
"48180",NA,13299,"Ware County, GA","County or equivalent",2001,35429,-6,43,500,457,-15,58,-73,-34
"48460",NA,NA,"West Plains, MO","Micropolitan Statistical Area",2001,37100,-131,-3,469,472,-96,20,-116,-32
"48460",NA,29091,"Howell County, MO","County or equivalent",2001,37100,-131,-3,469,472,-96,20,-116,-32
"48500",NA,NA,"West Point, MS","Micropolitan Statistical Area",2001,21796,-175,95,333,238,-254,5,-259,-16
"48500",NA,28025,"Clay County, MS","County or equivalent",2001,21796,-175,95,333,238,-254,5,-259,-16
"48580",NA,NA,"Whitewater, WI","Micropolitan Statistical Area",2001,93403,983,226,1097,871,837,212,625,-80
"48580",NA,55127,"Walworth County, WI","County or equivalent",2001,93403,983,226,1097,871,837,212,625,-80
"48740",NA,NA,"Willimantic, CT","Micropolitan Statistical Area",2001,109786,594,248,1298,1050,447,198,249,-101
"48740",NA,9015,"Windham County, CT","County or equivalent",2001,109786,594,248,1298,1050,447,198,249,-101
"48780",NA,NA,"Williston, ND","Micropolitan Statistical Area",2001,19430,-222,24,222,198,-234,6,-240,-12
"48780",NA,38105,"Williams County, ND","County or equivalent",2001,19430,-222,24,222,198,-234,6,-240,-12
"48820",NA,NA,"Willmar, MN","Micropolitan Statistical Area",2001,41181,38,136,523,387,-62,80,-142,-36
"48820",NA,27067,"Kandiyohi County, MN","County or equivalent",2001,41181,38,136,523,387,-62,80,-142,-36
"48940",NA,NA,"Wilmington, OH","Micropolitan Statistical Area",2001,40913,251,182,539,357,108,40,68,-39
"48940",NA,39027,"Clinton County, OH","County or equivalent",2001,40913,251,182,539,357,108,40,68,-39
"48980",NA,NA,"Wilson, NC","Micropolitan Statistical Area",2001,73917,-10,346,1091,745,-295,276,-571,-61
"48980",NA,37195,"Wilson County, NC","County or equivalent",2001,73917,-10,346,1091,745,-295,276,-571,-61
"49060",NA,NA,"Winfield, KS","Micropolitan Statistical Area",2001,35757,-497,36,470,434,-510,28,-538,-23
"49060",NA,20035,"Cowley County, KS","County or equivalent",2001,35757,-497,36,470,434,-510,28,-538,-23
"49100",NA,NA,"Winona, MN","Micropolitan Statistical Area",2001,49822,-215,125,529,404,-301,67,-368,-39
"49100",NA,27169,"Winona County, MN","County or equivalent",2001,49822,-215,125,529,404,-301,67,-368,-39
"49260",NA,NA,"Woodward, OK","Micropolitan Statistical Area",2001,18319,-110,47,240,193,-142,12,-154,-15
"49260",NA,40153,"Woodward County, OK","County or equivalent",2001,18319,-110,47,240,193,-142,12,-154,-15
"49300",NA,NA,"Wooster, OH","Micropolitan Statistical Area",2001,112090,429,595,1602,1007,-55,89,-144,-111
"49300",NA,39169,"Wayne County, OH","County or equivalent",2001,112090,429,595,1602,1007,-55,89,-144,-111
"49380",NA,NA,"Worthington, MN","Micropolitan Statistical Area",2001,20741,-34,113,315,202,-128,80,-208,-19
"49380",NA,27105,"Nobles County, MN","County or equivalent",2001,20741,-34,113,315,202,-128,80,-208,-19
"49460",NA,NA,"Yankton, SD","Micropolitan Statistical Area",2001,21467,-139,60,245,185,-182,6,-188,-17
"49460",NA,46135,"Yankton County, SD","County or equivalent",2001,21467,-139,60,245,185,-182,6,-188,-17
"49540",NA,NA,"Yazoo City, MS","Micropolitan Statistical Area",2001,27767,-362,101,430,329,-446,12,-458,-17
"49540",NA,28163,"Yazoo County, MS","County or equivalent",2001,27767,-362,101,430,329,-446,12,-458,-17
"49780",NA,NA,"Zanesville, OH","Micropolitan Statistical Area",2001,84695,-13,189,1031,842,-121,14,-135,-81
"49780",NA,39119,"Muskingum County, OH","County or equivalent",2001,84695,-13,189,1031,842,-121,14,-135,-81
"10180",NA,48059,"Callahan County, TX","County or equivalent",2002,12802,85,-6,130,136,106,4,102,-15
"10180",NA,48253,"Jones County, TX","County or equivalent",2002,19982,-143,-53,189,242,-66,4,-70,-24
"10180",NA,48441,"Taylor County, TX","County or equivalent",2002,125315,-127,819,2018,1199,-840,-118,-722,-106
"10420",NA,NA,"Akron, OH","Metropolitan Statistical Area",2002,699463,1258,2070,8527,6457,-1043,653,-1696,231
"10420",NA,39133,"Portage County, OH","County or equivalent",2002,153692,666,473,1603,1130,337,110,227,-144
"10420",NA,39153,"Summit County, OH","County or equivalent",2002,545771,592,1597,6924,5327,-1380,543,-1923,375
"10500",NA,NA,"Albany, GA","Metropolitan Statistical Area",2002,160013,199,971,2276,1305,-1142,47,-1189,370
"10500",NA,13007,"Baker County, GA","County or equivalent",2002,3952,-85,-2,42,44,-81,2,-83,-2
"10500",NA,13095,"Dougherty County, GA","County or equivalent",2002,95742,-367,620,1445,825,-916,17,-933,-71
"10500",NA,13177,"Lee County, GA","County or equivalent",2002,27727,982,212,338,126,305,18,287,465
"10500",NA,13273,"Terrell County, GA","County or equivalent",2002,10827,-126,24,152,128,-143,4,-147,-7
"10500",NA,13321,"Worth County, GA","County or equivalent",2002,21765,-205,117,299,182,-307,6,-313,-15
"10580",NA,NA,"Albany-Schenectady-Troy, NY","Metropolitan Statistical Area",2002,833525,4204,1503,9251,7748,3432,1199,2233,-731
"10580",NA,36001,"Albany County, NY","County or equivalent",2002,296525,1240,416,3257,2841,1094,635,459,-270
"10580",NA,36083,"Rensselaer County, NY","County or equivalent",2002,152204,-41,154,1647,1493,-56,247,-303,-139
"10580",NA,36091,"Saratoga County, NY","County or equivalent",2002,206635,2559,820,2358,1538,1903,88,1815,-164
"10580",NA,36093,"Schenectady County, NY","County or equivalent",2002,146534,581,133,1692,1559,579,226,353,-131
"10580",NA,36095,"Schoharie County, NY","County or equivalent",2002,31627,-135,-20,297,317,-88,3,-91,-27
"10740",NA,NA,"Albuquerque, NM","Metropolitan Statistical Area",2002,753210,13883,5227,10915,5688,9167,1778,7389,-511
"10740",NA,35001,"Bernalillo County, NM","County or equivalent",2002,573387,10999,3973,8426,4453,7404,1581,5823,-378
"10740",NA,35043,"Sandoval County, NM","County or equivalent",2002,95632,2498,674,1303,629,1879,67,1812,-55
"10740",NA,35057,"Torrance County, NM","County or equivalent",2002,16534,-139,67,179,112,-198,12,-210,-8
"10740",NA,35061,"Valencia County, NM","County or equivalent",2002,67657,525,513,1007,494,82,118,-36,-70
"10780",NA,NA,"Alexandria, LA","Metropolitan Statistical Area",2002,145123,208,657,2154,1497,-409,62,-471,-40
"10780",NA,22043,"Grant Parish, LA","County or equivalent",2002,18670,27,83,261,178,-36,-1,-35,-20
"10780",NA,22079,"Rapides Parish, LA","County or equivalent",2002,126453,181,574,1893,1319,-373,63,-436,-20
"10900",NA,NA,"Allentown-Bethlehem-Easton, PA-NJ","Metropolitan Statistical Area",2002,755906,7383,1121,8518,7397,6625,1494,5131,-363
"10900",NA,34041,"Warren County, NJ","County or equivalent",2002,106871,1601,430,1327,897,1249,205,1044,-78
"10900",NA,42025,"Carbon County, PA","County or equivalent",2002,59556,349,-193,597,790,579,14,565,-37
"10900",NA,42077,"Lehigh County, PA","County or equivalent",2002,316549,1826,642,3819,3177,1481,805,676,-297
"10900",NA,42095,"Northampton County, PA","County or equivalent",2002,272930,3607,242,2775,2533,3316,470,2846,49
"11020",NA,NA,"Altoona, PA","Metropolitan Statistical Area",2002,127341,-994,-270,1413,1683,-622,24,-646,-102
"11020",NA,42013,"Blair County, PA","County or equivalent",2002,127341,-994,-270,1413,1683,-622,24,-646,-102
"11100",NA,NA,"Amarillo, TX","Metropolitan Statistical Area",2002,230161,1869,1424,3505,2081,684,519,165,-239
"11100",NA,48011,"Armstrong County, TX","County or equivalent",2002,2072,-78,-1,26,27,-77,1,-78,0
"11100",NA,48065,"Carson County, TX","County or equivalent",2002,6499,113,3,73,70,114,7,107,-4
"11100",NA,48375,"Potter County, TX","County or equivalent",2002,115736,1213,838,2102,1264,500,392,108,-125
"11100",NA,48381,"Randall County, TX","County or equivalent",2002,105854,621,584,1304,720,147,119,28,-110
"11180",NA,NA,"Ames, IA","Metropolitan Statistical Area",2002,81607,1555,460,898,438,1153,486,667,-58
"11180",NA,19169,"Story County, IA","County or equivalent",2002,81607,1555,460,898,438,1153,486,667,-58
"11260",NA,NA,"Anchorage, AK","Metropolitan Statistical Area",2002,332357,6709,3365,4959,1594,3568,29,3539,-224
"11260",NA,2020,"Anchorage Municipality, AK","County or equivalent",2002,267834,4088,2807,4095,1288,1503,12,1491,-222
"11260",NA,2170,"Matanuska-Susitna Borough, AK","County or equivalent",2002,64523,2621,558,864,306,2065,17,2048,-2
"11300",NA,NA,"Anderson, IN","Metropolitan Statistical Area",2002,132458,-534,198,1696,1498,-622,86,-708,-110
"11300",NA,18095,"Madison County, IN","County or equivalent",2002,132458,-534,198,1696,1498,-622,86,-708,-110
"11340",NA,NA,"Anderson, SC","Metropolitan Statistical Area",2002,169874,1184,349,2145,1796,975,118,857,-140
"11340",NA,45007,"Anderson County, SC","County or equivalent",2002,169874,1184,349,2145,1796,975,118,857,-140
"11460",NA,NA,"Ann Arbor, MI","Metropolitan Statistical Area",2002,333636,4397,2424,4207,1783,2315,2073,242,-342
"11460",NA,26161,"Washtenaw County, MI","County or equivalent",2002,333636,4397,2424,4207,1783,2315,2073,242,-342
"11500",NA,NA,"Anniston-Oxford, AL","Metropolitan Statistical Area",2002,110814,-187,171,1492,1321,-262,49,-311,-96
"11500",NA,1015,"Calhoun County, AL","County or equivalent",2002,110814,-187,171,1492,1321,-262,49,-311,-96
"11540",NA,NA,"Appleton, WI","Metropolitan Statistical Area",2002,208112,2785,1505,2847,1342,1455,226,1229,-175
"11540",NA,55015,"Calumet County, WI","County or equivalent",2002,42523,1069,324,571,247,763,34,729,-18
"11540",NA,55087,"Outagamie County, WI","County or equivalent",2002,165589,1716,1181,2276,1095,692,192,500,-157
"11700",NA,NA,"Asheville, NC","Metropolitan Statistical Area",2002,377644,3878,224,4398,4174,3923,817,3106,-269
"11700",NA,37021,"Buncombe County, NC","County or equivalent",2002,210623,2191,352,2534,2182,1992,453,1539,-153
"11700",NA,37087,"Haywood County, NC","County or equivalent",2002,54917,355,-108,566,674,503,28,475,-40
"11700",NA,37089,"Henderson County, NC","County or equivalent",2002,92258,1314,-54,1065,1119,1424,327,1097,-56
"11700",NA,37115,"Madison County, NC","County or equivalent",2002,19846,18,34,233,199,4,9,-5,-20
"12020",NA,NA,"Athens-Clarke County, GA","Metropolitan Statistical Area",2002,170914,1833,1084,2208,1124,884,720,164,-135
"12020",NA,13059,"Clarke County, GA","County or equivalent",2002,104158,733,744,1362,618,77,653,-576,-88
"12020",NA,13195,"Madison County, GA","County or equivalent",2002,26588,482,119,353,234,377,27,350,-14
"12020",NA,13219,"Oconee County, GA","County or equivalent",2002,27084,419,168,325,157,275,35,240,-24
"12020",NA,13221,"Oglethorpe County, GA","County or equivalent",2002,13084,199,53,168,115,155,5,150,-9
"12060",NA,NA,"Atlanta-Sandy Springs-Marietta, GA","Metropolitan Statistical Area",2002,4554769,122187,45858,73229,27371,52233,26014,26219,24096
"12060",NA,13013,"Barrow County, GA","County or equivalent",2002,50970,2514,472,833,361,2030,58,1972,12
"12060",NA,13015,"Bartow County, GA","County or equivalent",2002,82242,2732,782,1393,611,1976,121,1855,-26
"12060",NA,13035,"Butts County, GA","County or equivalent",2002,21227,870,118,312,194,751,3,748,1
"12060",NA,13045,"Carroll County, GA","County or equivalent",2002,94855,3294,640,1432,792,2672,193,2479,-18
"12060",NA,13057,"Cherokee County, GA","County or equivalent",2002,158924,7640,1898,2711,813,5760,501,5259,-18
"12060",NA,13063,"Clayton County, GA","County or equivalent",2002,252425,5252,3102,4489,1387,2409,1392,1017,-259
"12060",NA,13067,"Cobb County, GA","County or equivalent",2002,637617,10747,7250,10529,3279,4161,4262,-101,-664
"12060",NA,13077,"Coweta County, GA","County or equivalent",2002,97386,3640,930,1528,598,2747,253,2494,-37
"12060",NA,13085,"Dawson County, GA","County or equivalent",2002,17533,624,136,239,103,494,12,482,-6
"12060",NA,13089,"DeKalb County, GA","County or equivalent",2002,689827,7698,6821,10933,4112,-5744,7028,-12772,6621
"12060",NA,13097,"Douglas County, GA","County or equivalent",2002,98187,2698,799,1463,664,1948,163,1785,-49
"12060",NA,13113,"Fayette County, GA","County or equivalent",2002,95950,1756,335,876,541,1491,184,1307,-70
"12060",NA,13117,"Forsyth County, GA","County or equivalent",2002,116141,7440,1509,2137,628,5891,374,5517,40
"12060",NA,13121,"Fulton County, GA","County or equivalent",2002,862907,16101,7020,13062,6042,-9937,5270,-15207,19018
"12060",NA,13135,"Gwinnett County, GA","County or equivalent",2002,644872,22971,8868,11491,2623,14523,5429,9094,-420
"12060",NA,13143,"Haralson County, GA","County or equivalent",2002,26758,456,99,382,283,372,10,362,-15
"12060",NA,13149,"Heard County, GA","County or equivalent",2002,11194,31,38,137,99,4,1,3,-11
"12060",NA,13151,"Henry County, GA","County or equivalent",2002,139796,9336,1432,2192,760,7816,80,7736,88
"12060",NA,13159,"Jasper County, GA","County or equivalent",2002,12022,394,68,174,106,328,11,317,-2
"12060",NA,13171,"Lamar County, GA","County or equivalent",2002,16139,-203,18,198,180,-208,11,-219,-13
"12060",NA,13199,"Meriwether County, GA","County or equivalent",2002,22864,275,88,350,262,203,1,202,-16
"12060",NA,13217,"Newton County, GA","County or equivalent",2002,71242,4296,664,1212,548,3591,67,3524,41
"12060",NA,13223,"Paulding County, GA","County or equivalent",2002,93863,5292,1227,1673,446,4039,42,3997,26
"12060",NA,13227,"Pickens County, GA","County or equivalent",2002,25575,1089,126,350,224,960,19,941,3
"12060",NA,13231,"Pike County, GA","County or equivalent",2002,14610,574,80,196,116,493,0,493,1
"12060",NA,13247,"Rockdale County, GA","County or equivalent",2002,72953,1261,487,1007,520,833,375,458,-59
"12060",NA,13255,"Spalding County, GA","County or equivalent",2002,59838,851,333,908,575,562,98,464,-44
"12060",NA,13297,"Walton County, GA","County or equivalent",2002,66852,2558,518,1022,504,2068,56,2012,-28
"12100",NA,NA,"Atlantic City-Hammonton, NJ","Metropolitan Statistical Area",2002,258009,3226,784,3498,2714,2667,1236,1431,-225
"12100",NA,34001,"Atlantic County, NJ","County or equivalent",2002,258009,3226,784,3498,2714,2667,1236,1431,-225
"12220",NA,NA,"Auburn-Opelika, AL","Metropolitan Statistical Area",2002,118127,1389,579,1355,776,910,153,757,-100
"12220",NA,1081,"Lee County, AL","County or equivalent",2002,118127,1389,579,1355,776,910,153,757,-100
"12260",NA,NA,"Augusta-Richmond County, GA-SC","Metropolitan Statistical Area",2002,506275,3393,2725,7340,4615,1092,-34,1126,-424
"12260",NA,13033,"Burke County, GA","County or equivalent",2002,22677,34,152,391,239,-95,4,-99,-23
"12260",NA,13073,"Columbia County, GA","County or equivalent",2002,94117,2596,709,1292,583,1935,50,1885,-48
"12260",NA,13189,"McDuffie County, GA","County or equivalent",2002,21172,-123,67,296,229,-172,4,-176,-18
"12260",NA,13245,"Richmond County, GA","County or equivalent",2002,199023,-511,1332,3253,1921,-1668,-260,-1408,-175
"12260",NA,45003,"Aiken County, SC","County or equivalent",2002,144653,1275,411,1840,1429,1002,155,847,-138
"12260",NA,45037,"Edgefield County, SC","County or equivalent",2002,24633,122,54,268,214,90,13,77,-22
"12420",NA,NA,"Austin-Round Rock, TX","Metropolitan Statistical Area",2002,1353122,28778,15951,22518,6567,13307,8527,4780,-480
"12420",NA,48021,"Bastrop County, TX","County or equivalent",2002,63751,2493,497,942,445,2014,157,1857,-18
"12420",NA,48055,"Caldwell County, TX","County or equivalent",2002,34692,987,206,499,293,789,50,739,-8
"12420",NA,48209,"Hays County, TX","County or equivalent",2002,111862,7008,1024,1606,582,5918,178,5740,66
"12420",NA,48453,"Travis County, TX","County or equivalent",2002,853070,5110,10527,14552,4025,-4948,7440,-12388,-469
"12420",NA,48491,"Williamson County, TX","County or equivalent",2002,289747,13180,3697,4919,1222,9534,702,8832,-51
"12540",NA,NA,"Bakersfield, CA","Metropolitan Statistical Area",2002,689617,15382,6971,11950,4979,8924,2807,6117,-513
"12540",NA,6029,"Kern County, CA","County or equivalent",2002,689617,15382,6971,11950,4979,8924,2807,6117,-513
"12580",NA,NA,"Baltimore-Towson, MD","Metropolitan Statistical Area",2002,2599306,21894,10170,33875,23705,8015,3907,4108,3709
"12580",NA,24003,"Anne Arundel County, MD","County or equivalent",2002,502267,5386,3201,6817,3616,2599,-91,2690,-414
"12580",NA,24005,"Baltimore County, MD","County or equivalent",2002,768047,5778,1231,8934,7703,5257,1821,3436,-710
"12580",NA,24013,"Carroll County, MD","County or equivalent",2002,158597,4146,700,1903,1203,3521,64,3457,-75
"12580",NA,24025,"Harford County, MD","County or equivalent",2002,226732,4481,1348,2928,1580,3270,65,3205,-137
"12580",NA,24027,"Howard County, MD","County or equivalent",2002,259129,4113,2267,3577,1310,2087,961,1126,-241
"12580",NA,24035,"Queen Anne's County, MD","County or equivalent",2002,42584,1293,174,517,343,1129,40,1089,-10
"12580",NA,24510,"Baltimore city, MD","County or equivalent",2002,641950,-3303,1249,9199,7950,-9848,1047,-10895,5296
"12620",NA,NA,"Bangor, ME","Metropolitan Statistical Area",2002,146207,635,133,1476,1343,631,97,534,-129
"12620",NA,23019,"Penobscot County, ME","County or equivalent",2002,146207,635,133,1476,1343,631,97,534,-129
"12700",NA,NA,"Barnstable Town, MA","Metropolitan Statistical Area",2002,227002,1960,-761,1995,2756,2847,326,2521,-126
"12700",NA,25001,"Barnstable County, MA","County or equivalent",2002,227002,1960,-761,1995,2756,2847,326,2521,-126
"12940",NA,NA,"Baton Rouge, LA","Metropolitan Statistical Area",2002,713356,3638,4615,10320,5705,-541,883,-1424,-436
"12940",NA,22005,"Ascension Parish, LA","County or equivalent",2002,81164,2078,856,1351,495,1266,84,1182,-44
"12940",NA,22033,"East Baton Rouge Parish, LA","County or equivalent",2002,410340,-1016,2658,5990,3332,-3406,767,-4173,-268
"12940",NA,22037,"East Feliciana Parish, LA","County or equivalent",2002,21028,-170,49,286,237,-206,2,-208,-13
"12940",NA,22047,"Iberville Parish, LA","County or equivalent",2002,33038,-193,106,432,326,-276,3,-279,-23
"12940",NA,22063,"Livingston Parish, LA","County or equivalent",2002,98296,3099,709,1427,718,2412,22,2390,-22
"12940",NA,22077,"Pointe Coupee Parish, LA","County or equivalent",2002,22352,-172,82,305,223,-240,-1,-239,-14
"12940",NA,22091,"St. Helena Parish, LA","County or equivalent",2002,10430,5,2,118,116,16,-1,17,-13
"12940",NA,22121,"West Baton Rouge Parish, LA","County or equivalent",2002,21644,23,128,293,165,-83,4,-87,-22
"12940",NA,22125,"West Feliciana Parish, LA","County or equivalent",2002,15064,-16,25,118,93,-24,3,-27,-17
"12980",NA,NA,"Battle Creek, MI","Metropolitan Statistical Area",2002,138265,260,355,1855,1500,35,165,-130,-130
"12980",NA,26025,"Calhoun County, MI","County or equivalent",2002,138265,260,355,1855,1500,35,165,-130,-130
"13020",NA,NA,"Bay City, MI","Metropolitan Statistical Area",2002,109576,-75,211,1326,1115,-184,19,-203,-102
"13020",NA,26017,"Bay County, MI","County or equivalent",2002,109576,-75,211,1326,1115,-184,19,-203,-102
"13140",NA,NA,"Beaumont-Port Arthur, TX","Metropolitan Statistical Area",2002,380948,-730,1193,5150,3957,-1620,566,-2186,-303
"13140",NA,48199,"Hardin County, TX","County or equivalent",2002,48869,491,206,676,470,329,9,320,-44
"13140",NA,48245,"Jefferson County, TX","County or equivalent",2002,248221,-950,801,3396,2595,-1562,507,-2069,-189
"13140",NA,48361,"Orange County, TX","County or equivalent",2002,83858,-271,186,1078,892,-387,50,-437,-70
"13380",NA,NA,"Bellingham, WA","Metropolitan Statistical Area",2002,174888,3692,724,1942,1218,3091,602,2489,-123
"13380",NA,53073,"Whatcom County, WA","County or equivalent",2002,174888,3692,724,1942,1218,3091,602,2489,-123
"13460",NA,NA,"Bend, OR","Metropolitan Statistical Area",2002,125440,4795,478,1444,966,4339,88,4251,-22
"13460",NA,41017,"Deschutes County, OR","County or equivalent",2002,125440,4795,478,1444,966,4339,88,4251,-22
"13740",NA,NA,"Billings, MT","Metropolitan Statistical Area",2002,141401,1165,527,1812,1285,767,28,739,-129
"13740",NA,30009,"Carbon County, MT","County or equivalent",2002,9651,16,-11,97,108,36,5,31,-9
"13740",NA,30111,"Yellowstone County, MT","County or equivalent",2002,131750,1149,538,1715,1177,731,23,708,-120
"13780",NA,NA,"Binghamton, NY","Metropolitan Statistical Area",2002,251255,-157,255,2698,2443,-181,369,-550,-231
"13780",NA,36007,"Broome County, NY","County or equivalent",2002,199670,-288,74,2102,2028,-184,349,-533,-178
"13780",NA,36107,"Tioga County, NY","County or equivalent",2002,51585,131,181,596,415,3,20,-17,-53
"13820",NA,NA,"Birmingham-Hoover, AL","Metropolitan Statistical Area",2002,1064480,4404,3784,14626,10842,512,1276,-764,108
"13820",NA,1007,"Bibb County, AL","County or equivalent",2002,20983,41,82,296,214,-20,4,-24,-21
"13820",NA,1009,"Blount County, AL","County or equivalent",2002,52737,758,166,677,511,629,94,535,-37
"13820",NA,1021,"Chilton County, AL","County or equivalent",2002,40449,425,97,505,408,357,47,310,-29
"13820",NA,1073,"Jefferson County, AL","County or equivalent",2002,659317,-1992,1695,9009,7314,-3876,918,-4794,189
"13820",NA,1115,"St. Clair County, AL","County or equivalent",2002,67082,1072,270,839,569,846,16,830,-44
"13820",NA,1117,"Shelby County, AL","County or equivalent",2002,153809,4579,1517,2446,929,2954,160,2794,108
"13820",NA,1127,"Walker County, AL","County or equivalent",2002,70103,-479,-43,854,897,-378,37,-415,-58
"13900",NA,NA,"Bismarck, ND","Metropolitan Statistical Area",2002,96090,923,385,1146,761,614,34,580,-76
"13900",NA,38015,"Burleigh County, ND","County or equivalent",2002,71023,928,299,850,551,683,26,657,-54
"13900",NA,38059,"Morton County, ND","County or equivalent",2002,25067,-5,86,296,210,-69,8,-77,-22
"13980",NA,NA,"Blacksburg-Christiansburg-Radford, VA","Metropolitan Statistical Area",2002,152572,-466,120,1380,1260,-461,389,-850,-125
"13980",NA,51071,"Giles County, VA","County or equivalent",2002,16807,13,5,205,200,25,0,25,-17
"13980",NA,51121,"Montgomery County, VA","County or equivalent",2002,85058,111,192,745,553,-7,368,-375,-74
"13980",NA,51155,"Pulaski County, VA","County or equivalent",2002,34820,-316,-112,296,408,-175,5,-180,-29
"13980",NA,51750,"Radford city, VA","County or equivalent",2002,15887,-274,35,134,99,-304,16,-320,-5
"14020",NA,NA,"Bloomington, IN","Metropolitan Statistical Area",2002,176472,311,535,1908,1373,-69,449,-518,-155
"14020",NA,18055,"Greene County, IN","County or equivalent",2002,32968,-193,8,416,408,-167,2,-169,-34
"14020",NA,18105,"Monroe County, IN","County or equivalent",2002,121237,303,483,1241,758,-76,446,-522,-104
"14020",NA,18119,"Owen County, IN","County or equivalent",2002,22267,201,44,251,207,174,1,173,-17
"14060",NA,NA,"Bloomington-Normal, IL","Metropolitan Statistical Area",2002,155595,2997,1054,2076,1022,2041,266,1775,-98
"14060",NA,17113,"McLean County, IL","County or equivalent",2002,155595,2997,1054,2076,1022,2041,266,1775,-98
"14260",NA,NA,"Boise City-Nampa, ID","Metropolitan Statistical Area",2002,498963,13462,4981,8121,3140,8783,1157,7626,-302
"14260",NA,16001,"Ada County, ID","County or equivalent",2002,320867,7395,2959,4836,1877,4673,685,3988,-237
"14260",NA,16015,"Boise County, ID","County or equivalent",2002,6988,166,36,62,26,134,10,124,-4
"14260",NA,16027,"Canyon County, ID","County or equivalent",2002,144949,5899,1849,2849,1000,4092,379,3713,-42
"14260",NA,16045,"Gem County, ID","County or equivalent",2002,15379,44,41,197,156,18,23,-5,-15
"14260",NA,16073,"Owyhee County, ID","County or equivalent",2002,10780,-42,96,177,81,-134,60,-194,-4
"14460",NA,NA,"Boston-Cambridge-Quincy, MA-NH","Metropolitan Statistical Area",2002,4456374,14699,21034,57470,36436,-12026,23419,-35445,5691
"14460",14484,NA,"Boston-Quincy, MA","Metropolitan Division",2002,1847486,10200,8966,24358,15392,-4820,11022,-15842,6054
"14460",14484,25021,"Norfolk County, MA","County or equivalent",2002,654076,576,2405,8222,5817,-1283,2389,-3672,-546
"14460",14484,25023,"Plymouth County, MA","County or equivalent",2002,482750,3943,2335,6423,4088,2085,787,1298,-477
"14460",14484,25025,"Suffolk County, MA","County or equivalent",2002,710660,5681,4226,9713,5487,-5622,7846,-13468,7077
"14460",15764,NA,"Cambridge-Newton-Framingham, MA","Metropolitan Division",2002,1472688,-2987,7079,18791,11712,-10658,9360,-20018,592
"14460",15764,25017,"Middlesex County, MA","County or equivalent",2002,1472688,-2987,7079,18791,11712,-10658,9360,-20018,592
"14460",37764,NA,"Peabody, MA","Metropolitan Division",2002,733216,2354,2990,9576,6586,-4,2713,-2717,-632
"14460",37764,25009,"Essex County, MA","County or equivalent",2002,733216,2354,2990,9576,6586,-4,2713,-2717,-632
"14460",40484,NA,"Rockingham County-Strafford County, NH","Metropolitan Division",2002,402984,5132,1999,4745,2746,3456,324,3132,-323
"14460",40484,33015,"Rockingham County, NH","County or equivalent",2002,287005,3625,1402,3296,1894,2452,218,2234,-229
"14460",40484,33017,"Strafford County, NH","County or equivalent",2002,115979,1507,597,1449,852,1004,106,898,-94
"14500",NA,NA,"Boulder, CO /1","Metropolitan Statistical Area",2002,279832,2076,2275,3598,1323,41,1530,-1489,-240
"14500",NA,8013,"Boulder County, CO /1","County or equivalent",2002,279832,2076,2275,3598,1323,41,1530,-1489,-240
"14540",NA,NA,"Bowling Green, KY","Metropolitan Statistical Area",2002,106172,875,468,1402,934,512,356,156,-105
"14540",NA,21061,"Edmonson County, KY","County or equivalent",2002,11746,17,9,138,129,20,4,16,-12
"14540",NA,21227,"Warren County, KY","County or equivalent",2002,94426,858,459,1264,805,492,352,140,-93
"14600",NA,NA,"Bradenton-Sarasota-Venice, FL","Metropolitan Statistical Area",2002,618187,13370,-2098,6015,8113,15560,1860,13700,-92
"14600",NA,12081,"Manatee County, FL","County or equivalent",2002,279189,7286,-49,3216,3265,7365,826,6539,-30
"14600",NA,12115,"Sarasota County, FL","County or equivalent",2002,338998,6084,-2049,2799,4848,8195,1034,7161,-62
"14740",NA,NA,"Bremerton-Silverdale, WA","Metropolitan Statistical Area",2002,236623,3319,1158,2976,1818,2316,-416,2732,-155
"14740",NA,53035,"Kitsap County, WA","County or equivalent",2002,236623,3319,1158,2976,1818,2316,-416,2732,-155
"14860",NA,NA,"Bridgeport-Stamford-Norwalk, CT","Metropolitan Statistical Area",2002,890913,2687,4887,11926,7039,-1460,6471,-7931,-740
"14860",NA,9001,"Fairfield County, CT","County or equivalent",2002,890913,2687,4887,11926,7039,-1460,6471,-7931,-740
"15180",NA,NA,"Brownsville-Harlingen, TX","Metropolitan Statistical Area",2002,349868,7419,6318,8453,2135,1467,2052,-585,-366
"15180",NA,48061,"Cameron County, TX","County or equivalent",2002,349868,7419,6318,8453,2135,1467,2052,-585,-366
"15260",NA,NA,"Brunswick, GA","Metropolitan Statistical Area",2002,94977,709,309,1246,937,472,121,351,-72
"15260",NA,13025,"Brantley County, GA","County or equivalent",2002,15056,224,40,169,129,193,-1,194,-9
"15260",NA,13127,"Glynn County, GA","County or equivalent",2002,69003,654,246,928,682,464,122,342,-56
"15260",NA,13191,"McIntosh County, GA","County or equivalent",2002,10918,-169,23,149,126,-185,0,-185,-7
"15380",NA,NA,"Buffalo-Niagara Falls, NY","Metropolitan Statistical Area",2002,1158498,-5046,697,13098,12401,-4748,1370,-6118,-995
"15380",NA,36029,"Erie County, NY","County or equivalent",2002,940800,-4405,642,10675,10033,-4239,1220,-5459,-808
"15380",NA,36063,"Niagara County, NY","County or equivalent",2002,217698,-641,55,2423,2368,-509,150,-659,-187
"15500",NA,NA,"Burlington, NC","Metropolitan Statistical Area",2002,135308,1844,627,1874,1247,1326,653,673,-109
"15500",NA,37001,"Alamance County, NC","County or equivalent",2002,135308,1844,627,1874,1247,1326,653,673,-109
"15540",NA,NA,"Burlington-South Burlington, VT","Metropolitan Statistical Area",2002,202528,1450,878,2235,1357,767,445,322,-195
"15540",NA,50007,"Chittenden County, VT","County or equivalent",2002,148815,848,653,1613,960,344,420,-76,-149
"15540",NA,50011,"Franklin County, VT","County or equivalent",2002,46469,462,218,565,347,286,24,262,-42
"15540",NA,50013,"Grand Isle County, VT","County or equivalent",2002,7244,140,7,57,50,137,1,136,-4
"15940",NA,NA,"Canton-Massillon, OH","Metropolitan Statistical Area",2002,407807,499,728,4772,4044,-855,106,-961,626
"15940",NA,39019,"Carroll County, OH","County or equivalent",2002,29098,165,115,361,246,77,3,74,-27
"15940",NA,39151,"Stark County, OH","County or equivalent",2002,378709,334,613,4411,3798,-932,103,-1035,653
"15980",NA,NA,"Cape Coral-Fort Myers, FL","Metropolitan Statistical Area",2002,474040,15499,-41,5409,5450,15502,1816,13686,38
"15980",NA,12071,"Lee County, FL","County or equivalent",2002,474040,15499,-41,5409,5450,15502,1816,13686,38
"16180",NA,NA,"Carson City, NV","Metropolitan Statistical Area",2002,54367,964,82,738,656,928,197,731,-46
"16180",NA,32510,"Carson City, NV","County or equivalent",2002,54367,964,82,738,656,928,197,731,-46
"16220",NA,NA,"Casper, WY","Metropolitan Statistical Area",2002,67353,490,327,920,593,222,37,185,-59
"16220",NA,56025,"Natrona County, WY","County or equivalent",2002,67353,490,327,920,593,222,37,185,-59
"16300",NA,NA,"Cedar Rapids, IA","Metropolitan Statistical Area",2002,242033,1961,1490,3297,1807,513,269,244,-42
"16300",NA,19011,"Benton County, IA","County or equivalent",2002,25988,370,92,319,227,271,3,268,7
"16300",NA,19105,"Jones County, IA","County or equivalent",2002,20152,-7,-22,186,208,34,0,34,-19
"16300",NA,19113,"Linn County, IA","County or equivalent",2002,195893,1598,1420,2792,1372,208,266,-58,-30
"16580",NA,NA,"Champaign-Urbana, IL","Metropolitan Statistical Area",2002,213353,1563,1044,2603,1559,726,991,-265,-207
"16580",NA,17019,"Champaign County, IL","County or equivalent",2002,183101,1781,1118,2298,1180,841,981,-140,-178
"16580",NA,17053,"Ford County, IL","County or equivalent",2002,14092,-54,-56,168,224,16,7,9,-14
"16580",NA,17147,"Piatt County, IL","County or equivalent",2002,16160,-164,-18,137,155,-131,3,-134,-15
"16620",NA,NA,"Charleston, WV","Metropolitan Statistical Area",2002,306123,-896,126,3737,3611,-780,64,-844,-242
"16620",NA,54005,"Boone County, WV","County or equivalent",2002,25523,132,32,325,293,121,5,116,-21
"16620",NA,54015,"Clay County, WV","County or equivalent",2002,10293,71,9,138,129,70,1,69,-8
"16620",NA,54039,"Kanawha County, WV","County or equivalent",2002,196025,-1673,-125,2371,2496,-1398,57,-1455,-150
"16620",NA,54043,"Lincoln County, WV","County or equivalent",2002,22194,76,52,307,255,45,1,44,-21
"16620",NA,54079,"Putnam County, WV","County or equivalent",2002,52088,498,158,596,438,382,0,382,-42
"16700",NA,NA,"Charleston-North Charleston-Summerville, SC","Metropolitan Statistical Area",2002,566735,9291,3409,7832,4423,5801,200,5601,81
"16700",NA,45015,"Berkeley County, SC","County or equivalent",2002,146472,1709,1114,2096,982,728,-219,947,-133
"16700",NA,45019,"Charleston County, SC","County or equivalent",2002,319723,5444,1782,4546,2764,3390,376,3014,272
"16700",NA,45035,"Dorchester County, SC","County or equivalent",2002,100540,2138,513,1190,677,1683,43,1640,-58
"16740",NA,NA,"Charlotte-Gastonia-Concord, NC-SC","Metropolitan Statistical Area",2002,1405871,30982,11742,21972,10230,20208,6141,14067,-968
"16740",NA,37007,"Anson County, NC","County or equivalent",2002,25275,-43,-15,286,301,-6,12,-18,-22
"16740",NA,37025,"Cabarrus County, NC","County or equivalent",2002,139425,3235,1013,2154,1141,2299,405,1894,-77
"16740",NA,37071,"Gaston County, NC","County or equivalent",2002,192462,722,596,2532,1936,316,532,-216,-190
"16740",NA,37119,"Mecklenburg County, NC","County or equivalent",2002,736964,16289,7703,12273,4570,9177,4433,4744,-591
"16740",NA,37179,"Union County, NC","County or equivalent",2002,138129,6637,1448,2335,887,5191,549,4642,-2
"16740",NA,45091,"York County, SC","County or equivalent",2002,173616,4142,997,2392,1395,3231,210,3021,-86
"16820",NA,NA,"Charlottesville, VA","Metropolitan Statistical Area",2002,180527,2691,772,2108,1336,1364,536,828,555
"16820",NA,51003,"Albemarle County, VA","County or equivalent",2002,86320,692,403,985,582,374,354,20,-85
"16820",NA,51065,"Fluvanna County, VA","County or equivalent",2002,22069,894,103,248,145,785,5,780,6
"16820",NA,51079,"Greene County, VA","County or equivalent",2002,16289,545,139,231,92,413,6,407,-7
"16820",NA,51125,"Nelson County, VA","County or equivalent",2002,14680,141,-38,132,170,187,-2,189,-8
"16820",NA,51540,"Charlottesville city, VA","County or equivalent",2002,41169,419,165,512,347,-395,173,-568,649
"16860",NA,NA,"Chattanooga, TN-GA","Metropolitan Statistical Area",2002,487535,4897,1201,6082,4881,1851,546,1305,1845
"16860",NA,13047,"Catoosa County, GA","County or equivalent",2002,56069,1368,244,724,480,1147,27,1120,-23
"16860",NA,13083,"Dade County, GA","County or equivalent",2002,15590,131,50,197,147,95,11,84,-14
"16860",NA,13295,"Walker County, GA","County or equivalent",2002,61974,384,112,802,690,326,35,291,-54
"16860",NA,47065,"Hamilton County, TN","County or equivalent",2002,314319,2793,740,3895,3155,85,454,-369,1968
"16860",NA,47115,"Marion County, TN","County or equivalent",2002,27821,-8,-5,308,313,23,10,13,-26
"16860",NA,47153,"Sequatchie County, TN","County or equivalent",2002,11762,229,60,156,96,175,9,166,-6
"16940",NA,NA,"Cheyenne, WY","Metropolitan Statistical Area",2002,83135,755,469,1150,681,351,-134,485,-65
"16940",NA,56021,"Laramie County, WY","County or equivalent",2002,83135,755,469,1150,681,351,-134,485,-65
"16980",NA,NA,"Chicago-Naperville-Joliet, IL-IN-WI","Metropolitan Statistical Area",2002,9252133,56772,70416,141220,70804,-13985,54871,-68856,341
"16980",16974,NA,"Chicago-Naperville-Joliet, IL","Metropolitan Division",2002,7747503,42001,60149,119543,59394,-19144,51099,-70243,996
"16980",16974,17031,"Cook County, IL","County or equivalent",2002,5360625,-17945,37373,82689,45316,-56095,40501,-96596,777
"16980",16974,17037,"DeKalb County, IL","County or equivalent",2002,92395,1591,541,1153,612,1093,302,791,-43
"16980",16974,17043,"DuPage County, IL","County or equivalent",2002,919547,4992,7346,12945,5599,-2246,5377,-7623,-108
"16980",16974,17063,"Grundy County, IL","County or equivalent",2002,38622,431,181,491,310,281,39,242,-31
"16980",16974,17089,"Kane County, IL","County or equivalent",2002,440584,16615,5667,8190,2523,10888,2942,7946,60
"16980",16974,17093,"Kendall County, IL","County or equivalent",2002,61725,3567,704,1007,303,2936,75,2861,-73
"16980",16974,17111,"McHenry County, IL","County or equivalent",2002,278282,8300,2634,4217,1583,5174,760,4414,492
"16980",16974,17197,"Will County, IL","County or equivalent",2002,555723,24450,5703,8851,3148,18825,1103,17722,-78
"16980",23844,NA,"Gary, IN","Metropolitan Division",2002,678497,1430,2806,9164,6358,-797,774,-1571,-579
"16980",23844,18073,"Jasper County, IN","County or equivalent",2002,30389,182,124,382,258,87,14,73,-29
"16980",23844,18089,"Lake County, IN","County or equivalent",2002,483936,-243,1912,6777,4865,-1744,603,-2347,-411
"16980",23844,18111,"Newton County, IN","County or equivalent",2002,14245,-74,37,168,131,-100,13,-113,-11
"16980",23844,18127,"Porter County, IN","County or equivalent",2002,149927,1565,733,1837,1104,960,144,816,-128
"16980",29404,NA,"Lake County-Kenosha County, IL-WI","Metropolitan Division",2002,826133,13341,7461,12513,5052,5956,2998,2958,-76
"16980",29404,17097,"Lake County, IL","County or equivalent",2002,672303,11452,6611,10469,3858,4791,2782,2009,50
"16980",29404,55059,"Kenosha County, WI","County or equivalent",2002,153830,1889,850,2044,1194,1165,216,949,-126
"17020",NA,NA,"Chico, CA","Metropolitan Statistical Area",2002,209299,2933,-9,2277,2286,3053,435,2618,-111
"17020",NA,6007,"Butte County, CA","County or equivalent",2002,209299,2933,-9,2277,2286,3053,435,2618,-111
"17140",NA,NA,"Cincinnati-Middletown, OH-KY-IN","Metropolitan Statistical Area",2002,2049629,14235,10466,28391,17925,-2411,2490,-4901,6180
"17140",NA,18029,"Dearborn County, IN","County or equivalent",2002,47146,372,193,537,344,219,9,210,-40
"17140",NA,18047,"Franklin County, IN","County or equivalent",2002,22423,148,87,255,168,79,1,78,-18
"17140",NA,18115,"Ohio County, IN","County or equivalent",2002,5739,73,-1,59,60,79,-1,80,-5
"17140",NA,21015,"Boone County, KY","County or equivalent",2002,93289,3075,858,1447,589,2255,184,2071,-38
"17140",NA,21023,"Bracken County, KY","County or equivalent",2002,8451,90,21,108,87,75,1,74,-6
"17140",NA,21037,"Campbell County, KY","County or equivalent",2002,88311,-302,296,1167,871,-531,61,-592,-67
"17140",NA,21077,"Gallatin County, KY","County or equivalent",2002,7834,-151,20,113,93,-167,0,-167,-4
"17140",NA,21081,"Grant County, KY","County or equivalent",2002,23519,411,193,389,196,234,9,225,-16
"17140",NA,21117,"Kenton County, KY","County or equivalent",2002,151693,-267,830,2200,1370,-976,116,-1092,-121
"17140",NA,21191,"Pendleton County, KY","County or equivalent",2002,14722,109,99,210,111,23,7,16,-13
"17140",NA,39015,"Brown County, OH","County or equivalent",2002,43208,436,150,543,393,324,7,317,-38
"17140",NA,39017,"Butler County, OH","County or equivalent",2002,338891,2338,1940,4682,2742,722,345,377,-324
"17140",NA,39025,"Clermont County, OH","County or equivalent",2002,182550,2158,1349,2631,1282,984,118,866,-175
"17140",NA,39061,"Hamilton County, OH","County or equivalent",2002,848120,-1177,3019,11479,8460,-11260,1477,-12737,7064
"17140",NA,39165,"Warren County, OH","County or equivalent",2002,173733,6922,1412,2571,1159,5529,156,5373,-19
"17300",NA,NA,"Clarksville, TN-KY","Metropolitan Statistical Area",2002,238073,2423,2427,4153,1726,-1074,-1107,33,1070
"17300",NA,21047,"Christian County, KY","County or equivalent",2002,75999,1249,992,1531,539,-967,-544,-423,1224
"17300",NA,21221,"Trigg County, KY","County or equivalent",2002,12695,9,-40,119,159,59,-4,63,-10
"17300",NA,47125,"Montgomery County, TN","County or equivalent",2002,136699,1040,1477,2351,874,-300,-549,249,-137
"17300",NA,47161,"Stewart County, TN","County or equivalent",2002,12680,125,-2,152,154,134,-10,144,-7
"17420",NA,NA,"Cleveland, TN","Metropolitan Statistical Area",2002,105539,478,430,1404,974,137,118,19,-89
"17420",NA,47011,"Bradley County, TN","County or equivalent",2002,89525,685,429,1196,767,336,113,223,-80
"17420",NA,47139,"Polk County, TN","County or equivalent",2002,16014,-207,1,208,207,-199,5,-204,-9
"17460",NA,NA,"Cleveland-Elyria-Mentor, OH","Metropolitan Statistical Area",2002,2139550,-4430,5276,26967,21691,-10072,3514,-13586,366
"17460",NA,39035,"Cuyahoga County, OH","County or equivalent",2002,1369638,-12063,2316,17596,15280,-13444,2772,-16216,-935
"17460",NA,39055,"Geauga County, OH","County or equivalent",2002,92284,679,404,1077,673,366,26,340,-91
"17460",NA,39085,"Lake County, OH","County or equivalent",2002,230541,1285,498,2606,2108,-91,413,-504,878
"17460",NA,39093,"Lorain County, OH","County or equivalent",2002,289198,2395,1075,3633,2558,708,201,507,612
"17460",NA,39103,"Medina County, OH","County or equivalent",2002,157889,3274,983,2055,1072,2389,102,2287,-98
"17660",NA,NA,"Coeur d'Alene, ID","Metropolitan Statistical Area",2002,114025,2306,558,1463,905,1839,46,1793,-91
"17660",NA,16055,"Kootenai County, ID","County or equivalent",2002,114025,2306,558,1463,905,1839,46,1793,-91
"17780",NA,NA,"College Station-Bryan, TX","Metropolitan Statistical Area",2002,189277,2455,1547,2655,1108,1095,1150,-55,-187
"17780",NA,48041,"Brazos County, TX","County or equivalent",2002,156917,2697,1495,2208,713,1364,1111,253,-162
"17780",NA,48051,"Burleson County, TX","County or equivalent",2002,16556,-51,62,215,153,-96,12,-108,-17
"17780",NA,48395,"Robertson County, TX","County or equivalent",2002,15804,-191,-10,232,242,-173,27,-200,-8
"17820",NA,NA,"Colorado Springs, CO","Metropolitan Statistical Area",2002,566143,9529,5731,8963,3232,3133,-101,3234,665
"17820",NA,8041,"El Paso County, CO","County or equivalent",2002,544862,9306,5577,8714,3137,3045,-100,3145,684
"17820",NA,8119,"Teller County, CO","County or equivalent",2002,21281,223,154,249,95,88,-1,89,-19
"17860",NA,NA,"Columbia, MO","Metropolitan Statistical Area",2002,149708,1928,887,1873,986,1157,423,734,-116
"17860",NA,29019,"Boone County, MO","County or equivalent",2002,139705,2046,889,1766,877,1267,419,848,-110
"17860",NA,29089,"Howard County, MO","County or equivalent",2002,10003,-118,-2,107,109,-110,4,-114,-6
"17900",NA,NA,"Columbia, SC","Metropolitan Statistical Area",2002,663104,5666,3457,8870,5413,2795,516,2279,-586
"17900",NA,45017,"Calhoun County, SC","County or equivalent",2002,15139,-122,32,183,151,-141,6,-147,-13
"17900",NA,45039,"Fairfield County, SC","County or equivalent",2002,23754,172,60,324,264,132,6,126,-20
"17900",NA,45055,"Kershaw County, SC","County or equivalent",2002,53451,116,153,677,524,16,12,4,-53
"17900",NA,45063,"Lexington County, SC","County or equivalent",2002,222116,2332,1237,2982,1745,1306,349,957,-211
"17900",NA,45079,"Richland County, SC","County or equivalent",2002,329626,3260,1916,4450,2534,1619,21,1598,-275
"17900",NA,45081,"Saluda County, SC","County or equivalent",2002,19018,-92,59,254,195,-137,122,-259,-14
"17980",NA,NA,"Columbus, GA-AL","Metropolitan Statistical Area",2002,286223,2832,1456,4171,2715,1487,-465,1952,-111
"17980",NA,1113,"Russell County, AL","County or equivalent",2002,49141,-229,72,636,564,-260,26,-286,-41
"17980",NA,13053,"Chattahoochee County, GA","County or equivalent",2002,19187,3212,213,244,31,2907,-340,3247,92
"17980",NA,13145,"Harris County, GA","County or equivalent",2002,24966,646,78,285,207,575,6,569,-7
"17980",NA,13197,"Marion County, GA","County or equivalent",2002,7076,-68,27,104,77,-88,27,-115,-7
"17980",NA,13215,"Muscogee County, GA","County or equivalent",2002,185853,-729,1066,2902,1836,-1647,-184,-1463,-148
"18020",NA,NA,"Columbus, IN","Metropolitan Statistical Area",2002,71653,-320,355,991,636,-631,223,-854,-44
"18020",NA,18005,"Bartholomew County, IN","County or equivalent",2002,71653,-320,355,991,636,-631,223,-854,-44
"18140",NA,NA,"Columbus, OH","Metropolitan Statistical Area",2002,1658667,16806,12321,24831,12510,4753,4323,430,-268
"18140",NA,39041,"Delaware County, OH","County or equivalent",2002,126988,7905,1351,1999,648,5651,61,5590,903
"18140",NA,39045,"Fairfield County, OH","County or equivalent",2002,128872,2901,708,1704,996,2256,14,2242,-63
"18140",NA,39049,"Franklin County, OH","County or equivalent",2002,1086682,4512,8821,17034,8213,-3454,4153,-7607,-855
"18140",NA,39089,"Licking County, OH","County or equivalent",2002,148439,1113,664,1953,1289,579,48,531,-130
"18140",NA,39097,"Madison County, OH","County or equivalent",2002,40361,183,161,507,346,65,29,36,-43
"18140",NA,39117,"Morrow County, OH","County or equivalent",2002,32867,477,170,440,270,328,3,325,-21
"18140",NA,39129,"Pickaway County, OH","County or equivalent",2002,51557,-707,146,600,454,-831,1,-832,-22
"18140",NA,39159,"Union County, OH","County or equivalent",2002,42901,422,300,594,294,159,14,145,-37
"18580",NA,NA,"Corpus Christi, TX","Metropolitan Statistical Area",2002,402926,1618,3294,6545,3251,-1335,219,-1554,-341
"18580",NA,48007,"Aransas County, TX","County or equivalent",2002,23000,486,-1,256,257,495,33,462,-8
"18580",NA,48355,"Nueces County, TX","County or equivalent",2002,313072,1152,2704,5183,2479,-1272,311,-1583,-280
"18580",NA,48409,"San Patricio County, TX","County or equivalent",2002,66854,-20,591,1106,515,-558,-125,-433,-53
"18700",NA,NA,"Corvallis, OR","Metropolitan Statistical Area",2002,79585,1436,362,796,434,1131,344,787,-57
"18700",NA,41003,"Benton County, OR","County or equivalent",2002,79585,1436,362,796,434,1131,344,787,-57
"19060",NA,NA,"Cumberland, MD-WV","Metropolitan Statistical Area",2002,100852,-464,-275,976,1251,-107,19,-126,-82
"19060",NA,24001,"Allegany County, MD","County or equivalent",2002,73737,-583,-248,684,932,-273,13,-286,-62
"19060",NA,54057,"Mineral County, WV","County or equivalent",2002,27115,119,-27,292,319,166,6,160,-20
"19100",NA,NA,"Dallas-Fort Worth-Arlington, TX","Metropolitan Statistical Area",2002,5476979,122233,62566,95695,33129,56136,42217,13919,3531
"19100",19124,NA,"Dallas-Plano-Irving, TX","Metropolitan Division",2002,3672291,80378,44498,65300,20802,30949,32816,-1867,4931
"19100",19124,48085,"Collin County, TX","County or equivalent",2002,568990,31086,7435,9467,2032,23100,3341,19759,551
"19100",19124,48113,"Dallas County, TX","County or equivalent",2002,2280650,12952,28752,42885,14133,-19742,26757,-46499,3942
"19100",19124,48119,"Delta County, TX","County or equivalent",2002,5433,106,0,58,58,112,-1,113,-6
"19100",19124,48121,"Denton County, TX","County or equivalent",2002,489394,24602,6222,8071,1849,17957,1844,16113,423
"19100",19124,48139,"Ellis County, TX","County or equivalent",2002,119500,3796,959,1872,913,2890,371,2519,-53
"19100",19124,48231,"Hunt County, TX","County or equivalent",2002,79785,1569,320,1084,764,1292,203,1089,-43
"19100",19124,48257,"Kaufman County, TX","County or equivalent",2002,77744,2575,431,1165,734,2109,197,1912,35
"19100",19124,48397,"Rockwall County, TX","County or equivalent",2002,50795,3692,379,698,319,3231,104,3127,82
"19100",23104,NA,"Fort Worth-Arlington, TX","Metropolitan Division",2002,1804688,41855,18068,30395,12327,25187,9401,15786,-1400
"19100",23104,48251,"Johnson County, TX","County or equivalent",2002,134853,3178,843,1927,1084,2401,255,2146,-66
"19100",23104,48367,"Parker County, TX","County or equivalent",2002,93941,2301,355,1128,773,1974,92,1882,-28
"19100",23104,48439,"Tarrant County, TX","County or equivalent",2002,1523445,34908,16612,26677,10065,19580,8952,10628,-1284
"19100",23104,48497,"Wise County, TX","County or equivalent",2002,52449,1468,258,663,405,1232,102,1130,-22
"19140",NA,NA,"Dalton, GA","Metropolitan Statistical Area",2002,124788,1504,1524,2433,909,71,983,-912,-91
"19140",NA,13213,"Murray County, GA","County or equivalent",2002,38363,572,362,617,255,245,67,178,-35
"19140",NA,13313,"Whitfield County, GA","County or equivalent",2002,86425,932,1162,1816,654,-174,916,-1090,-56
"19180",NA,NA,"Danville, IL","Metropolitan Statistical Area",2002,82923,-529,134,1092,958,-604,51,-655,-59
"19180",NA,17183,"Vermilion County, IL","County or equivalent",2002,82923,-529,134,1092,958,-604,51,-655,-59
"19260",NA,NA,"Danville, VA","Metropolitan Statistical Area",2002,108618,-733,-150,1282,1432,-484,82,-566,-99
"19260",NA,51143,"Pittsylvania County, VA","County or equivalent",2002,61348,-338,63,714,651,-341,38,-379,-60
"19260",NA,51590,"Danville city, VA","County or equivalent",2002,47270,-395,-213,568,781,-143,44,-187,-39
"19340",NA,NA,"Davenport-Moline-Rock Island, IA-IL","Metropolitan Statistical Area",2002,373804,-783,1457,4931,3474,-1956,522,-2478,-284
"19340",NA,17073,"Henry County, IL","County or equivalent",2002,50169,-393,-13,552,565,-338,21,-359,-42
"19340",NA,17131,"Mercer County, IL","County or equivalent",2002,16880,-24,44,196,152,-53,4,-57,-15
"19340",NA,17161,"Rock Island County, IL","County or equivalent",2002,148133,-487,428,1904,1476,-808,277,-1085,-107
"19340",NA,19163,"Scott County, IA","County or equivalent",2002,158622,121,998,2279,1281,-757,220,-977,-120
"19380",NA,NA,"Dayton, OH","Metropolitan Statistical Area",2002,845270,-735,2745,10890,8145,-3399,380,-3779,-81
"19380",NA,39057,"Greene County, OH","County or equivalent",2002,151447,1918,500,1686,1186,940,72,868,478
"19380",NA,39109,"Miami County, OH","County or equivalent",2002,99202,106,345,1256,911,-148,54,-202,-91
"19380",NA,39113,"Montgomery County, OH","County or equivalent",2002,552310,-2787,1837,7485,5648,-4199,242,-4441,-425
"19380",NA,39135,"Preble County, OH","County or equivalent",2002,42311,28,63,463,400,8,12,-4,-43
"19460",NA,NA,"Decatur, AL","Metropolitan Statistical Area",2002,145932,-339,428,1836,1408,-649,190,-839,-118
"19460",NA,1079,"Lawrence County, AL","County or equivalent",2002,34645,-192,58,399,341,-221,10,-231,-29
"19460",NA,1103,"Morgan County, AL","County or equivalent",2002,111287,-147,370,1437,1067,-428,180,-608,-89
"19500",NA,NA,"Decatur, IL","Metropolitan Statistical Area",2002,111998,-1320,282,1411,1129,-1545,48,-1593,-57
"19500",NA,17115,"Macon County, IL","County or equivalent",2002,111998,-1320,282,1411,1129,-1545,48,-1593,-57
"19660",NA,NA,"Deltona-Daytona Beach-Ormond Beach, FL","Metropolitan Statistical Area",2002,458242,7075,-1356,4551,5907,8630,789,7841,-199
"19660",NA,12127,"Volusia County, FL","County or equivalent",2002,458242,7075,-1356,4551,5907,8630,789,7841,-199
"19740",NA,NA,"Denver-Aurora, CO /1","Metropolitan Statistical Area",2002,2277073,30097,22346,36289,13943,8129,13341,-5212,-378
"19740",NA,8001,"Adams County, CO /1","County or equivalent",2002,371986,11579,4318,6467,2149,7471,2555,4916,-210
"19740",NA,8005,"Arapahoe County, CO /1","County or equivalent",2002,509769,6916,4600,7501,2901,2840,2615,225,-524
"19740",NA,8014,"Broomfield County, CO /1","County or equivalent",2002,42545,1095,407,605,198,-69,123,-192,757
"19740",NA,8019,"Clear Creek County, CO /1","County or equivalent",2002,9495,94,59,106,47,43,2,41,-8
"19740",NA,8031,"Denver County, CO /1","County or equivalent",2002,561477,-3051,6241,10835,4594,-9198,6467,-15665,-94
"19740",NA,8035,"Douglas County, CO /1","County or equivalent",2002,209977,12687,3256,3760,504,9345,389,8956,86
"19740",NA,8039,"Elbert County, CO /1","County or equivalent",2002,21786,617,145,235,90,478,7,471,-6
"19740",NA,8047,"Gilpin County, CO /1","County or equivalent",2002,4858,27,38,64,26,-8,1,-9,-3
"19740",NA,8059,"Jefferson County, CO /1","County or equivalent",2002,529261,-441,3181,6545,3364,-3246,1173,-4419,-376
"19740",NA,8093,"Park County, CO /1","County or equivalent",2002,15919,574,101,171,70,473,9,464,0
"19780",NA,NA,"Des Moines-West Des Moines, IA","Metropolitan Statistical Area",2002,497044,6872,3643,7461,3818,3041,1431,1610,188
"19780",NA,19049,"Dallas County, IA","County or equivalent",2002,44331,1610,240,547,307,1292,78,1214,78
"19780",NA,19077,"Guthrie County, IA","County or equivalent",2002,11221,-1,0,137,137,9,3,6,-10
"19780",NA,19121,"Madison County, IA","County or equivalent",2002,14317,167,43,203,160,135,-2,137,-11
"19780",NA,19153,"Polk County, IA","County or equivalent",2002,385879,4817,3234,6093,2859,1413,1340,73,170
"19780",NA,19181,"Warren County, IA","County or equivalent",2002,41296,279,126,481,355,192,12,180,-39
"19820",NA,NA,"Detroit-Warren-Livonia, MI","Metropolitan Statistical Area",2002,4484953,7138,21125,60501,39376,-20849,13125,-33974,6862
"19820",19804,NA,"Detroit-Livonia-Dearborn, MI","Metropolitan Division",2002,2052396,-5691,9752,29857,20105,-23378,6020,-29398,7935
"19820",19804,26163,"Wayne County, MI","County or equivalent",2002,2052396,-5691,9752,29857,20105,-23378,6020,-29398,7935
"19820",47644,NA,"Warren-Troy-Farmington Hills, MI","Metropolitan Division",2002,2432557,12829,11373,30644,19271,2529,7105,-4576,-1073
"19820",47644,26087,"Lapeer County, MI","County or equivalent",2002,90277,1036,496,1078,582,610,43,567,-70
"19820",47644,26093,"Livingston County, MI","County or equivalent",2002,168102,4769,1044,2006,962,3806,157,3649,-81
"19820",47644,26099,"Macomb County, MI","County or equivalent",2002,807173,7173,2768,10062,7294,4363,1943,2420,42
"19820",47644,26125,"Oakland County, MI","County or equivalent",2002,1200284,-1046,6530,15496,8966,-6771,4876,-11647,-805
"19820",47644,26147,"St. Clair County, MI","County or equivalent",2002,166721,897,535,2002,1467,521,86,435,-159
"20020",NA,NA,"Dothan, AL","Metropolitan Statistical Area",2002,131610,354,287,1695,1408,204,64,140,-137
"20020",NA,1061,"Geneva County, AL","County or equivalent",2002,25455,-72,-37,283,320,-11,6,-17,-24
"20020",NA,1067,"Henry County, AL","County or equivalent",2002,16328,25,8,216,208,34,9,25,-17
"20020",NA,1069,"Houston County, AL","County or equivalent",2002,89827,401,316,1196,880,181,49,132,-96
"20100",NA,NA,"Dover, DE","Metropolitan Statistical Area",2002,131274,2462,772,1859,1087,1773,-42,1815,-83
"20100",NA,10001,"Kent County, DE","County or equivalent",2002,131274,2462,772,1859,1087,1773,-42,1815,-83
"20220",NA,NA,"Dubuque, IA","Metropolitan Statistical Area",2002,89205,217,302,1131,829,-75,106,-181,-10
"20220",NA,19061,"Dubuque County, IA","County or equivalent",2002,89205,217,302,1131,829,-75,106,-181,-10
"20260",NA,NA,"Duluth, MN-WI","Metropolitan Statistical Area",2002,275776,-601,-115,2833,2948,-247,105,-352,-239
"20260",NA,27017,"Carlton County, MN","County or equivalent",2002,32457,443,21,356,335,444,12,432,-22
"20260",NA,27137,"St. Louis County, MN","County or equivalent",2002,199691,-1136,-174,1997,2171,-786,68,-854,-176
"20260",NA,55031,"Douglas County, WI","County or equivalent",2002,43628,92,38,480,442,95,25,70,-41
"20500",NA,NA,"Durham, NC","Metropolitan Statistical Area",2002,441783,6553,3121,6365,3244,3687,3136,551,-255
"20500",NA,37037,"Chatham County, NC","County or equivalent",2002,54201,2557,172,663,491,2370,371,1999,15
"20500",NA,37063,"Durham County, NC","County or equivalent",2002,234331,4856,2206,3878,1672,2866,2009,857,-216
"20500",NA,37135,"Orange County, NC","County or equivalent",2002,116873,-1341,651,1336,685,-1964,739,-2703,-28
"20500",NA,37145,"Person County, NC","County or equivalent",2002,36378,481,92,488,396,415,17,398,-26
"20740",NA,NA,"Eau Claire, WI","Metropolitan Statistical Area",2002,150853,1156,607,1828,1221,681,76,605,-132
"20740",NA,55017,"Chippewa County, WI","County or equivalent",2002,56094,413,174,678,504,285,17,268,-46
"20740",NA,55035,"Eau Claire County, WI","County or equivalent",2002,94759,743,433,1150,717,396,59,337,-86
"20940",NA,NA,"El Centro, CA","Metropolitan Statistical Area",2002,144629,1452,1691,2584,893,-135,1094,-1229,-104
"20940",NA,6025,"Imperial County, CA","County or equivalent",2002,144629,1452,1691,2584,893,-135,1094,-1229,-104
"21060",NA,NA,"Elizabethtown, KY","Metropolitan Statistical Area",2002,108441,360,725,1558,833,-260,-233,-27,-105
"21060",NA,21093,"Hardin County, KY","County or equivalent",2002,95020,320,707,1402,695,-295,-234,-61,-92
"21060",NA,21123,"Larue County, KY","County or equivalent",2002,13421,40,18,156,138,35,1,34,-13
"21140",NA,NA,"Elkhart-Goshen, IN","Metropolitan Statistical Area",2002,185013,-20,1494,2996,1502,-1408,877,-2285,-106
"21140",NA,18039,"Elkhart County, IN","County or equivalent",2002,185013,-20,1494,2996,1502,-1408,877,-2285,-106
"21300",NA,NA,"Elmira, NY","Metropolitan Statistical Area",2002,90408,-263,167,1083,916,-356,43,-399,-74
"21300",NA,36015,"Chemung County, NY","County or equivalent",2002,90408,-263,167,1083,916,-356,43,-399,-74
"21340",NA,NA,"El Paso, TX","Metropolitan Statistical Area",2002,689213,4178,9825,14004,4179,-5245,4005,-9250,-402
"21340",NA,48141,"El Paso County, TX","County or equivalent",2002,689213,4178,9825,14004,4179,-5245,4005,-9250,-402
"21500",NA,NA,"Erie, PA","Metropolitan Statistical Area",2002,281847,366,602,3307,2705,-1010,397,-1407,774
"21500",NA,42049,"Erie County, PA","County or equivalent",2002,281847,366,602,3307,2705,-1010,397,-1407,774
"21660",NA,NA,"Eugene-Springfield, OR","Metropolitan Statistical Area",2002,327402,2580,579,3590,3011,2314,699,1615,-313
"21660",NA,41039,"Lane County, OR","County or equivalent",2002,327402,2580,579,3590,3011,2314,699,1615,-313
"21780",NA,NA,"Evansville, IN-KY","Metropolitan Statistical Area",2002,343746,774,747,4293,3546,368,215,153,-341
"21780",NA,18051,"Gibson County, IN","County or equivalent",2002,32584,-38,54,377,323,-57,15,-72,-35
"21780",NA,18129,"Posey County, IN","County or equivalent",2002,26918,-20,38,272,234,-33,7,-40,-25
"21780",NA,18163,"Vanderburgh County, IN","County or equivalent",2002,172173,195,307,2238,1931,63,132,-69,-175
"21780",NA,18173,"Warrick County, IN","County or equivalent",2002,53148,454,168,631,463,334,14,320,-48
"21780",NA,21101,"Henderson County, KY","County or equivalent",2002,44937,153,132,580,448,63,23,40,-42
"21780",NA,21233,"Webster County, KY","County or equivalent",2002,13986,30,48,195,147,-2,24,-26,-16
"21820",NA,NA,"Fairbanks, AK","Metropolitan Statistical Area",2002,87412,2119,1182,1492,310,-68,-308,240,1005
"21820",NA,2090,"Fairbanks North Star Borough, AK","County or equivalent",2002,87412,2119,1182,1492,310,-68,-308,240,1005
"22020",NA,NA,"Fargo, ND-MN","Metropolitan Statistical Area",2002,177445,1196,1091,2219,1128,281,350,-69,-176
"22020",NA,27027,"Clay County, MN","County or equivalent",2002,51485,115,119,504,385,49,36,13,-53
"22020",NA,38017,"Cass County, ND","County or equivalent",2002,125960,1081,972,1715,743,232,314,-82,-123
"22140",NA,NA,"Farmington, NM","Metropolitan Statistical Area",2002,118256,3128,1217,1982,765,1969,127,1842,-58
"22140",NA,35045,"San Juan County, NM","County or equivalent",2002,118256,3128,1217,1982,765,1969,127,1842,-58
"22180",NA,NA,"Fayetteville, NC","Metropolitan Statistical Area",2002,342309,4229,3721,6009,2288,766,-1820,2586,-258
"22180",NA,37051,"Cumberland County, NC","County or equivalent",2002,306601,3122,3309,5356,2047,57,-1871,1928,-244
"22180",NA,37093,"Hoke County, NC","County or equivalent",2002,35708,1107,412,653,241,709,51,658,-14
"22220",NA,NA,"Fayetteville-Springdale-Rogers, AR-MO","Metropolitan Statistical Area",2002,367526,9147,2975,5798,2823,6162,1468,4694,10
"22220",NA,5007,"Benton County, AR","County or equivalent",2002,164821,5566,1253,2509,1256,4325,502,3823,-12
"22220",NA,5087,"Madison County, AR","County or equivalent",2002,14211,-92,41,188,147,-118,17,-135,-15
"22220",NA,5143,"Washington County, AR","County or equivalent",2002,166827,3673,1519,2727,1208,2096,862,1234,58
"22220",NA,29119,"McDonald County, MO","County or equivalent",2002,21667,0,162,374,212,-141,87,-228,-21
"22380",NA,NA,"Flagstaff, AZ","Metropolitan Statistical Area",2002,120333,2562,1317,1921,604,1331,210,1121,-86
"22380",NA,4005,"Coconino County, AZ","County or equivalent",2002,120333,2562,1317,1921,604,1331,210,1121,-86
"22420",NA,NA,"Flint, MI","Metropolitan Statistical Area",2002,438685,841,2199,6226,4027,-938,175,-1113,-420
"22420",NA,26049,"Genesee County, MI","County or equivalent",2002,438685,841,2199,6226,4027,-938,175,-1113,-420
"22500",NA,NA,"Florence, SC","Metropolitan Statistical Area",2002,194683,898,741,2761,2020,345,93,252,-188
"22500",NA,45031,"Darlington County, SC","County or equivalent",2002,67697,146,245,927,682,-33,24,-57,-66
"22500",NA,45041,"Florence County, SC","County or equivalent",2002,126986,752,496,1834,1338,378,69,309,-122
"22520",NA,NA,"Florence-Muscle Shoals, AL","Metropolitan Statistical Area",2002,141443,-781,90,1595,1505,-744,54,-798,-127
"22520",NA,1033,"Colbert County, AL","County or equivalent",2002,54586,-251,62,648,586,-260,13,-273,-53
"22520",NA,1077,"Lauderdale County, AL","County or equivalent",2002,86857,-530,28,947,919,-484,41,-525,-74
"22540",NA,NA,"Fond du Lac, WI","Metropolitan Statistical Area",2002,97781,52,184,1105,921,-43,105,-148,-89
"22540",NA,55039,"Fond du Lac County, WI","County or equivalent",2002,97781,52,184,1105,921,-43,105,-148,-89
"22660",NA,NA,"Fort Collins-Loveland, CO","Metropolitan Statistical Area",2002,265632,4915,1769,3293,1524,3335,618,2717,-189
"22660",NA,8069,"Larimer County, CO","County or equivalent",2002,265632,4915,1769,3293,1524,3335,618,2717,-189
"22900",NA,NA,"Fort Smith, AR-OK","Metropolitan Statistical Area",2002,277045,1609,1375,4117,2742,494,550,-56,-260
"22900",NA,5033,"Crawford County, AR","County or equivalent",2002,54698,597,274,756,482,372,27,345,-49
"22900",NA,5047,"Franklin County, AR","County or equivalent",2002,17831,6,55,225,170,-31,11,-42,-18
"22900",NA,5131,"Sebastian County, AR","County or equivalent",2002,116775,528,709,1846,1137,-73,397,-470,-108
"22900",NA,40079,"Le Flore County, OK","County or equivalent",2002,48324,296,184,733,549,160,100,60,-48
"22900",NA,40135,"Sequoyah County, OK","County or equivalent",2002,39417,182,153,557,404,66,15,51,-37
"23020",NA,NA,"Fort Walton Beach-Crestview-Destin, FL","Metropolitan Statistical Area",2002,175832,3903,1039,2405,1366,2923,-573,3496,-59
"23020",NA,12091,"Okaloosa County, FL","County or equivalent",2002,175832,3903,1039,2405,1366,2923,-573,3496,-59
"23060",NA,NA,"Fort Wayne, IN","Metropolitan Statistical Area",2002,395846,2377,2849,6055,3206,-116,776,-892,-356
"23060",NA,18003,"Allen County, IN","County or equivalent",2002,336856,2033,2640,5310,2670,-309,763,-1072,-298
"23060",NA,18179,"Wells County, IN","County or equivalent",2002,27722,118,84,319,235,66,1,65,-32
"23060",NA,18183,"Whitley County, IN","County or equivalent",2002,31268,226,125,426,301,127,12,115,-26
"23420",NA,NA,"Fresno, CA","Metropolitan Statistical Area",2002,829729,16253,8688,14453,5765,8294,4824,3470,-729
"23420",NA,6019,"Fresno County, CA","County or equivalent",2002,829729,16253,8688,14453,5765,8294,4824,3470,-729
"23460",NA,NA,"Gadsden, AL","Metropolitan Statistical Area",2002,102749,-133,11,1310,1299,-48,84,-132,-96
"23460",NA,1055,"Etowah County, AL","County or equivalent",2002,102749,-133,11,1310,1299,-48,84,-132,-96
"23540",NA,NA,"Gainesville, FL","Metropolitan Statistical Area",2002,238725,2886,943,2647,1704,2160,819,1341,-217
"23540",NA,12001,"Alachua County, FL","County or equivalent",2002,223846,2564,890,2466,1576,1881,810,1071,-207
"23540",NA,12041,"Gilchrist County, FL","County or equivalent",2002,14879,322,53,181,128,279,9,270,-10
"23580",NA,NA,"Gainesville, GA","Metropolitan Statistical Area",2002,151624,4826,1883,2929,1046,2912,1668,1244,31
"23580",NA,13139,"Hall County, GA","County or equivalent",2002,151624,4826,1883,2929,1046,2912,1668,1244,31
"24020",NA,NA,"Glens Falls, NY","Metropolitan Statistical Area",2002,125000,347,145,1306,1161,313,37,276,-111
"24020",NA,36113,"Warren County, NY","County or equivalent",2002,63976,410,113,665,552,347,28,319,-50
"24020",NA,36115,"Washington County, NY","County or equivalent",2002,61024,-63,32,641,609,-34,9,-43,-61
"24140",NA,NA,"Goldsboro, NC","Metropolitan Statistical Area",2002,112740,-154,722,1734,1012,-784,38,-822,-92
"24140",NA,37191,"Wayne County, NC","County or equivalent",2002,112740,-154,722,1734,1012,-784,38,-822,-92
"24220",NA,NA,"Grand Forks, ND-MN","Metropolitan Statistical Area",2002,96051,-362,291,1125,834,-578,-14,-564,-75
"24220",NA,27119,"Polk County, MN","County or equivalent",2002,30813,-215,-64,313,377,-126,15,-141,-25
"24220",NA,38035,"Grand Forks County, ND","County or equivalent",2002,65238,-147,355,812,457,-452,-29,-423,-50
"24300",NA,NA,"Grand Junction, CO","Metropolitan Statistical Area",2002,122134,2850,364,1529,1165,2556,128,2428,-70
"24300",NA,8077,"Mesa County, CO","County or equivalent",2002,122134,2850,364,1529,1165,2556,128,2428,-70
"24340",NA,NA,"Grand Rapids-Wyoming, MI","Metropolitan Statistical Area",2002,755971,5892,5921,11336,5415,617,2220,-1603,-646
"24340",NA,26015,"Barry County, MI","County or equivalent",2002,57859,416,274,719,445,193,10,183,-51
"24340",NA,26067,"Ionia County, MI","County or equivalent",2002,62920,1014,398,829,431,658,23,635,-42
"24340",NA,26081,"Kent County, MI","County or equivalent",2002,586488,4344,5113,9207,4094,-265,2147,-2412,-504
"24340",NA,26123,"Newaygo County, MI","County or equivalent",2002,48704,118,136,581,445,31,40,-9,-49
"24500",NA,NA,"Great Falls, MT","Metropolitan Statistical Area",2002,80590,210,259,1047,788,-406,-161,-245,357
"24500",NA,30013,"Cascade County, MT","County or equivalent",2002,80590,210,259,1047,788,-406,-161,-245,357
"24540",NA,NA,"Greeley, CO /1","Metropolitan Statistical Area",2002,203660,10583,2205,3382,1177,8331,900,7431,47
"24540",NA,8123,"Weld County, CO /1","County or equivalent",2002,203660,10583,2205,3382,1177,8331,900,7431,47
"24580",NA,NA,"Green Bay, WI","Metropolitan Statistical Area",2002,288709,2876,1719,3877,2158,1418,490,928,-261
"24580",NA,55009,"Brown County, WI","County or equivalent",2002,232002,2519,1642,3247,1605,1092,474,618,-215
"24580",NA,55061,"Kewaunee County, WI","County or equivalent",2002,20368,110,28,228,200,98,14,84,-16
"24580",NA,55083,"Oconto County, WI","County or equivalent",2002,36339,247,49,402,353,228,2,226,-30
"24660",NA,NA,"Greensboro-High Point, NC","Metropolitan Statistical Area",2002,656502,4309,3217,8887,5670,1690,2795,-1105,-598
"24660",NA,37081,"Guilford County, NC","County or equivalent",2002,430946,2967,2435,5934,3499,923,1960,-1037,-391
"24660",NA,37151,"Randolph County, NC","County or equivalent",2002,133161,964,663,1802,1139,424,636,-212,-123
"24660",NA,37157,"Rockingham County, NC","County or equivalent",2002,92395,378,119,1151,1032,343,199,144,-84
"24780",NA,NA,"Greenville, NC","Metropolitan Statistical Area",2002,157052,2050,1060,2233,1173,1122,378,744,-132
"24780",NA,37079,"Greene County, NC","County or equivalent",2002,19355,183,94,244,150,108,89,19,-19
"24780",NA,37147,"Pitt County, NC","County or equivalent",2002,137697,1867,966,1989,1023,1014,289,725,-113
"24860",NA,NA,"Greenville-Mauldin-Easley, SC","Metropolitan Statistical Area",2002,571863,4214,2582,7575,4993,2131,1583,548,-499
"24860",NA,45045,"Greenville County, SC","County or equivalent",2002,390611,4428,2121,5471,3350,2654,1271,1383,-347
"24860",NA,45059,"Laurens County, SC","County or equivalent",2002,69699,-273,50,789,739,-265,86,-351,-58
"24860",NA,45077,"Pickens County, SC","County or equivalent",2002,111553,59,411,1315,904,-258,226,-484,-94
"25060",NA,NA,"Gulfport-Biloxi, MS","Metropolitan Statistical Area",2002,249746,1599,1254,3646,2392,558,-286,844,-213
"25060",NA,28045,"Hancock County, MS","County or equivalent",2002,44435,587,71,530,459,540,6,534,-24
"25060",NA,28047,"Harrison County, MS","County or equivalent",2002,191295,1063,1133,2914,1781,109,-292,401,-179
"25060",NA,28131,"Stone County, MS","County or equivalent",2002,14016,-51,50,202,152,-91,0,-91,-10
"25180",NA,NA,"Hagerstown-Martinsburg, MD-WV","Metropolitan Statistical Area",2002,230868,4161,715,2863,2148,3576,87,3489,-130
"25180",NA,24043,"Washington County, MD","County or equivalent",2002,134550,1568,321,1613,1292,1346,69,1277,-99
"25180",NA,54003,"Berkeley County, WV","County or equivalent",2002,81086,2513,438,1099,661,2095,9,2086,-20
"25180",NA,54065,"Morgan County, WV","County or equivalent",2002,15232,80,-44,151,195,135,9,126,-11
"25260",NA,NA,"Hanford-Corcoran, CA","Metropolitan Statistical Area",2002,134781,2279,1489,2203,714,907,367,540,-117
"25260",NA,6031,"Kings County, CA","County or equivalent",2002,134781,2279,1489,2203,714,907,367,540,-117
"25420",NA,NA,"Harrisburg-Carlisle, PA","Metropolitan Statistical Area",2002,513402,3064,1092,5895,4803,2441,683,1758,-469
"25420",NA,42041,"Cumberland County, PA","County or equivalent",2002,217181,2126,247,2221,1974,2058,246,1812,-179
"25420",NA,42043,"Dauphin County, PA","County or equivalent",2002,252418,884,724,3178,2454,406,434,-28,-246
"25420",NA,42099,"Perry County, PA","County or equivalent",2002,43803,54,121,496,375,-23,3,-26,-44
"25500",NA,NA,"Harrisonburg, VA","Metropolitan Statistical Area",2002,111116,1275,576,1365,789,764,396,368,-65
"25500",NA,51165,"Rockingham County, VA","County or equivalent",2002,69026,469,299,867,568,201,132,69,-31
"25500",NA,51660,"Harrisonburg city, VA","County or equivalent",2002,42090,806,277,498,221,563,264,299,-34
"25540",NA,NA,"Hartford-West Hartford-East Hartford, CT","Metropolitan Statistical Area",2002,1165584,8655,3868,13781,9913,5810,3600,2210,-1023
"25540",NA,9003,"Hartford County, CT","County or equivalent",2002,864543,3334,2761,10491,7730,1403,3130,-1727,-830
"25540",NA,9007,"Middlesex County, CT","County or equivalent",2002,159141,2121,498,1835,1337,1753,239,1514,-130
"25540",NA,9013,"Tolland County, CT","County or equivalent",2002,141900,3200,609,1455,846,2654,231,2423,-63
"25620",NA,NA,"Hattiesburg, MS","Metropolitan Statistical Area",2002,126654,1306,675,1852,1177,736,84,652,-105
"25620",NA,28035,"Forrest County, MS","County or equivalent",2002,73510,283,334,1079,745,22,86,-64,-73
"25620",NA,28073,"Lamar County, MS","County or equivalent",2002,40928,976,313,627,314,684,-1,685,-21
"25620",NA,28111,"Perry County, MS","County or equivalent",2002,12216,47,28,146,118,30,-1,31,-11
"25860",NA,NA,"Hickory-Lenoir-Morganton, NC","Metropolitan Statistical Area",2002,348110,1388,1446,4557,3111,23,979,-956,-81
"25860",NA,37003,"Alexander County, NC","County or equivalent",2002,34369,387,175,443,268,245,48,197,-33
"25860",NA,37023,"Burke County, NC","County or equivalent",2002,89038,-247,261,1049,788,-443,216,-659,-65
"25860",NA,37027,"Caldwell County, NC","County or equivalent",2002,78530,374,191,967,776,36,96,-60,147
"25860",NA,37035,"Catawba County, NC","County or equivalent",2002,146173,874,819,2098,1279,185,619,-434,-130
"25980",NA,NA,"Hinesville-Fort Stewart, GA","Metropolitan Statistical Area",2002,72091,1284,1255,1573,318,84,-560,644,-55
"25980",NA,13179,"Liberty County, GA","County or equivalent",2002,61525,1115,1154,1420,266,6,-570,576,-45
"25980",NA,13183,"Long County, GA","County or equivalent",2002,10566,169,101,153,52,78,10,68,-10
"26100",NA,NA,"Holland-Grand Haven, MI","Metropolitan Statistical Area",2002,246239,2801,2116,3615,1499,935,349,586,-250
"26100",NA,26139,"Ottawa County, MI","County or equivalent",2002,246239,2801,2116,3615,1499,935,349,586,-250
"26180",NA,NA,"Honolulu, HI","Metropolitan Statistical Area",2002,882278,5254,6572,12756,6184,-526,1635,-2161,-792
"26180",NA,15003,"Honolulu County, HI","County or equivalent",2002,882278,5254,6572,12756,6184,-526,1635,-2161,-792
"26300",NA,NA,"Hot Springs, AR","Metropolitan Statistical Area",2002,90124,826,-312,1018,1330,1184,63,1121,-46
"26300",NA,5051,"Garland County, AR","County or equivalent",2002,90124,826,-312,1018,1330,1184,63,1121,-46
"26380",NA,NA,"Houma-Bayou Cane-Thibodaux, LA","Metropolitan Statistical Area",2002,195564,800,1228,2798,1570,-261,108,-369,-167
"26380",NA,22057,"Lafourche Parish, LA","County or equivalent",2002,90652,612,434,1159,725,261,55,206,-83
"26380",NA,22109,"Terrebonne Parish, LA","County or equivalent",2002,104912,188,794,1639,845,-522,53,-575,-84
"26420",NA,NA,"Houston-Sugar Land-Baytown, TX","Metropolitan Statistical Area",2002,4979939,127990,54398,84835,30437,62972,38474,24498,10620
"26420",NA,48015,"Austin County, TX","County or equivalent",2002,24571,386,72,353,281,336,60,276,-22
"26420",NA,48039,"Brazoria County, TX","County or equivalent",2002,255297,6958,2389,4156,1767,4689,711,3978,-120
"26420",NA,48071,"Chambers County, TX","County or equivalent",2002,26957,406,119,334,215,306,59,247,-19
"26420",NA,48157,"Fort Bend County, TX","County or equivalent",2002,396697,21486,3769,5366,1597,17176,1872,15304,541
"26420",NA,48167,"Galveston County, TX","County or equivalent",2002,260140,5577,1507,3780,2273,4216,790,3426,-146
"26420",NA,48201,"Harris County, TX","County or equivalent",2002,3558978,75178,43240,64202,20962,21685,33550,-11865,10253
"26420",NA,48291,"Liberty County, TX","County or equivalent",2002,73281,1640,309,1037,728,1368,106,1262,-37
"26420",NA,48339,"Montgomery County, TX","County or equivalent",2002,326900,15211,2682,4840,2158,12324,1191,11133,205
"26420",NA,48407,"San Jacinto County, TX","County or equivalent",2002,23150,389,50,273,223,353,24,329,-14
"26420",NA,48473,"Waller County, TX","County or equivalent",2002,33968,759,261,494,233,519,111,408,-21
"26580",NA,NA,"Huntington-Ashland, WV-KY-OH","Metropolitan Statistical Area",2002,285944,-1054,-157,3304,3461,-630,72,-702,-267
"26580",NA,21019,"Boyd County, KY","County or equivalent",2002,49343,-137,-96,560,656,7,7,0,-48
"26580",NA,21089,"Greenup County, KY","County or equivalent",2002,36785,-112,-48,369,417,-27,0,-27,-37
"26580",NA,39087,"Lawrence County, OH","County or equivalent",2002,61866,-122,-59,711,770,-4,12,-16,-59
"26580",NA,54011,"Cabell County, WV","County or equivalent",2002,95547,-387,39,1156,1117,-343,45,-388,-83
"26580",NA,54099,"Wayne County, WV","County or equivalent",2002,42403,-296,7,508,501,-263,8,-271,-40
"26620",NA,NA,"Huntsville, AL","Metropolitan Statistical Area",2002,352843,5089,1634,4318,2684,3415,449,2966,40
"26620",NA,1083,"Limestone County, AL","County or equivalent",2002,67079,460,288,834,546,232,36,196,-60
"26620",NA,1089,"Madison County, AL","County or equivalent",2002,285764,4629,1346,3484,2138,3183,413,2770,100
"26820",NA,NA,"Idaho Falls, ID","Metropolitan Statistical Area",2002,104300,1384,1099,1852,753,392,153,239,-107
"26820",NA,16019,"Bonneville County, ID","County or equivalent",2002,84637,986,888,1511,623,189,102,87,-91
"26820",NA,16051,"Jefferson County, ID","County or equivalent",2002,19663,398,211,341,130,203,51,152,-16
"26900",NA,NA,"Indianapolis-Carmel, IN","Metropolitan Statistical Area",2002,1577489,21789,11826,24308,12482,9383,2946,6437,580
"26900",NA,18011,"Boone County, IN","County or equivalent",2002,48154,1068,202,626,424,884,15,869,-18
"26900",NA,18013,"Brown County, IN","County or equivalent",2002,15181,67,-4,151,155,83,7,76,-12
"26900",NA,18057,"Hamilton County, IN","County or equivalent",2002,207733,11474,2335,3326,991,7978,291,7687,1161
"26900",NA,18059,"Hancock County, IN","County or equivalent",2002,57978,1384,284,705,421,1126,4,1122,-26
"26900",NA,18063,"Hendricks County, IN","County or equivalent",2002,114627,4742,838,1519,681,3915,67,3848,-11
"26900",NA,18081,"Johnson County, IN","County or equivalent",2002,121854,3121,707,1698,991,2198,84,2114,216
"26900",NA,18097,"Marion County, IN","County or equivalent",2002,864352,-503,6900,14470,7570,-6800,2382,-9182,-603
"26900",NA,18109,"Morgan County, IN","County or equivalent",2002,67778,607,338,871,533,329,13,316,-60
"26900",NA,18133,"Putnam County, IN","County or equivalent",2002,36193,16,80,395,315,-28,15,-43,-36
"26900",NA,18145,"Shelby County, IN","County or equivalent",2002,43639,-187,146,547,401,-302,68,-370,-31
"26980",NA,NA,"Iowa City, IA","Metropolitan Statistical Area",2002,136527,1673,951,1738,787,568,537,31,154
"26980",NA,19103,"Johnson County, IA","County or equivalent",2002,115534,1685,871,1407,536,642,521,121,172
"26980",NA,19183,"Washington County, IA","County or equivalent",2002,20993,-12,80,331,251,-74,16,-90,-18
"27060",NA,NA,"Ithaca, NY","Metropolitan Statistical Area",2002,98418,846,291,867,576,652,692,-40,-97
"27060",NA,36109,"Tompkins County, NY","County or equivalent",2002,98418,846,291,867,576,652,692,-40,-97
"27100",NA,NA,"Jackson, MI","Metropolitan Statistical Area",2002,160802,1041,543,1989,1446,638,99,539,-140
"27100",NA,26075,"Jackson County, MI","County or equivalent",2002,160802,1041,543,1989,1446,638,99,539,-140
"27140",NA,NA,"Jackson, MS","Metropolitan Statistical Area",2002,504364,3200,3137,7524,4387,475,249,226,-412
"27140",NA,28029,"Copiah County, MS","County or equivalent",2002,28702,-129,154,425,271,-263,-5,-258,-20
"27140",NA,28049,"Hinds County, MS","County or equivalent",2002,248648,-778,1790,3852,2062,-2361,111,-2472,-207
"27140",NA,28089,"Madison County, MS","County or equivalent",2002,77981,1454,270,1203,933,1265,45,1220,-81
"27140",NA,28121,"Rankin County, MS","County or equivalent",2002,121314,2367,860,1682,822,1584,85,1499,-77
"27140",NA,28127,"Simpson County, MS","County or equivalent",2002,27719,286,63,362,299,250,13,237,-27
"27180",NA,NA,"Jackson, TN","Metropolitan Statistical Area",2002,109295,507,508,1511,1003,105,150,-45,-106
"27180",NA,47023,"Chester County, TN","County or equivalent",2002,15838,10,47,185,138,-23,2,-25,-14
"27180",NA,47113,"Madison County, TN","County or equivalent",2002,93457,497,461,1326,865,128,148,-20,-92
"27260",NA,NA,"Jacksonville, FL","Metropolitan Statistical Area",2002,1172493,24571,6412,16327,9915,18806,814,17992,-647
"27260",NA,12003,"Baker County, FL","County or equivalent",2002,23168,610,149,352,203,473,1,472,-12
"27260",NA,12019,"Clay County, FL","County or equivalent",2002,150578,5122,703,1903,1200,4454,5,4449,-35
"27260",NA,12031,"Duval County, FL","County or equivalent",2002,802487,11486,5227,12036,6809,6859,675,6184,-600
"27260",NA,12089,"Nassau County, FL","County or equivalent",2002,60454,1331,167,708,541,1188,23,1165,-24
"27260",NA,12109,"St. Johns County, FL","County or equivalent",2002,135806,6022,166,1328,1162,5832,110,5722,24
"27340",NA,NA,"Jacksonville, NC","Metropolitan Statistical Area",2002,153280,3616,2321,3087,766,1335,-1954,3289,-40
"27340",NA,37133,"Onslow County, NC","County or equivalent",2002,153280,3616,2321,3087,766,1335,-1954,3289,-40
"27500",NA,NA,"Janesville, WI","Metropolitan Statistical Area",2002,153522,366,652,1980,1328,-150,270,-420,-136
"27500",NA,55105,"Rock County, WI","County or equivalent",2002,153522,366,652,1980,1328,-150,270,-420,-136
"27620",NA,NA,"Jefferson City, MO","Metropolitan Statistical Area",2002,141939,1038,556,1786,1230,610,113,497,-128
"27620",NA,29027,"Callaway County, MO","County or equivalent",2002,41969,478,128,489,361,379,23,356,-29
"27620",NA,29051,"Cole County, MO","County or equivalent",2002,72022,422,359,934,575,138,87,51,-75
"27620",NA,29135,"Moniteau County, MO","County or equivalent",2002,14909,156,50,192,142,115,3,112,-9
"27620",NA,29151,"Osage County, MO","County or equivalent",2002,13039,-18,19,171,152,-22,0,-22,-15
"27740",NA,NA,"Johnson City, TN","Metropolitan Statistical Area",2002,183704,1628,5,2016,2011,1758,118,1640,-135
"27740",NA,47019,"Carter County, TN","County or equivalent",2002,56816,-53,-49,569,618,52,21,31,-56
"27740",NA,47171,"Unicoi County, TN","County or equivalent",2002,17611,54,-65,184,249,135,-1,136,-16
"27740",NA,47179,"Washington County, TN","County or equivalent",2002,109277,1627,119,1263,1144,1571,98,1473,-63
"27780",NA,NA,"Johnstown, PA","Metropolitan Statistical Area",2002,149833,-1135,-406,1509,1915,-598,41,-639,-131
"27780",NA,42021,"Cambria County, PA","County or equivalent",2002,149833,-1135,-406,1509,1915,-598,41,-639,-131
"27860",NA,NA,"Jonesboro, AR","Metropolitan Statistical Area",2002,109207,422,360,1515,1155,155,128,27,-93
"27860",NA,5031,"Craighead County, AR","County or equivalent",2002,83970,697,328,1161,833,445,113,332,-76
"27860",NA,5111,"Poinsett County, AR","County or equivalent",2002,25237,-275,32,354,322,-290,15,-305,-17
"27900",NA,NA,"Joplin, MO","Metropolitan Statistical Area",2002,160078,1482,809,2463,1654,814,189,625,-141
"27900",NA,29097,"Jasper County, MO","County or equivalent",2002,107023,1201,614,1734,1120,678,158,520,-91
"27900",NA,29145,"Newton County, MO","County or equivalent",2002,53055,281,195,729,534,136,31,105,-50
"28020",NA,NA,"Kalamazoo-Portage, MI","Metropolitan Statistical Area",2002,318960,2238,1631,4203,2572,911,581,330,-304
"28020",NA,26077,"Kalamazoo County, MI","County or equivalent",2002,241709,1716,1242,3131,1889,706,519,187,-232
"28020",NA,26159,"Van Buren County, MI","County or equivalent",2002,77251,522,389,1072,683,205,62,143,-72
"28100",NA,NA,"Kankakee-Bradley, IL","Metropolitan Statistical Area",2002,105396,591,440,1567,1127,-32,143,-175,183
"28100",NA,17091,"Kankakee County, IL","County or equivalent",2002,105396,591,440,1567,1127,-32,143,-175,183
"28140",NA,NA,"Kansas City, MO-KS","Metropolitan Statistical Area",2002,1885911,22204,12564,27970,15406,9853,4005,5848,-213
"28140",NA,20059,"Franklin County, KS","County or equivalent",2002,25493,348,144,375,231,116,17,99,88
"28140",NA,20091,"Johnson County, KS","County or equivalent",2002,475755,11877,4221,7078,2857,7941,1277,6664,-285
"28140",NA,20103,"Leavenworth County, KS","County or equivalent",2002,70749,951,393,935,542,607,-105,712,-49
"28140",NA,20107,"Linn County, KS","County or equivalent",2002,9672,-46,5,123,118,-42,-1,-41,-9
"28140",NA,20121,"Miami County, KS","County or equivalent",2002,28742,150,84,345,261,90,7,83,-24
"28140",NA,20209,"Wyandotte County, KS","County or equivalent",2002,157293,-972,1294,2815,1521,-2190,975,-3165,-76
"28140",NA,29013,"Bates County, MO","County or equivalent",2002,16951,177,-16,213,229,202,9,193,-9
"28140",NA,29025,"Caldwell County, MO","County or equivalent",2002,9000,13,21,131,110,0,0,0,-8
"28140",NA,29037,"Cass County, MO","County or equivalent",2002,86767,2199,413,1136,723,1829,28,1801,-43
"28140",NA,29047,"Clay County, MO","County or equivalent",2002,191190,2985,1423,2789,1366,1708,251,1457,-146
"28140",NA,29049,"Clinton County, MO","County or equivalent",2002,19584,188,28,240,212,177,1,176,-17
"28140",NA,29095,"Jackson County, MO","County or equivalent",2002,660580,2476,4031,10090,6059,-2020,1408,-3428,465
"28140",NA,29107,"Lafayette County, MO","County or equivalent",2002,32865,-4,-27,410,437,54,6,48,-31
"28140",NA,29165,"Platte County, MO","County or equivalent",2002,77789,1773,510,1014,504,1311,134,1177,-48
"28140",NA,29177,"Ray County, MO","County or equivalent",2002,23481,89,40,276,236,70,-2,72,-21
"28420",NA,NA,"Kennewick-Pasco-Richland, WA","Metropolitan Statistical Area",2002,202474,6129,2066,3363,1297,4174,1099,3075,-111
"28420",NA,53005,"Benton County, WA","County or equivalent",2002,149671,4097,1188,2188,1000,2986,511,2475,-77
"28420",NA,53021,"Franklin County, WA","County or equivalent",2002,52803,2032,878,1175,297,1188,588,600,-34
"28660",NA,NA,"Killeen-Temple-Fort Hood, TX","Metropolitan Statistical Area",2002,339953,5519,4521,6679,2158,799,-1801,2600,199
"28660",NA,48027,"Bell County, TX","County or equivalent",2002,247958,5412,3838,5466,1628,1302,-1010,2312,272
"28660",NA,48099,"Coryell County, TX","County or equivalent",2002,73320,-444,637,959,322,-1013,-802,-211,-68
"28660",NA,48281,"Lampasas County, TX","County or equivalent",2002,18675,551,46,254,208,510,11,499,-5
"28700",NA,NA,"Kingsport-Bristol-Bristol, TN-VA","Metropolitan Statistical Area",2002,298418,204,-196,3183,3379,659,127,532,-259
"28700",NA,47073,"Hawkins County, TN","County or equivalent",2002,54505,357,65,610,545,335,17,318,-43
"28700",NA,47163,"Sullivan County, TN","County or equivalent",2002,152592,181,-117,1632,1749,432,91,341,-134
"28700",NA,51169,"Scott County, VA","County or equivalent",2002,22965,-131,-65,223,288,-43,4,-47,-23
"28700",NA,51191,"Washington County, VA","County or equivalent",2002,51259,55,-8,540,548,111,10,101,-48
"28700",NA,51520,"Bristol city, VA","County or equivalent",2002,17097,-258,-71,178,249,-176,5,-181,-11
"28740",NA,NA,"Kingston, NY","Metropolitan Statistical Area",2002,179760,1448,159,1805,1646,1422,191,1231,-133
"28740",NA,36111,"Ulster County, NY","County or equivalent",2002,179760,1448,159,1805,1646,1422,191,1231,-133
"28940",NA,NA,"Knoxville, TN","Metropolitan Statistical Area",2002,632699,7497,1361,7517,6156,5034,617,4417,1102
"28940",NA,47001,"Anderson County, TN","County or equivalent",2002,71340,23,-25,795,820,115,82,33,-67
"28940",NA,47009,"Blount County, TN","County or equivalent",2002,109499,1573,108,1249,1141,1532,79,1453,-67
"28940",NA,47093,"Knox County, TN","County or equivalent",2002,392723,5011,1157,4749,3592,2573,424,2149,1281
"28940",NA,47105,"Loudon County, TN","County or equivalent",2002,40732,769,39,481,442,758,33,725,-28
"28940",NA,47173,"Union County, TN","County or equivalent",2002,18405,121,82,243,161,56,-1,57,-17
"29020",NA,NA,"Kokomo, IN","Metropolitan Statistical Area",2002,101036,-377,224,1364,1140,-519,59,-578,-82
"29020",NA,18067,"Howard County, IN","County or equivalent",2002,84587,-368,197,1181,984,-501,56,-557,-64
"29020",NA,18159,"Tipton County, IN","County or equivalent",2002,16449,-9,27,183,156,-18,3,-21,-18
"29100",NA,NA,"La Crosse, WI-MN","Metropolitan Statistical Area",2002,128192,592,358,1432,1074,359,75,284,-125
"29100",NA,27055,"Houston County, MN","County or equivalent",2002,19836,-58,45,202,157,-86,8,-94,-17
"29100",NA,55063,"La Crosse County, WI","County or equivalent",2002,108356,650,313,1230,917,445,67,378,-108
"29140",NA,NA,"Lafayette, IN","Metropolitan Statistical Area",2002,180661,511,975,2246,1271,-315,932,-1247,-149
"29140",NA,18007,"Benton County, IN","County or equivalent",2002,9132,-158,-3,86,89,-149,0,-149,-6
"29140",NA,18015,"Carroll County, IN","County or equivalent",2002,20193,-68,57,219,162,-103,22,-125,-22
"29140",NA,18157,"Tippecanoe County, IN","County or equivalent",2002,151336,737,921,1941,1020,-63,910,-973,-121
"29180",NA,NA,"Lafayette, LA","Metropolitan Statistical Area",2002,242040,2192,1860,3700,1840,567,234,333,-235
"29180",NA,22055,"Lafayette Parish, LA","County or equivalent",2002,192700,1920,1534,2986,1452,569,227,342,-183
"29180",NA,22099,"St. Martin Parish, LA","County or equivalent",2002,49340,272,326,714,388,-2,7,-9,-52
"29340",NA,NA,"Lake Charles, LA","Metropolitan Statistical Area",2002,192575,-234,1006,2806,1800,-1083,85,-1168,-157
"29340",NA,22019,"Calcasieu Parish, LA","County or equivalent",2002,182842,-134,980,2693,1713,-963,72,-1035,-151
"29340",NA,22023,"Cameron Parish, LA","County or equivalent",2002,9733,-100,26,113,87,-120,13,-133,-6
"29420",NA,NA,"Lake Havasu City-Kingman, AZ","Metropolitan Statistical Area",2002,165151,5329,-51,1981,2032,5399,314,5085,-19
"29420",NA,4015,"Mohave County, AZ","County or equivalent",2002,165151,5329,-51,1981,2032,5399,314,5085,-19
"29460",NA,NA,"Lakeland-Winter Haven, FL","Metropolitan Statistical Area",2002,498150,6900,1578,6841,5263,5651,1215,4436,-329
"29460",NA,12105,"Polk County, FL","County or equivalent",2002,498150,6900,1578,6841,5263,5651,1215,4436,-329
"29540",NA,NA,"Lancaster, PA","Metropolitan Statistical Area",2002,477927,3590,2405,6634,4229,1672,490,1182,-487
"29540",NA,42071,"Lancaster County, PA","County or equivalent",2002,477927,3590,2405,6634,4229,1672,490,1182,-487
"29620",NA,NA,"Lansing-East Lansing, MI","Metropolitan Statistical Area",2002,452917,2197,2584,5711,3127,-45,1230,-1275,-342
"29620",NA,26037,"Clinton County, MI","County or equivalent",2002,66486,967,324,808,484,688,13,675,-45
"29620",NA,26045,"Eaton County, MI","County or equivalent",2002,105429,792,458,1256,798,428,86,342,-94
"29620",NA,26065,"Ingham County, MI","County or equivalent",2002,281002,438,1802,3647,1845,-1161,1131,-2292,-203
"29700",NA,NA,"Laredo, TX","Metropolitan Statistical Area",2002,205135,5188,4913,5911,998,444,1672,-1228,-169
"29700",NA,48479,"Webb County, TX","County or equivalent",2002,205135,5188,4913,5911,998,444,1672,-1228,-169
"29740",NA,NA,"Las Cruces, NM","Metropolitan Statistical Area",2002,178574,2038,1871,3028,1157,335,731,-396,-168
"29740",NA,35013,"Dona Ana County, NM","County or equivalent",2002,178574,2038,1871,3028,1157,335,731,-396,-168
"29820",NA,NA,"Las Vegas-Paradise, NV","Metropolitan Statistical Area",2002,1514128,58135,11879,23309,11430,46717,9226,37491,-461
"29820",NA,32003,"Clark County, NV","County or equivalent",2002,1514128,58135,11879,23309,11430,46717,9226,37491,-461
"29940",NA,NA,"Lawrence, KS","Metropolitan Statistical Area",2002,104472,2147,651,1221,570,809,329,480,687
"29940",NA,20045,"Douglas County, KS","County or equivalent",2002,104472,2147,651,1221,570,809,329,480,687
"30020",NA,NA,"Lawton, OK","Metropolitan Statistical Area",2002,111993,-231,1014,1877,863,-1142,-676,-466,-103
"30020",NA,40031,"Comanche County, OK","County or equivalent",2002,111993,-231,1014,1877,863,-1142,-676,-466,-103
"30140",NA,NA,"Lebanon, PA","Metropolitan Statistical Area",2002,121309,490,145,1399,1254,462,111,351,-117
"30140",NA,42075,"Lebanon County, PA","County or equivalent",2002,121309,490,145,1399,1254,462,111,351,-117
"30300",NA,NA,"Lewiston, ID-WA","Metropolitan Statistical Area",2002,57641,165,105,700,595,123,26,97,-63
"30300",NA,16069,"Nez Perce County, ID","County or equivalent",2002,37124,118,63,462,399,97,25,72,-42
"30300",NA,53003,"Asotin County, WA","County or equivalent",2002,20517,47,42,238,196,26,1,25,-21
"30340",NA,NA,"Lewiston-Auburn, ME","Metropolitan Statistical Area",2002,104842,704,199,1244,1045,587,42,545,-82
"30340",NA,23001,"Androscoggin County, ME","County or equivalent",2002,104842,704,199,1244,1045,587,42,545,-82
"30460",NA,NA,"Lexington-Fayette, KY","Metropolitan Statistical Area",2002,416694,3089,2243,5641,3398,1179,1305,-126,-333
"30460",NA,21017,"Bourbon County, KY","County or equivalent",2002,19396,-19,25,227,202,-25,45,-70,-19
"30460",NA,21049,"Clark County, KY","County or equivalent",2002,33510,74,74,405,331,32,16,16,-32
"30460",NA,21067,"Fayette County, KY","County or equivalent",2002,264253,1065,1515,3608,2093,-234,1109,-1343,-216
"30460",NA,21113,"Jessamine County, KY","County or equivalent",2002,40624,885,200,543,343,712,37,675,-27
"30460",NA,21209,"Scott County, KY","County or equivalent",2002,35487,999,326,553,227,691,39,652,-18
"30460",NA,21239,"Woodford County, KY","County or equivalent",2002,23424,85,103,305,202,3,59,-56,-21
"30620",NA,NA,"Lima, OH","Metropolitan Statistical Area",2002,107847,-349,359,1469,1110,-623,29,-652,-85
"30620",NA,39003,"Allen County, OH","County or equivalent",2002,107847,-349,359,1469,1110,-623,29,-652,-85
"30700",NA,NA,"Lincoln, NE","Metropolitan Statistical Area",2002,274577,3609,2021,3898,1877,1826,920,906,-238
"30700",NA,31109,"Lancaster County, NE","County or equivalent",2002,257984,3641,1991,3718,1727,1874,914,960,-224
"30700",NA,31159,"Seward County, NE","County or equivalent",2002,16593,-32,30,180,150,-48,6,-54,-14
"30780",NA,NA,"Little Rock-North Little Rock-Conway, AR","Metropolitan Statistical Area",2002,622862,5538,3599,8921,5322,2113,329,1784,-174
"30780",NA,5045,"Faulkner County, AR","County or equivalent",2002,90365,1669,620,1277,657,1073,87,986,-24
"30780",NA,5053,"Grant County, AR","County or equivalent",2002,16658,30,23,185,162,24,2,22,-17
"30780",NA,5085,"Lonoke County, AR","County or equivalent",2002,54975,1066,270,706,436,849,-25,874,-53
"30780",NA,5105,"Perry County, AR","County or equivalent",2002,10339,38,13,133,120,34,-1,35,-9
"30780",NA,5119,"Pulaski County, AR","County or equivalent",2002,364767,1744,2374,5607,3233,-628,235,-863,-2
"30780",NA,5125,"Saline County, AR","County or equivalent",2002,85758,991,299,1013,714,761,31,730,-69
"30860",NA,NA,"Logan, UT-ID","Metropolitan Statistical Area",2002,108924,3694,2013,2504,491,879,400,479,802
"30860",NA,16041,"Franklin County, ID","County or equivalent",2002,11662,210,159,249,90,63,25,38,-12
"30860",NA,49005,"Cache County, UT","County or equivalent",2002,97262,3484,1854,2255,401,816,375,441,814
"30980",NA,NA,"Longview, TX","Metropolitan Statistical Area",2002,196310,1688,769,2940,2171,1093,407,686,-174
"30980",NA,48183,"Gregg County, TX","County or equivalent",2002,112390,766,653,1853,1200,221,269,-48,-108
"30980",NA,48401,"Rusk County, TX","County or equivalent",2002,47378,19,0,574,574,71,113,-42,-52
"30980",NA,48459,"Upshur County, TX","County or equivalent",2002,36542,903,116,513,397,801,25,776,-14
"31020",NA,NA,"Longview, WA","Metropolitan Statistical Area",2002,94270,672,326,1253,927,442,138,304,-96
"31020",NA,53015,"Cowlitz County, WA","County or equivalent",2002,94270,672,326,1253,927,442,138,304,-96
"31100",NA,NA,"Los Angeles-Long Beach-Santa Ana, CA","Metropolitan Statistical Area",2002,12655506,118908,119960,196949,76989,8215,117720,-109505,-9267
"31100",31084,NA,"Los Angeles-Long Beach-Glendale, CA","Metropolitan Division",2002,9733679,90612,91646,151917,60271,6096,92093,-85997,-7130
"31100",31084,6037,"Los Angeles County, CA","County or equivalent",2002,9733679,90612,91646,151917,60271,6096,92093,-85997,-7130
"31100",42044,NA,"Santa Ana-Anaheim-Irvine, CA","Metropolitan Division",2002,2921827,28296,28314,45032,16718,2119,25627,-23508,-2137
"31100",42044,6059,"Orange County, CA","County or equivalent",2002,2921827,28296,28314,45032,16718,2119,25627,-23508,-2137
"31140",NA,NA,"Louisville/Jefferson County, KY-IN","Metropolitan Statistical Area",2002,1179540,7455,4703,15808,11105,3142,1634,1508,-390
"31140",NA,18019,"Clark County, IN","County or equivalent",2002,97828,654,295,1292,997,463,89,374,-104
"31140",NA,18043,"Floyd County, IN","County or equivalent",2002,71400,-40,189,870,681,-165,14,-179,-64
"31140",NA,18061,"Harrison County, IN","County or equivalent",2002,35043,379,135,444,309,273,15,258,-29
"31140",NA,18175,"Washington County, IN","County or equivalent",2002,27582,136,79,358,279,82,3,79,-25
"31140",NA,21029,"Bullitt County, KY","County or equivalent",2002,64812,1615,367,736,369,706,-8,714,542
"31140",NA,21103,"Henry County, KY","County or equivalent",2002,15248,32,34,195,161,13,16,-3,-15
"31140",NA,21111,"Jefferson County, KY","County or equivalent",2002,695948,982,2682,9835,7153,-1091,1366,-2457,-609
"31140",NA,21163,"Meade County, KY","County or equivalent",2002,27190,400,121,299,178,294,-40,334,-15
"31140",NA,21179,"Nelson County, KY","County or equivalent",2002,38797,603,219,521,302,417,31,386,-33
"31140",NA,21185,"Oldham County, KY","County or equivalent",2002,48951,1114,265,511,246,869,24,845,-20
"31140",NA,21211,"Shelby County, KY","County or equivalent",2002,34802,738,212,477,265,547,120,427,-21
"31140",NA,21215,"Spencer County, KY","County or equivalent",2002,13394,707,81,176,95,618,3,615,8
"31140",NA,21223,"Trimble County, KY","County or equivalent",2002,8545,135,24,94,70,116,1,115,-5
"31180",NA,NA,"Lubbock, TX","Metropolitan Statistical Area",2002,255677,2314,1934,4062,2128,463,274,189,-83
"31180",NA,48107,"Crosby County, TX","County or equivalent",2002,6860,-103,16,92,76,-114,6,-120,-5
"31180",NA,48303,"Lubbock County, TX","County or equivalent",2002,248817,2417,1918,3970,2052,577,268,309,-78
"31340",NA,NA,"Lynchburg, VA","Metropolitan Statistical Area",2002,229432,309,239,2546,2307,290,196,94,-220
"31340",NA,51009,"Amherst County, VA","County or equivalent",2002,31759,-216,-22,305,327,-162,17,-179,-32
"31340",NA,51011,"Appomattox County, VA","County or equivalent",2002,13667,-110,27,155,128,-125,10,-135,-12
"31340",NA,51019,"Bedford County, VA","County or equivalent",2002,61356,378,86,576,490,343,26,317,-51
"31340",NA,51031,"Campbell County, VA","County or equivalent",2002,51403,154,120,580,460,83,19,64,-49
"31340",NA,51515,"Bedford city, VA","County or equivalent",2002,6287,-45,-34,66,100,-4,-2,-2,-7
"31340",NA,51680,"Lynchburg city, VA","County or equivalent",2002,64960,148,62,864,802,155,126,29,-69
"31420",NA,NA,"Macon, GA","Metropolitan Statistical Area",2002,224398,1627,1019,3272,2253,789,165,624,-181
"31420",NA,13021,"Bibb County, GA","County or equivalent",2002,153965,347,777,2416,1639,-292,141,-433,-138
"31420",NA,13079,"Crawford County, GA","County or equivalent",2002,12448,2,11,137,126,3,1,2,-12
"31420",NA,13169,"Jones County, GA","County or equivalent",2002,24677,517,152,331,179,379,10,369,-14
"31420",NA,13207,"Monroe County, GA","County or equivalent",2002,22584,571,64,260,196,518,15,503,-11
"31420",NA,13289,"Twiggs County, GA","County or equivalent",2002,10724,190,15,128,113,181,-2,183,-6
"31460",NA,NA,"Madera, CA","Metropolitan Statistical Area",2002,127949,2475,1194,2134,940,1391,849,542,-110
"31460",NA,6039,"Madera County, CA","County or equivalent",2002,127949,2475,1194,2134,940,1391,849,542,-110
"31540",NA,NA,"Madison, WI","Metropolitan Statistical Area",2002,519439,7730,3161,6541,3380,4984,1782,3202,-415
"31540",NA,55021,"Columbia County, WI","County or equivalent",2002,53148,165,123,655,532,91,22,69,-49
"31540",NA,55025,"Dane County, WI","County or equivalent",2002,443289,7482,2919,5573,2654,4904,1760,3144,-341
"31540",NA,55049,"Iowa County, WI","County or equivalent",2002,23002,83,119,313,194,-11,0,-11,-25
"31700",NA,NA,"Manchester-Nashua, NH","Metropolitan Statistical Area",2002,390682,2618,2255,5006,2751,734,1195,-461,-371
"31700",NA,33011,"Hillsborough County, NH","County or equivalent",2002,390682,2618,2255,5006,2751,734,1195,-461,-371
"31900",NA,NA,"Mansfield, OH","Metropolitan Statistical Area",2002,128059,53,317,1546,1229,-145,41,-186,-119
"31900",NA,39139,"Richland County, OH","County or equivalent",2002,128059,53,317,1546,1229,-145,41,-186,-119
"32580",NA,NA,"McAllen-Edinburg-Mission, TX","Metropolitan Statistical Area",2002,608006,19170,12128,15201,3073,7575,4847,2728,-533
"32580",NA,48215,"Hidalgo County, TX","County or equivalent",2002,608006,19170,12128,15201,3073,7575,4847,2728,-533
"32780",NA,NA,"Medford, OR","Metropolitan Statistical Area",2002,186592,2795,219,2106,1887,2711,254,2457,-135
"32780",NA,41029,"Jackson County, OR","County or equivalent",2002,186592,2795,219,2106,1887,2711,254,2457,-135
"32820",NA,NA,"Memphis, TN-MS-AR","Metropolitan Statistical Area",2002,1223516,8474,8490,19187,10697,849,1783,-934,-865
"32820",NA,5035,"Crittenden County, AR","County or equivalent",2002,51146,-77,374,912,538,-489,30,-519,38
"32820",NA,28033,"DeSoto County, MS","County or equivalent",2002,118294,5048,973,1795,822,4088,116,3972,-13
"32820",NA,28093,"Marshall County, MS","County or equivalent",2002,35258,214,191,520,329,56,6,50,-33
"32820",NA,28137,"Tate County, MS","County or equivalent",2002,25501,-4,122,373,251,-99,-1,-98,-27
"32820",NA,28143,"Tunica County, MS","County or equivalent",2002,9718,360,78,196,118,283,6,277,-1
"32820",NA,47047,"Fayette County, TN","County or equivalent",2002,31019,827,85,385,300,747,7,740,-5
"32820",NA,47157,"Shelby County, TN","County or equivalent",2002,899529,1566,6414,14272,7858,-4067,1619,-5686,-781
"32820",NA,47167,"Tipton County, TN","County or equivalent",2002,53051,540,253,734,481,330,0,330,-43
"32900",NA,NA,"Merced, CA","Metropolitan Statistical Area",2002,223296,5839,2546,3993,1447,3445,1307,2138,-152
"32900",NA,6047,"Merced County, CA","County or equivalent",2002,223296,5839,2546,3993,1447,3445,1307,2138,-152
"33100",NA,NA,"Miami-Fort Lauderdale-Pompano Beach, FL","Metropolitan Statistical Area",2002,5188731,80147,20291,68410,48119,58679,60445,-1766,1177
"33100",22744,NA,"Fort Lauderdale-Pompano Beach-Deerfield Beach, FL","Metropolitan Division",2002,1698537,30372,6087,22207,16120,24270,14965,9305,15
"33100",22744,12011,"Broward County, FL","County or equivalent",2002,1698537,30372,6087,22207,16120,24270,14965,9305,15
"33100",33124,NA,"Miami-Miami Beach-Kendall, FL","Metropolitan Division",2002,2307071,23137,13736,32366,18630,7548,38016,-30468,1853
"33100",33124,12086,"Miami-Dade County, FL","County or equivalent",2002,2307071,23137,13736,32366,18630,7548,38016,-30468,1853
"33100",48424,NA,"West Palm Beach-Boca Raton-Boynton Beach, FL","Metropolitan Division",2002,1183123,26638,468,13837,13369,26861,7464,19397,-691
"33100",48424,12099,"Palm Beach County, FL","County or equivalent",2002,1183123,26638,468,13837,13369,26861,7464,19397,-691
"33140",NA,NA,"Michigan City-La Porte, IN","Metropolitan Statistical Area",2002,109424,-625,373,1386,1013,-915,89,-1004,-83
"33140",NA,18091,"LaPorte County, IN","County or equivalent",2002,109424,-625,373,1386,1013,-915,89,-1004,-83
"33260",NA,NA,"Midland, TX","Metropolitan Statistical Area",2002,116936,1173,883,1830,947,399,176,223,-109
"33260",NA,48329,"Midland County, TX","County or equivalent",2002,116936,1173,883,1830,947,399,176,223,-109
"33340",NA,NA,"Milwaukee-Waukesha-West Allis, WI","Metropolitan Statistical Area",2002,1519318,8499,8150,21266,13116,-3805,3334,-7139,4154
"33340",NA,55079,"Milwaukee County, WI","County or equivalent",2002,946707,2958,5616,14563,8947,-7345,2857,-10202,4687
"33340",NA,55089,"Ozaukee County, WI","County or equivalent",2002,83553,583,322,920,598,351,76,275,-90
"33340",NA,55131,"Washington County, WI","County or equivalent",2002,120517,1208,690,1505,815,621,73,548,-103
"33340",NA,55133,"Waukesha County, WI","County or equivalent",2002,368541,3750,1522,4278,2756,2568,328,2240,-340
"33460",NA,NA,"Minneapolis-St. Paul-Bloomington, MN-WI","Metropolitan Statistical Area",2002,3052620,28874,24632,43783,19151,5856,10457,-4601,-1614
"33460",NA,27003,"Anoka County, MN","County or equivalent",2002,308876,3979,2811,4281,1470,1457,417,1040,-289
"33460",NA,27019,"Carver County, MN","County or equivalent",2002,75653,2560,900,1171,271,1692,142,1550,-32
"33460",NA,27025,"Chisago County, MN","County or equivalent",2002,44728,1634,424,735,311,1222,4,1218,-12
"33460",NA,27037,"Dakota County, MN","County or equivalent",2002,368028,4519,3409,5142,1733,1483,678,805,-373
"33460",NA,27053,"Hennepin County, MN","County or equivalent",2002,1123026,-1831,8064,16072,8008,-9249,6472,-15721,-646
"33460",NA,27059,"Isanti County, MN","County or equivalent",2002,33754,1130,168,418,250,966,11,955,-4
"33460",NA,27123,"Ramsey County, MN","County or equivalent",2002,510563,-2419,3257,7258,4001,-5428,2268,-7696,-248
"33460",NA,27139,"Scott County, MN","County or equivalent",2002,103160,5968,1423,1836,413,4511,152,4359,34
"33460",NA,27141,"Sherburne County, MN","County or equivalent",2002,71980,3721,762,1152,390,2759,21,2738,200
"33460",NA,27163,"Washington County, MN","County or equivalent",2002,209170,2537,1746,2801,1055,992,217,775,-201
"33460",NA,27171,"Wright County, MN","County or equivalent",2002,98076,4334,1018,1580,562,3313,42,3271,3
"33460",NA,55093,"Pierce County, WI","County or equivalent",2002,37478,264,155,397,242,143,8,135,-34
"33460",NA,55109,"St. Croix County, WI","County or equivalent",2002,68128,2478,495,940,445,1995,25,1970,-12
"33540",NA,NA,"Missoula, MT","Metropolitan Statistical Area",2002,98925,1527,461,1127,666,1132,78,1054,-66
"33540",NA,30063,"Missoula County, MT","County or equivalent",2002,98925,1527,461,1127,666,1132,78,1054,-66
"33660",NA,NA,"Mobile, AL","Metropolitan Statistical Area",2002,398228,-1769,2046,5963,3917,-3550,404,-3954,-265
"33660",NA,1097,"Mobile County, AL","County or equivalent",2002,398228,-1769,2046,5963,3917,-3550,404,-3954,-265
"33700",NA,NA,"Modesto, CA","Metropolitan Statistical Area",2002,477538,13598,4118,7790,3672,9712,2138,7574,-232
"33700",NA,6099,"Stanislaus County, CA","County or equivalent",2002,477538,13598,4118,7790,3672,9712,2138,7574,-232
"33740",NA,NA,"Monroe, LA","Metropolitan Statistical Area",2002,169970,566,974,2551,1577,-246,54,-300,-162
"33740",NA,22073,"Ouachita Parish, LA","County or equivalent",2002,147326,727,888,2235,1347,-15,37,-52,-146
"33740",NA,22111,"Union Parish, LA","County or equivalent",2002,22644,-161,86,316,230,-231,17,-248,-16
"33780",NA,NA,"Monroe, MI","Metropolitan Statistical Area",2002,148566,935,463,1666,1203,612,102,510,-140
"33780",NA,26115,"Monroe County, MI","County or equivalent",2002,148566,935,463,1666,1203,612,102,510,-140
"33860",NA,NA,"Montgomery, AL","Metropolitan Statistical Area",2002,350341,2005,1987,5090,3103,292,-38,330,-274
"33860",NA,1001,"Autauga County, AL","County or equivalent",2002,45160,723,226,593,367,525,-24,549,-28
"33860",NA,1051,"Elmore County, AL","County or equivalent",2002,68826,1256,406,897,491,887,-23,910,-37
"33860",NA,1085,"Lowndes County, AL","County or equivalent",2002,13460,8,58,209,151,-38,-1,-37,-12
"33860",NA,1101,"Montgomery County, AL","County or equivalent",2002,222895,18,1297,3391,2094,-1082,10,-1092,-197
"34060",NA,NA,"Morgantown, WV","Metropolitan Statistical Area",2002,112780,840,187,1144,957,750,224,526,-97
"34060",NA,54061,"Monongalia County, WV","County or equivalent",2002,83349,582,178,816,638,480,223,257,-76
"34060",NA,54077,"Preston County, WV","County or equivalent",2002,29431,258,9,328,319,270,1,269,-21
"34100",NA,NA,"Morristown, TN","Metropolitan Statistical Area",2002,125140,389,290,1597,1307,183,381,-198,-84
"34100",NA,47057,"Grainger County, TN","County or equivalent",2002,21079,248,33,265,232,228,17,211,-13
"34100",NA,47063,"Hamblen County, TN","County or equivalent",2002,58337,-423,167,807,640,-555,312,-867,-35
"34100",NA,47089,"Jefferson County, TN","County or equivalent",2002,45724,564,90,525,435,510,52,458,-36
"34580",NA,NA,"Mount Vernon-Anacortes, WA","Metropolitan Statistical Area",2002,106126,1298,438,1400,962,956,365,591,-96
"34580",NA,53057,"Skagit County, WA","County or equivalent",2002,106126,1298,438,1400,962,956,365,591,-96
"34620",NA,NA,"Muncie, IN","Metropolitan Statistical Area",2002,119355,-632,191,1320,1129,-723,123,-846,-100
"34620",NA,18035,"Delaware County, IN","County or equivalent",2002,119355,-632,191,1320,1129,-723,123,-846,-100
"34740",NA,NA,"Muskegon-Norton Shores, MI","Metropolitan Statistical Area",2002,171803,564,719,2327,1608,9,106,-97,-164
"34740",NA,26121,"Muskegon County, MI","County or equivalent",2002,171803,564,719,2327,1608,9,106,-97,-164
"34820",NA,NA,"Myrtle Beach-North Myrtle Beach-Conway, SC","Metropolitan Statistical Area",2002,206110,4277,687,2596,1909,3690,408,3282,-100
"34820",NA,45051,"Horry County, SC","County or equivalent",2002,206110,4277,687,2596,1909,3690,408,3282,-100
"34900",NA,NA,"Napa, CA","Metropolitan Statistical Area",2002,128639,1886,300,1581,1281,1681,810,871,-95
"34900",NA,6055,"Napa County, CA","County or equivalent",2002,128639,1886,300,1581,1281,1681,810,871,-95
"34940",NA,NA,"Naples-Marco Island, FL","Metropolitan Statistical Area",2002,275034,10938,1176,3586,2410,9798,2344,7454,-36
"34940",NA,12021,"Collier County, FL","County or equivalent",2002,275034,10938,1176,3586,2410,9798,2344,7454,-36
"34980",NA,NA,"Nashville-Davidson--Murfreesboro--Franklin, TN","Metropolitan Statistical Area",2002,1363831,20429,8726,19463,10737,7767,3603,4164,3936
"34980",NA,47015,"Cannon County, TN","County or equivalent",2002,12966,-22,17,153,136,-28,7,-35,-11
"34980",NA,47021,"Cheatham County, TN","County or equivalent",2002,36935,386,210,489,279,209,7,202,-33
"34980",NA,47037,"Davidson County, TN","County or equivalent",2002,582346,3514,3735,8798,5063,-4606,2646,-7252,4385
"34980",NA,47043,"Dickson County, TN","County or equivalent",2002,44330,469,223,653,430,282,7,275,-36
"34980",NA,47081,"Hickman County, TN","County or equivalent",2002,23053,349,55,280,225,306,0,306,-12
"34980",NA,47111,"Macon County, TN","County or equivalent",2002,20762,-46,27,259,232,-55,33,-88,-18
"34980",NA,47147,"Robertson County, TN","County or equivalent",2002,56905,962,420,863,443,582,126,456,-40
"34980",NA,47149,"Rutherford County, TN","County or equivalent",2002,195939,6313,1800,2957,1157,4594,324,4270,-81
"34980",NA,47159,"Smith County, TN","County or equivalent",2002,18090,132,32,205,173,115,7,108,-15
"34980",NA,47165,"Sumner County, TN","County or equivalent",2002,135980,2370,695,1786,1091,1767,160,1607,-92
"34980",NA,47169,"Trousdale County, TN","County or equivalent",2002,7285,-2,2,84,82,3,11,-8,-7
"34980",NA,47187,"Williamson County, TN","County or equivalent",2002,136234,4040,996,1682,686,3096,229,2867,-52
"34980",NA,47189,"Wilson County, TN","County or equivalent",2002,93006,1964,514,1254,740,1502,46,1456,-52
"35300",NA,NA,"New Haven-Milford, CT","Metropolitan Statistical Area",2002,832371,3930,2318,10107,7789,2447,2856,-409,-835
"35300",NA,9009,"New Haven County, CT","County or equivalent",2002,832371,3930,2318,10107,7789,2447,2856,-409,-835
"35380",NA,NA,"New Orleans-Metairie-Kenner, LA","Metropolitan Statistical Area",2002,1310879,0,6527,18755,12228,-6345,1279,-7624,-182
"35380",NA,22051,"Jefferson Parish, LA","County or equivalent",2002,451213,-768,2050,6234,4184,-2800,745,-3545,-18
"35380",NA,22071,"Orleans Parish, LA","County or equivalent",2002,472556,-5279,2207,7192,4985,-7539,404,-7943,53
"35380",NA,22075,"Plaquemines Parish, LA","County or equivalent",2002,27123,270,182,394,212,112,-18,130,-24
"35380",NA,22087,"St. Bernard Parish, LA","County or equivalent",2002,66255,-285,127,855,728,-409,11,-420,-3
"35380",NA,22089,"St. Charles Parish, LA","County or equivalent",2002,48959,549,354,658,304,236,45,191,-41
"35380",NA,22095,"St. John the Baptist Parish, LA","County or equivalent",2002,43940,373,374,681,307,44,22,22,-45
"35380",NA,22103,"St. Tammany Parish, LA","County or equivalent",2002,200833,5140,1233,2741,1508,4011,70,3941,-104
"35620",NA,NA,"New York-Northern New Jersey-Long Island, NY-NJ-PA","Metropolitan Statistical Area",2002,18593272,102215,110538,258412,147874,-50328,157472,-207800,42005
"35620",20764,NA,"Edison-New Brunswick, NJ","Metropolitan Division",2002,2240482,29892,9063,29342,20279,19638,12542,7096,1191
"35620",20764,34023,"Middlesex County, NJ","County or equivalent",2002,766790,6237,4792,10367,5575,2082,7948,-5866,-637
"35620",20764,34025,"Monmouth County, NJ","County or equivalent",2002,630543,6581,2182,7789,5607,2433,1824,609,1966
"35620",20764,34029,"Ocean County, NJ","County or equivalent",2002,536602,12927,-260,6798,7058,13021,643,12378,166
"35620",20764,34035,"Somerset County, NJ","County or equivalent",2002,306547,4147,2349,4388,2039,2102,2127,-25,-304
"35620",35004,NA,"Nassau-Suffolk, NY","Metropolitan Division",2002,2817494,26118,12888,36014,23126,111,9008,-8897,13119
"35620",35004,36059,"Nassau County, NY","County or equivalent",2002,1349605,7035,4502,16034,11532,-3327,4729,-8056,5860
"35620",35004,36103,"Suffolk County, NY","County or equivalent",2002,1467889,19083,8386,19980,11594,3438,4279,-841,7259
"35620",35084,NA,"Newark-Union, NJ-PA","Metropolitan Division",2002,2120282,9370,11714,29200,17486,-679,13563,-14242,-1665
"35620",35084,34013,"Essex County, NJ","County or equivalent",2002,793280,42,4838,12054,7216,-4190,6089,-10279,-606
"35620",35084,34019,"Hunterdon County, NJ","County or equivalent",2002,126144,1525,665,1463,798,964,231,733,-104
"35620",35084,34027,"Morris County, NJ","County or equivalent",2002,476692,3411,2800,6252,3452,1033,2671,-1638,-422
"35620",35084,34037,"Sussex County, NJ","County or equivalent",2002,147891,1845,690,1669,979,1280,149,1131,-125
"35620",35084,34039,"Union County, NJ","County or equivalent",2002,526549,854,2694,7369,4675,-1425,4401,-5826,-415
"35620",35084,42103,"Pike County, PA","County or equivalent",2002,49726,1693,27,393,366,1659,22,1637,7
"35620",35644,NA,"New York-White Plains-Wayne, NY-NJ","Metropolitan Division",2002,11415014,36835,76873,163856,86983,-69398,122359,-191757,29360
"35620",35644,34003,"Bergen County, NJ","County or equivalent",2002,890457,1582,2517,10199,7682,-168,7136,-7304,-767
"35620",35644,34017,"Hudson County, NJ","County or equivalent",2002,608623,-4224,3700,8412,4712,-7724,8959,-16683,-200
"35620",35644,34031,"Passaic County, NJ","County or equivalent",2002,493537,705,3606,7655,4049,-2590,4324,-6914,-311
"35620",35644,36005,"Bronx County, NY","County or equivalent",2002,1350114,7932,12491,22925,10434,-4627,12642,-17269,68
"35620",35644,36047,"Kings County, NY","County or equivalent",2002,2477362,5803,21377,39806,18429,-23581,29277,-52858,8007
"35620",35644,36061,"New York County, NY","County or equivalent",2002,1565477,4205,8255,19939,11684,-6813,16336,-23149,2763
"35620",35644,36079,"Putnam County, NY","County or equivalent",2002,98187,1192,626,1218,592,652,235,417,-86
"35620",35644,36081,"Queens County, NY","County or equivalent",2002,2239553,4685,14601,30735,16134,-24797,33240,-58037,14881
"35620",35644,36085,"Richmond County, NY","County or equivalent",2002,460133,7079,1992,5726,3734,2589,1876,713,2498
"35620",35644,36087,"Rockland County, NY","County or equivalent",2002,290200,1544,2366,4464,2098,-808,1475,-2283,-14
"35620",35644,36119,"Westchester County, NY","County or equivalent",2002,941371,6332,5342,12777,7435,-1531,6859,-8390,2521
"35660",NA,NA,"Niles-Benton Harbor, MI","Metropolitan Statistical Area",2002,161449,-181,458,2036,1578,-503,355,-858,-136
"35660",NA,26021,"Berrien County, MI","County or equivalent",2002,161449,-181,458,2036,1578,-503,355,-858,-136
"35980",NA,NA,"Norwich-New London, CT","Metropolitan Statistical Area",2002,262945,2044,1038,3157,2119,1230,-6,1236,-224
"35980",NA,9011,"New London County, CT","County or equivalent",2002,262945,2044,1038,3157,2119,1230,-6,1236,-224
"36100",NA,NA,"Ocala, FL","Metropolitan Statistical Area",2002,271188,6816,-558,3010,3568,7410,343,7067,-36
"36100",NA,12083,"Marion County, FL","County or equivalent",2002,271188,6816,-558,3010,3568,7410,343,7067,-36
"36140",NA,NA,"Ocean City, NJ","Metropolitan Statistical Area",2002,101415,-446,-322,1054,1376,-31,20,-51,-93
"36140",NA,34009,"Cape May County, NJ","County or equivalent",2002,101415,-446,-322,1054,1376,-31,20,-51,-93
"36220",NA,NA,"Odessa, TX","Metropolitan Statistical Area",2002,121802,1206,1195,2229,1034,131,211,-80,-120
"36220",NA,48135,"Ector County, TX","County or equivalent",2002,121802,1206,1195,2229,1034,131,211,-80,-120
"36260",NA,NA,"Ogden-Clearfield, UT","Metropolitan Statistical Area",2002,461758,9046,6467,9122,2655,1719,648,1071,860
"36260",NA,49011,"Davis County, UT","County or equivalent",2002,249765,5237,3849,5042,1193,1081,62,1019,307
"36260",NA,49029,"Morgan County, UT","County or equivalent",2002,7403,113,60,91,31,59,2,57,-6
"36260",NA,49057,"Weber County, UT","County or equivalent",2002,204590,3696,2558,3989,1431,579,584,-5,559
"36420",NA,NA,"Oklahoma City, OK","Metropolitan Statistical Area",2002,1119841,12318,7069,16793,9724,6253,2578,3675,-1004
"36420",NA,40017,"Canadian County, OK","County or equivalent",2002,90663,1161,470,1121,651,758,77,681,-67
"36420",NA,40027,"Cleveland County, OK","County or equivalent",2002,215586,3126,1248,2548,1300,2036,343,1693,-158
"36420",NA,40051,"Grady County, OK","County or equivalent",2002,46631,782,160,603,443,645,6,639,-23
"36420",NA,40081,"Lincoln County, OK","County or equivalent",2002,32095,7,85,415,330,-42,4,-46,-36
"36420",NA,40083,"Logan County, OK","County or equivalent",2002,34704,185,100,410,310,117,10,107,-32
"36420",NA,40087,"McClain County, OK","County or equivalent",2002,28002,224,122,371,249,128,25,103,-26
"36420",NA,40109,"Oklahoma County, OK","County or equivalent",2002,672160,6833,4884,11325,6441,2611,2113,498,-662
"36500",NA,NA,"Olympia, WA","Metropolitan Statistical Area",2002,216549,4040,749,2384,1635,3445,211,3234,-154
"36500",NA,53067,"Thurston County, WA","County or equivalent",2002,216549,4040,749,2384,1635,3445,211,3234,-154
"36540",NA,NA,"Omaha-Council Bluffs, NE-IA","Metropolitan Statistical Area",2002,782158,6902,6275,12354,6079,1316,1384,-68,-689
"36540",NA,19085,"Harrison County, IA","County or equivalent",2002,15499,-140,-78,152,230,-48,5,-53,-14
"36540",NA,19129,"Mills County, IA","County or equivalent",2002,14535,53,46,174,128,21,3,18,-14
"36540",NA,19155,"Pottawattamie County, IA","County or equivalent",2002,87933,271,346,1202,856,11,48,-37,-86
"36540",NA,31025,"Cass County, NE","County or equivalent",2002,24708,183,111,350,239,98,-1,99,-26
"36540",NA,31055,"Douglas County, NE","County or equivalent",2002,471445,3517,4033,7705,3672,-89,1501,-1590,-427
"36540",NA,31153,"Sarpy County, NE","County or equivalent",2002,129033,3016,1689,2297,608,1410,-199,1609,-83
"36540",NA,31155,"Saunders County, NE","County or equivalent",2002,19830,-86,46,238,192,-113,9,-122,-19
"36540",NA,31177,"Washington County, NE","County or equivalent",2002,19175,88,82,236,154,26,18,8,-20
"36740",NA,NA,"Orlando-Kissimmee, FL","Metropolitan Statistical Area",2002,1755472,47343,10516,24099,13583,36425,9327,27098,402
"36740",NA,12069,"Lake County, FL","County or equivalent",2002,234399,10526,-504,2535,3039,11055,359,10696,-25
"36740",NA,12095,"Orange County, FL","County or equivalent",2002,946230,18839,7892,14337,6445,11702,6166,5536,-755
"36740",NA,12097,"Osceola County, FL","County or equivalent",2002,193720,10465,1364,2786,1422,7681,1529,6152,1420
"36740",NA,12117,"Seminole County, FL","County or equivalent",2002,381123,7513,1764,4441,2677,5987,1273,4714,-238
"36780",NA,NA,"Oshkosh-Neenah, WI","Metropolitan Statistical Area",2002,158372,610,569,1827,1258,198,179,19,-157
"36780",NA,55139,"Winnebago County, WI","County or equivalent",2002,158372,610,569,1827,1258,198,179,19,-157
"36980",NA,NA,"Owensboro, KY","Metropolitan Statistical Area",2002,109951,98,457,1579,1122,-266,43,-309,-93
"36980",NA,21059,"Daviess County, KY","County or equivalent",2002,91578,8,401,1329,928,-316,32,-348,-77
"36980",NA,21091,"Hancock County, KY","County or equivalent",2002,8437,1,27,110,83,-18,2,-20,-8
"36980",NA,21149,"McLean County, KY","County or equivalent",2002,9936,89,29,140,111,68,9,59,-8
"37100",NA,NA,"Oxnard-Thousand Oaks-Ventura, CA","Metropolitan Statistical Area",2002,777421,11711,6658,11452,4794,5810,3718,2092,-757
"37100",NA,6111,"Ventura County, CA","County or equivalent",2002,777421,11711,6658,11452,4794,5810,3718,2092,-757
"37340",NA,NA,"Palm Bay-Melbourne-Titusville, FL","Metropolitan Statistical Area",2002,494258,8415,-636,4836,5472,9281,510,8771,-230
"37340",NA,12009,"Brevard County, FL","County or equivalent",2002,494258,8415,-636,4836,5472,9281,510,8771,-230
"37380",NA,NA,"Palm Coast, FL","Metropolitan Statistical Area",2002,57401,3706,-199,467,666,3866,75,3791,39
"37380",NA,12035,"Flagler County, FL","County or equivalent",2002,57401,3706,-199,467,666,3866,75,3791,39
"37460",NA,NA,"Panama City-Lynn Haven, FL","Metropolitan Statistical Area",2002,152158,2375,398,1883,1485,2075,-136,2211,-98
"37460",NA,12005,"Bay County, FL","County or equivalent",2002,152158,2375,398,1883,1485,2075,-136,2211,-98
"37620",NA,NA,"Parkersburg-Marietta-Vienna, WV-OH","Metropolitan Statistical Area",2002,163313,-519,39,1874,1835,-413,21,-434,-145
"37620",NA,39167,"Washington County, OH","County or equivalent",2002,62424,-331,22,702,680,-303,3,-306,-50
"37620",NA,54073,"Pleasants County, WV","County or equivalent",2002,7510,-27,-7,78,85,-14,3,-17,-6
"37620",NA,54105,"Wirt County, WV","County or equivalent",2002,5798,-54,5,52,47,-54,1,-55,-5
"37620",NA,54107,"Wood County, WV","County or equivalent",2002,87581,-107,19,1042,1023,-42,14,-56,-84
"37700",NA,NA,"Pascagoula, MS","Metropolitan Statistical Area",2002,152251,260,881,2220,1339,-501,-13,-488,-120
"37700",NA,28039,"George County, MS","County or equivalent",2002,19851,391,165,364,199,236,12,224,-10
"37700",NA,28059,"Jackson County, MS","County or equivalent",2002,132400,-131,716,1856,1140,-737,-25,-712,-110
"37860",NA,NA,"Pensacola-Ferry Pass-Brent, FL","Metropolitan Statistical Area",2002,427702,7387,1604,5429,3825,6048,-523,6571,-265
"37860",NA,12033,"Escambia County, FL","County or equivalent",2002,299668,858,969,3884,2915,197,-406,603,-308
"37860",NA,12113,"Santa Rosa County, FL","County or equivalent",2002,128034,6529,635,1545,910,5851,-117,5968,43
"37900",NA,NA,"Peoria, IL","Metropolitan Statistical Area",2002,365434,299,1132,4791,3659,-525,293,-818,-308
"37900",NA,17123,"Marshall County, IL","County or equivalent",2002,12942,21,-53,124,177,86,1,85,-12
"37900",NA,17143,"Peoria County, IL","County or equivalent",2002,182399,192,874,2609,1735,-523,241,-764,-159
"37900",NA,17175,"Stark County, IL","County or equivalent",2002,6256,-46,-28,64,92,-14,-1,-13,-4
"37900",NA,17179,"Tazewell County, IL","County or equivalent",2002,128134,-11,273,1556,1283,-164,44,-208,-120
"37900",NA,17203,"Woodford County, IL","County or equivalent",2002,35703,143,66,438,372,90,8,82,-13
"37980",NA,NA,"Philadelphia-Camden-Wilmington, PA-NJ-DE-MD","Metropolitan Statistical Area",2002,5729127,21262,19865,73990,54125,5282,13103,-7821,-3885
"37980",15804,NA,"Camden, NJ","Metropolitan Division",2002,1209211,12967,4378,15176,10798,8620,1553,7067,-31
"37980",15804,34005,"Burlington County, NJ","County or equivalent",2002,436230,6654,1528,5265,3737,5418,340,5078,-292
"37980",15804,34007,"Camden County, NJ","County or equivalent",2002,509568,1885,2140,6850,4710,-388,1065,-1453,133
"37980",15804,34015,"Gloucester County, NJ","County or equivalent",2002,263413,4428,710,3061,2351,3590,148,3442,128
"37980",37964,NA,"Philadelphia, PA","Metropolitan Division",2002,3856573,2755,12106,49910,37804,-6117,9911,-16028,-3234
"37980",37964,42017,"Bucks County, PA","County or equivalent",2002,607375,4176,1964,6966,5002,2802,905,1897,-590
"37980",37964,42029,"Chester County, PA","County or equivalent",2002,448358,6790,2549,5787,3238,4619,934,3685,-378
"37980",37964,42045,"Delaware County, PA","County or equivalent",2002,552365,-189,912,6560,5648,-572,1189,-1761,-529
"37980",37964,42091,"Montgomery County, PA","County or equivalent",2002,763205,5315,2421,9407,6986,3607,1471,2136,-713
"37980",37964,42101,"Philadelphia County, PA","County or equivalent",2002,1485270,-13337,4260,21190,16930,-16573,5412,-21985,-1024
"37980",48864,NA,"Wilmington, DE-MD-NJ","Metropolitan Division",2002,663343,5540,3381,8904,5523,2779,1639,1140,-620
"37980",48864,10003,"New Castle County, DE","County or equivalent",2002,508773,3358,2855,6943,4088,1006,1522,-516,-503
"37980",48864,24015,"Cecil County, MD","County or equivalent",2002,90059,1803,435,1170,735,1422,49,1373,-54
"37980",48864,34033,"Salem County, NJ","County or equivalent",2002,64511,379,91,791,700,351,68,283,-63
"38060",NA,NA,"Phoenix-Mesa-Scottsdale, AZ","Metropolitan Statistical Area",2002,3494554,106764,33078,58404,25326,74009,24163,49846,-323
"38060",NA,4013,"Maricopa County, AZ","County or equivalent",2002,3296790,97350,32020,55726,23706,67334,23625,43709,-2004
"38060",NA,4021,"Pinal County, AZ","County or equivalent",2002,197764,9414,1058,2678,1620,6675,538,6137,1681
"38220",NA,NA,"Pine Bluff, AR","Metropolitan Statistical Area",2002,105986,-508,365,1457,1092,-792,65,-857,-81
"38220",NA,5025,"Cleveland County, AR","County or equivalent",2002,8596,-24,49,126,77,-67,6,-73,-6
"38220",NA,5069,"Jefferson County, AR","County or equivalent",2002,82962,-476,286,1181,895,-702,58,-760,-60
"38220",NA,5079,"Lincoln County, AR","County or equivalent",2002,14428,-8,30,150,120,-23,1,-24,-15
"38300",NA,NA,"Pittsburgh, PA","Metropolitan Statistical Area",2002,2408947,-9304,-3950,25037,28987,-3200,2204,-5404,-2154
"38300",NA,42003,"Allegheny County, PA","County or equivalent",2002,1265469,-7107,-1848,13532,15380,-4133,1982,-6115,-1126
"38300",NA,42005,"Armstrong County, PA","County or equivalent",2002,71467,-336,-188,677,865,-83,3,-86,-65
"38300",NA,42007,"Beaver County, PA","County or equivalent",2002,178599,-994,-390,1819,2209,-454,37,-491,-150
"38300",NA,42019,"Butler County, PA","County or equivalent",2002,177472,1641,397,2078,1681,1414,72,1342,-170
"38300",NA,42051,"Fayette County, PA","County or equivalent",2002,146198,-878,-329,1501,1830,-417,15,-432,-132
"38300",NA,42125,"Washington County, PA","County or equivalent",2002,202967,-122,-552,2025,2577,603,39,564,-173
"38300",NA,42129,"Westmoreland County, PA","County or equivalent",2002,366775,-1508,-1040,3405,4445,-130,56,-186,-338
"38340",NA,NA,"Pittsfield, MA","Metropolitan Statistical Area",2002,133083,-635,-330,1240,1570,-190,136,-326,-115
"38340",NA,25003,"Berkshire County, MA","County or equivalent",2002,133083,-635,-330,1240,1570,-190,136,-326,-115
"38540",NA,NA,"Pocatello, ID","Metropolitan Statistical Area",2002,84663,483,867,1495,628,-908,94,-1002,524
"38540",NA,16005,"Bannock County, ID","County or equivalent",2002,77201,503,796,1386,590,-768,64,-832,475
"38540",NA,16077,"Power County, ID","County or equivalent",2002,7462,-20,71,109,38,-140,30,-170,49
"38860",NA,NA,"Portland-South Portland-Biddeford, ME","Metropolitan Statistical Area",2002,500783,5425,917,5315,4398,4901,300,4601,-393
"38860",NA,23005,"Cumberland County, ME","County or equivalent",2002,269670,1722,433,2879,2446,1543,284,1259,-254
"38860",NA,23023,"Sagadahoc County, ME","County or equivalent",2002,35807,307,87,395,308,250,-27,277,-30
"38860",NA,23031,"York County, ME","County or equivalent",2002,195306,3396,397,2041,1644,3108,43,3065,-109
"38900",NA,NA,"Portland-Vancouver-Beaverton, OR-WA","Metropolitan Statistical Area",2002,2011436,35492,12912,27728,14816,24338,9853,14485,-1758
"38900",NA,41005,"Clackamas County, OR","County or equivalent",2002,351661,6824,1384,4025,2641,5727,923,4804,-287
"38900",NA,41009,"Columbia County, OR","County or equivalent",2002,45155,922,113,494,381,832,12,820,-23
"38900",NA,41051,"Multnomah County, OR","County or equivalent",2002,676775,7009,3272,9165,5893,4398,4069,329,-661
"38900",NA,41067,"Washington County, OR","County or equivalent",2002,471724,9243,4737,7491,2754,4972,3108,1864,-466
"38900",NA,41071,"Yamhill County, OR","County or equivalent",2002,87533,1253,482,1194,712,853,316,537,-82
"38900",NA,53011,"Clark County, WA","County or equivalent",2002,368700,10185,2895,5257,2362,7520,1418,6102,-230
"38900",NA,53059,"Skamania County, WA","County or equivalent",2002,9888,56,29,102,73,36,7,29,-9
"38940",NA,NA,"Port St. Lucie, FL","Metropolitan Statistical Area",2002,335833,9013,-443,3499,3942,9508,915,8593,-52
"38940",NA,12085,"Martin County, FL","County or equivalent",2002,131519,2415,-442,1217,1659,2887,337,2550,-30
"38940",NA,12111,"St. Lucie County, FL","County or equivalent",2002,204314,6598,-1,2282,2283,6621,578,6043,-22
"39100",NA,NA,"Poughkeepsie-Newburgh-Middletown, NY","Metropolitan Statistical Area",2002,642075,8859,3270,8081,4811,6069,1202,4867,-480
"39100",NA,36027,"Dutchess County, NY","County or equivalent",2002,286828,2496,897,3165,2268,1853,672,1181,-254
"39100",NA,36071,"Orange County, NY","County or equivalent",2002,355247,6363,2373,4916,2543,4216,530,3686,-226
"39140",NA,NA,"Prescott, AZ","Metropolitan Statistical Area",2002,178346,5081,-244,1809,2053,5369,338,5031,-44
"39140",NA,4025,"Yavapai County, AZ","County or equivalent",2002,178346,5081,-244,1809,2053,5369,338,5031,-44
"39300",NA,NA,"Providence-New Bedford-Fall River, RI-MA","Metropolitan Statistical Area",2002,1609000,12295,4091,19036,14945,9595,3916,5679,-1391
"39300",NA,25005,"Bristol County, MA","County or equivalent",2002,543063,4423,1479,6651,5172,3380,754,2626,-436
"39300",NA,44001,"Bristol County, RI","County or equivalent",2002,51059,65,-21,483,504,133,23,110,-47
"39300",NA,44003,"Kent County, RI","County or equivalent",2002,169763,1109,137,1834,1697,1102,137,965,-130
"39300",NA,44005,"Newport County, RI","County or equivalent",2002,85489,56,159,818,659,-21,-41,20,-82
"39300",NA,44007,"Providence County, RI","County or equivalent",2002,632886,5127,1987,7991,6004,3739,2947,792,-599
"39300",NA,44009,"Washington County, RI","County or equivalent",2002,126740,1515,350,1259,909,1262,96,1166,-97
"39340",NA,NA,"Provo-Orem, UT","Metropolitan Statistical Area",2002,405757,9545,8837,10493,1656,1339,1417,-78,-631
"39340",NA,49023,"Juab County, UT","County or equivalent",2002,8476,88,147,187,40,-51,2,-53,-8
"39340",NA,49049,"Utah County, UT","County or equivalent",2002,397281,9457,8690,10306,1616,1390,1415,-25,-623
"39380",NA,NA,"Pueblo, CO","Metropolitan Statistical Area",2002,146726,2607,513,1996,1483,2172,169,2003,-78
"39380",NA,8101,"Pueblo County, CO","County or equivalent",2002,146726,2607,513,1996,1483,2172,169,2003,-78
"39460",NA,NA,"Punta Gorda, FL","Metropolitan Statistical Area",2002,149346,3427,-1177,999,2176,4598,182,4416,6
"39460",NA,12015,"Charlotte County, FL","County or equivalent",2002,149346,3427,-1177,999,2176,4598,182,4416,6
"39540",NA,NA,"Racine, WI","Metropolitan Statistical Area",2002,191362,1424,1073,2579,1506,-51,267,-318,402
"39540",NA,55101,"Racine County, WI","County or equivalent",2002,191362,1424,1073,2579,1506,-51,267,-318,402
"39580",NA,NA,"Raleigh-Cary, NC","Metropolitan Statistical Area",2002,863225,27771,8983,13622,4639,17816,4866,12950,972
"39580",NA,37069,"Franklin County, NC","County or equivalent",2002,50621,1837,242,645,403,1600,142,1458,-5
"39580",NA,37101,"Johnston County, NC","County or equivalent",2002,132445,4763,1165,2148,983,3627,519,3108,-29
"39580",NA,37183,"Wake County, NC","County or equivalent",2002,680159,21171,7576,10829,3253,12589,4205,8384,1006
"39660",NA,NA,"Rapid City, SD","Metropolitan Statistical Area",2002,115245,1067,917,1751,834,266,-100,366,-116
"39660",NA,46093,"Meade County, SD","County or equivalent",2002,24402,203,238,413,175,-10,-80,70,-25
"39660",NA,46103,"Pennington County, SD","County or equivalent",2002,90843,864,679,1338,659,276,-20,296,-91
"39740",NA,NA,"Reading, PA","Metropolitan Statistical Area",2002,380447,3379,1097,4668,3571,2588,599,1989,-306
"39740",NA,42011,"Berks County, PA","County or equivalent",2002,380447,3379,1097,4668,3571,2588,599,1989,-306
"39820",NA,NA,"Redding, CA","Metropolitan Statistical Area",2002,171129,4167,154,1995,1841,4091,122,3969,-78
"39820",NA,6089,"Shasta County, CA","County or equivalent",2002,171129,4167,154,1995,1841,4091,122,3969,-78
"39900",NA,NA,"Reno-Sparks, NV","Metropolitan Statistical Area",2002,364877,9871,2414,5172,2758,7684,1748,5936,-227
"39900",NA,32029,"Storey County, NV","County or equivalent",2002,3398,-18,-9,8,17,-5,4,-9,-4
"39900",NA,32031,"Washoe County, NV","County or equivalent",2002,361479,9889,2423,5164,2741,7689,1744,5945,-223
"40060",NA,NA,"Richmond, VA","Metropolitan Statistical Area",2002,1124967,14088,5159,14726,9567,9753,1629,8124,-824
"40060",NA,51007,"Amelia County, VA","County or equivalent",2002,11619,82,36,150,114,59,1,58,-13
"40060",NA,51033,"Caroline County, VA","County or equivalent",2002,22489,357,36,274,238,337,7,330,-16
"40060",NA,51036,"Charles City County, VA","County or equivalent",2002,7023,76,12,75,63,69,1,68,-5
"40060",NA,51041,"Chesterfield County, VA","County or equivalent",2002,269266,4797,1870,3375,1505,3115,442,2673,-188
"40060",NA,51049,"Cumberland County, VA","County or equivalent",2002,9048,62,42,110,68,29,10,19,-9
"40060",NA,51053,"Dinwiddie County, VA","County or equivalent",2002,24647,212,8,218,210,223,2,221,-19
"40060",NA,51075,"Goochland County, VA","County or equivalent",2002,17608,352,51,196,145,308,13,295,-7
"40060",NA,51085,"Hanover County, VA","County or equivalent",2002,91485,2590,455,1067,612,2178,44,2134,-43
"40060",NA,51087,"Henrico County, VA","County or equivalent",2002,268099,2142,1272,3540,2268,1139,883,256,-269
"40060",NA,51097,"King and Queen County, VA","County or equivalent",2002,6566,-32,-12,61,73,-13,-1,-12,-7
"40060",NA,51101,"King William County, VA","County or equivalent",2002,13673,236,41,181,140,203,6,197,-8
"40060",NA,51109,"Louisa County, VA","County or equivalent",2002,27008,722,73,340,267,661,4,657,-12
"40060",NA,51127,"New Kent County, VA","County or equivalent",2002,14195,311,32,147,115,284,-3,287,-5
"40060",NA,51145,"Powhatan County, VA","County or equivalent",2002,24097,1017,107,257,150,902,1,901,8
"40060",NA,51149,"Prince George County, VA","County or equivalent",2002,35145,1230,166,341,175,1057,-225,1282,7
"40060",NA,51183,"Sussex County, VA","County or equivalent",2002,12045,-223,-6,120,126,-211,10,-221,-6
"40060",NA,51570,"Colonial Heights city, VA","County or equivalent",2002,17110,65,3,222,219,82,17,65,-20
"40060",NA,51670,"Hopewell city, VA","County or equivalent",2002,22472,223,74,367,293,169,11,158,-20
"40060",NA,51730,"Petersburg city, VA","County or equivalent",2002,33016,-283,77,572,495,-338,-2,-336,-22
"40060",NA,51760,"Richmond city, VA","County or equivalent",2002,198356,152,822,3113,2291,-500,408,-908,-170
"40140",NA,NA,"Riverside-San Bernardino-Ontario, CA","Metropolitan Statistical Area",2002,3486831,108758,30493,55074,24581,79794,13310,66484,-1529
"40140",NA,6065,"Riverside County, CA","County or equivalent",2002,1684378,68844,12723,25702,12979,56414,7048,49366,-293
"40140",NA,6071,"San Bernardino County, CA","County or equivalent",2002,1802453,39914,17770,29372,11602,23380,6262,17118,-1236
"40220",NA,NA,"Roanoke, VA","Metropolitan Statistical Area",2002,288696,105,172,3381,3209,153,313,-160,-220
"40220",NA,51023,"Botetourt County, VA","County or equivalent",2002,31056,390,28,270,242,380,1,379,-18
"40220",NA,51045,"Craig County, VA","County or equivalent",2002,5051,-10,-9,49,58,3,1,2,-4
"40220",NA,51067,"Franklin County, VA","County or equivalent",2002,48267,385,100,551,451,323,6,317,-38
"40220",NA,51161,"Roanoke County, VA","County or equivalent",2002,86255,455,372,1241,869,167,108,59,-84
"40220",NA,51770,"Roanoke city, VA","County or equivalent",2002,93276,-1265,-267,1025,1292,-940,179,-1119,-58
"40220",NA,51775,"Salem city, VA","County or equivalent",2002,24791,150,-52,245,297,220,18,202,-18
"40340",NA,NA,"Rochester, MN","Metropolitan Statistical Area",2002,169405,2780,1418,2519,1101,1510,672,838,-148
"40340",NA,27039,"Dodge County, MN","County or equivalent",2002,18490,392,164,297,133,241,20,221,-13
"40340",NA,27109,"Olmsted County, MN","County or equivalent",2002,129117,2381,1181,1954,773,1317,612,705,-117
"40340",NA,27157,"Wabasha County, MN","County or equivalent",2002,21798,7,73,268,195,-48,40,-88,-18
"40380",NA,NA,"Rochester, NY","Metropolitan Statistical Area",2002,1041391,8,3382,12246,8864,-2522,1874,-4396,-852
"40380",NA,36051,"Livingston County, NY","County or equivalent",2002,64194,-261,153,659,506,-362,9,-371,-52
"40380",NA,36055,"Monroe County, NY","County or equivalent",2002,739159,393,2673,8915,6242,-1673,1746,-3419,-607
"40380",NA,36069,"Ontario County, NY","County or equivalent",2002,101512,739,194,1132,938,639,68,571,-94
"40380",NA,36073,"Orleans County, NY","County or equivalent",2002,43407,-278,87,476,389,-334,16,-350,-31
"40380",NA,36117,"Wayne County, NY","County or equivalent",2002,93119,-585,275,1064,789,-792,35,-827,-68
"40420",NA,NA,"Rockford, IL","Metropolitan Statistical Area",2002,327041,3108,1807,4620,2813,922,934,-12,379
"40420",NA,17007,"Boone County, IL","County or equivalent",2002,44523,1334,318,633,315,1031,140,891,-15
"40420",NA,17201,"Winnebago County, IL","County or equivalent",2002,282518,1774,1489,3987,2498,-109,794,-903,394
"40580",NA,NA,"Rocky Mount, NC","Metropolitan Statistical Area",2002,143307,6,513,2039,1526,-323,201,-524,-184
"40580",NA,37065,"Edgecombe County, NC","County or equivalent",2002,54646,-478,179,815,636,-568,88,-656,-89
"40580",NA,37127,"Nash County, NC","County or equivalent",2002,88661,484,334,1224,890,245,113,132,-95
"40660",NA,NA,"Rome, GA","Metropolitan Statistical Area",2002,92579,1443,353,1326,973,1187,241,946,-97
"40660",NA,13115,"Floyd County, GA","County or equivalent",2002,92579,1443,353,1326,973,1187,241,946,-97
"40900",NA,NA,"Sacramento--Arden-Arcade--Roseville, CA","Metropolitan Statistical Area",2002,1922960,56552,12546,26639,14093,44906,9062,35844,-900
"40900",NA,6017,"El Dorado County, CA","County or equivalent",2002,164619,3805,549,1735,1186,3319,300,3019,-63
"40900",NA,6061,"Placer County, CA","County or equivalent",2002,277833,13621,1192,3293,2101,12455,496,11959,-26
"40900",NA,6067,"Sacramento County, CA","County or equivalent",2002,1300112,34164,9587,19249,9662,25262,6781,18481,-685
"40900",NA,6113,"Yolo County, CA","County or equivalent",2002,180396,4962,1218,2362,1144,3870,1485,2385,-126
"40980",NA,NA,"Saginaw-Saginaw Township North, MI","Metropolitan Statistical Area",2002,209042,-309,723,2802,2079,-858,152,-1010,-174
"40980",NA,26145,"Saginaw County, MI","County or equivalent",2002,209042,-309,723,2802,2079,-858,152,-1010,-174
"41060",NA,NA,"St. Cloud, MN","Metropolitan Statistical Area",2002,175069,3424,1227,2319,1092,1023,178,845,1174
"41060",NA,27009,"Benton County, MN","County or equivalent",2002,36757,1067,246,564,318,671,33,638,150
"41060",NA,27145,"Stearns County, MN","County or equivalent",2002,138312,2357,981,1755,774,352,145,207,1024
"41100",NA,NA,"St. George, UT","Metropolitan Statistical Area",2002,99412,4799,1234,1949,715,3592,166,3426,-27
"41100",NA,49053,"Washington County, UT","County or equivalent",2002,99412,4799,1234,1949,715,3592,166,3426,-27
"41140",NA,NA,"St. Joseph, MO-KS","Metropolitan Statistical Area",2002,123955,-9,226,1519,1293,-477,28,-505,242
"41140",NA,20043,"Doniphan County, KS","County or equivalent",2002,8122,-64,-4,82,86,-52,0,-52,-8
"41140",NA,29003,"Andrew County, MO","County or equivalent",2002,16513,-76,-3,178,181,-55,-1,-54,-18
"41140",NA,29021,"Buchanan County, MO","County or equivalent",2002,86324,147,213,1139,926,-346,24,-370,280
"41140",NA,29063,"DeKalb County, MO","County or equivalent",2002,12996,-16,20,120,100,-24,5,-29,-12
"41180",NA,NA,"St. Louis, MO-IL","Metropolitan Statistical Area",2002,2733182,14324,10119,36008,25889,-954,3541,-4495,5159
"41180",NA,17005,"Bond County, IL","County or equivalent",2002,17798,188,5,196,191,198,2,196,-15
"41180",NA,17013,"Calhoun County, IL","County or equivalent",2002,4976,-66,-20,43,63,-44,1,-45,-2
"41180",NA,17027,"Clinton County, IL","County or equivalent",2002,35726,97,60,371,311,71,6,65,-34
"41180",NA,17083,"Jersey County, IL","County or equivalent",2002,21899,190,49,249,200,156,2,154,-15
"41180",NA,17117,"Macoupin County, IL","County or equivalent",2002,48774,-58,-17,583,600,6,2,4,-47
"41180",NA,17119,"Madison County, IL","County or equivalent",2002,261298,864,583,3394,2811,177,71,106,104
"41180",NA,17133,"Monroe County, IL","County or equivalent",2002,29193,822,102,336,234,663,8,655,57
"41180",NA,17163,"St. Clair County, IL","County or equivalent",2002,257075,1180,1148,3732,2584,-44,-212,168,76
"41180",NA,29071,"Franklin County, MO","County or equivalent",2002,95710,856,435,1340,905,512,6,506,-91
"41180",NA,29099,"Jefferson County, MO","County or equivalent",2002,202600,1945,1093,2680,1587,1026,66,960,-174
"41180",NA,29113,"Lincoln County, MO","County or equivalent",2002,42188,1437,265,612,347,1179,7,1172,-7
"41180",NA,29183,"St. Charles County, MO","County or equivalent",2002,302729,8076,2532,4272,1740,5715,179,5536,-171
"41180",NA,29189,"St. Louis County, MO","County or equivalent",2002,1013003,-2687,2441,12220,9779,-4301,1755,-6056,-827
"41180",NA,29219,"Warren County, MO","County or equivalent",2002,26076,752,135,344,209,623,15,608,-6
"41180",NA,29221,"Washington County, MO","County or equivalent",2002,23666,212,132,350,218,101,4,97,-21
"41180",NA,29510,"St. Louis city, MO","County or equivalent",2002,350471,516,1176,5286,4110,-6992,1629,-8621,6332
"41420",NA,NA,"Salem, OR","Metropolitan Statistical Area",2002,358349,5781,2195,5284,3089,3887,1844,2043,-301
"41420",NA,41047,"Marion County, OR","County or equivalent",2002,293578,4806,2019,4547,2528,3032,1659,1373,-245
"41420",NA,41053,"Polk County, OR","County or equivalent",2002,64771,975,176,737,561,855,185,670,-56
"41500",NA,NA,"Salinas, CA","Metropolitan Statistical Area",2002,409810,2460,4908,7257,2349,-2190,3682,-5872,-258
"41500",NA,6053,"Monterey County, CA","County or equivalent",2002,409810,2460,4908,7257,2349,-2190,3682,-5872,-258
"41540",NA,NA,"Salisbury, MD","Metropolitan Statistical Area",2002,111309,878,316,1373,1057,666,174,492,-104
"41540",NA,24039,"Somerset County, MD","County or equivalent",2002,25374,214,-21,235,256,253,31,222,-18
"41540",NA,24045,"Wicomico County, MD","County or equivalent",2002,85935,664,337,1138,801,413,143,270,-86
"41620",NA,NA,"Salt Lake City, UT","Metropolitan Statistical Area",2002,1001878,12978,13964,19550,5586,-3636,5706,-9342,2650
"41620",NA,49035,"Salt Lake County, UT","County or equivalent",2002,924515,10278,12783,18044,5261,-5194,5457,-10651,2689
"41620",NA,49043,"Summit County, UT","County or equivalent",2002,31753,829,394,487,93,458,158,300,-23
"41620",NA,49045,"Tooele County, UT","County or equivalent",2002,45610,1871,787,1019,232,1100,91,1009,-16
"41660",NA,NA,"San Angelo, TX","Metropolitan Statistical Area",2002,105760,220,500,1527,1027,-183,-50,-133,-97
"41660",NA,48235,"Irion County, TX","County or equivalent",2002,1740,40,5,15,10,36,2,34,-1
"41660",NA,48451,"Tom Green County, TX","County or equivalent",2002,104020,180,495,1512,1017,-219,-52,-167,-96
"41700",NA,NA,"San Antonio, TX","Metropolitan Statistical Area",2002,1777575,33705,15564,28465,12901,19428,3176,16252,-1287
"41700",NA,48013,"Atascosa County, TX","County or equivalent",2002,40820,949,321,642,321,654,36,618,-26
"41700",NA,48019,"Bandera County, TX","County or equivalent",2002,18737,536,21,182,161,519,18,501,-4
"41700",NA,48029,"Bexar County, TX","County or equivalent",2002,1440092,25458,13869,24085,10216,12732,2849,9883,-1143
"41700",NA,48091,"Comal County, TX","County or equivalent",2002,84222,2803,364,1104,740,2447,95,2352,-8
"41700",NA,48187,"Guadalupe County, TX","County or equivalent",2002,94091,2046,517,1171,654,1585,127,1458,-56
"41700",NA,48259,"Kendall County, TX","County or equivalent",2002,25158,647,53,291,238,600,37,563,-6
"41700",NA,48325,"Medina County, TX","County or equivalent",2002,40478,551,250,558,308,331,13,318,-30
"41700",NA,48493,"Wilson County, TX","County or equivalent",2002,33977,715,169,432,263,560,1,559,-14
"41740",NA,NA,"San Diego-Carlsbad-San Marcos, CA","Metropolitan Statistical Area",2002,2905609,35979,24175,43809,19634,14583,10909,3674,-2779
"41740",NA,6073,"San Diego County, CA","County or equivalent",2002,2905609,35979,24175,43809,19634,14583,10909,3674,-2779
"41780",NA,NA,"Sandusky, OH","Metropolitan Statistical Area",2002,78643,-585,60,922,862,-589,25,-614,-56
"41780",NA,39043,"Erie County, OH","County or equivalent",2002,78643,-585,60,922,862,-589,25,-614,-56
"41860",NA,NA,"San Francisco-Oakland-Fremont, CA","Metropolitan Statistical Area",2002,4168561,-12718,26746,56482,29736,-43135,35981,-79116,3671
"41860",36084,NA,"Oakland-Fremont-Hayward, CA","Metropolitan Division",2002,2443300,1628,18449,35178,16729,-15418,19464,-34882,-1403
"41860",36084,6001,"Alameda County, CA","County or equivalent",2002,1461880,-7776,12307,21874,9567,-19613,14100,-33713,-470
"41860",36084,6013,"Contra Costa County, CA","County or equivalent",2002,981420,9404,6142,13304,7162,4195,5364,-1169,-933
"41860",41884,NA,"San Francisco-San Mateo-Redwood City, CA","Metropolitan Division",2002,1725261,-14346,8297,21304,13007,-27717,16517,-44234,5074
"41860",41884,6041,"Marin County, CA","County or equivalent",2002,246483,-1549,940,2850,1910,-2359,1369,-3728,-130
"41860",41884,6075,"San Francisco County, CA","County or equivalent",2002,778773,-5612,1773,8202,6429,-12720,8088,-20808,5335
"41860",41884,6081,"San Mateo County, CA","County or equivalent",2002,700005,-7185,5584,10252,4668,-12638,7060,-19698,-131
"41940",NA,NA,"San Jose-Sunnyvale-Santa Clara, CA","Metropolitan Statistical Area",2002,1730409,-15944,18985,27847,8862,-34957,23519,-58476,28
"41940",NA,6069,"San Benito County, CA","County or equivalent",2002,55205,464,707,964,257,-204,319,-523,-39
"41940",NA,6085,"Santa Clara County, CA","County or equivalent",2002,1675204,-16408,18278,26883,8605,-34753,23200,-57953,67
"42020",NA,NA,"San Luis Obispo-Paso Robles, CA","Metropolitan Statistical Area",2002,252985,1460,321,2331,2010,1359,563,796,-220
"42020",NA,6079,"San Luis Obispo County, CA","County or equivalent",2002,252985,1460,321,2331,2010,1359,563,796,-220
"42060",NA,NA,"Santa Barbara-Santa Maria-Goleta, CA","Metropolitan Statistical Area",2002,402529,839,2663,5638,2975,-1539,2489,-4028,-285
"42060",NA,6083,"Santa Barbara County, CA","County or equivalent",2002,402529,839,2663,5638,2975,-1539,2489,-4028,-285
"42100",NA,NA,"Santa Cruz-Watsonville, CA","Metropolitan Statistical Area",2002,253917,-1837,1782,3459,1677,-3500,1410,-4910,-119
"42100",NA,6087,"Santa Cruz County, CA","County or equivalent",2002,253917,-1837,1782,3459,1677,-3500,1410,-4910,-119
"42140",NA,NA,"Santa Fe, NM","Metropolitan Statistical Area",2002,134390,2827,727,1529,802,2190,698,1492,-90
"42140",NA,35049,"Santa Fe County, NM","County or equivalent",2002,134390,2827,727,1529,802,2190,698,1492,-90
"42220",NA,NA,"Santa Rosa-Petaluma, CA","Metropolitan Statistical Area",2002,463902,-706,1782,5708,3926,-2159,2276,-4435,-329
"42220",NA,6097,"Sonoma County, CA","County or equivalent",2002,463902,-706,1782,5708,3926,-2159,2276,-4435,-329
"42340",NA,NA,"Savannah, GA","Metropolitan Statistical Area",2002,301625,4632,1810,4459,2649,3030,190,2840,-208
"42340",NA,13029,"Bryan County, GA","County or equivalent",2002,24869,754,174,347,173,585,-17,602,-5
"42340",NA,13051,"Chatham County, GA","County or equivalent",2002,235669,2103,1310,3527,2217,998,199,799,-205
"42340",NA,13103,"Effingham County, GA","County or equivalent",2002,41087,1775,326,585,259,1447,8,1439,2
"42540",NA,NA,"Scranton--Wilkes-Barre, PA","Metropolitan Statistical Area",2002,552348,-3247,-2238,5379,7617,-481,279,-760,-528
"42540",NA,42069,"Lackawanna County, PA","County or equivalent",2002,210718,-1304,-866,2100,2966,-240,118,-358,-198
"42540",NA,42079,"Luzerne County, PA","County or equivalent",2002,313699,-1788,-1409,2977,4386,-70,157,-227,-309
"42540",NA,42131,"Wyoming County, PA","County or equivalent",2002,27931,-155,37,302,265,-171,4,-175,-21
"42660",NA,NA,"Seattle-Tacoma-Bellevue, WA","Metropolitan Statistical Area",2002,3120811,26652,19408,40406,20998,6965,14142,-7177,279
"42660",42644,NA,"Seattle-Bellevue-Everett, WA","Metropolitan Division",2002,2392368,14419,14791,30307,15516,-1159,13407,-14566,787
"42660",42644,53033,"King County, WA","County or equivalent",2002,1762693,5927,10315,21847,11532,-5742,11512,-17254,1354
"42660",42644,53061,"Snohomish County, WA","County or equivalent",2002,629675,8492,4476,8460,3984,4583,1895,2688,-567
"42660",45104,NA,"Tacoma, WA","Metropolitan Division",2002,728443,12233,4617,10099,5482,8124,735,7389,-508
"42660",45104,53053,"Pierce County, WA","County or equivalent",2002,728443,12233,4617,10099,5482,8124,735,7389,-508
"42680",NA,NA,"Sebastian-Vero Beach, FL","Metropolitan Statistical Area",2002,117746,2459,-497,1117,1614,2981,290,2691,-25
"42680",NA,12061,"Indian River County, FL","County or equivalent",2002,117746,2459,-497,1117,1614,2981,290,2691,-25
"43100",NA,NA,"Sheboygan, WI","Metropolitan Statistical Area",2002,112954,82,336,1389,1053,-153,164,-317,-101
"43100",NA,55117,"Sheboygan County, WI","County or equivalent",2002,112954,82,336,1389,1053,-153,164,-317,-101
"43300",NA,NA,"Sherman-Denison, TX","Metropolitan Statistical Area",2002,113273,892,373,1636,1263,623,226,397,-104
"43300",NA,48181,"Grayson County, TX","County or equivalent",2002,113273,892,373,1636,1263,623,226,397,-104
"43340",NA,NA,"Shreveport-Bossier City, LA","Metropolitan Statistical Area",2002,376114,199,1920,5630,3710,-1430,-110,-1320,-291
"43340",NA,22015,"Bossier Parish, LA","County or equivalent",2002,100898,1101,722,1498,776,462,-165,627,-83
"43340",NA,22017,"Caddo Parish, LA","County or equivalent",2002,249632,-1034,1102,3773,2671,-1952,47,-1999,-184
"43340",NA,22031,"De Soto Parish, LA","County or equivalent",2002,25584,132,96,359,263,60,8,52,-24
"43580",NA,NA,"Sioux City, IA-NE-SD","Metropolitan Statistical Area",2002,142280,-190,961,2280,1319,-1058,564,-1622,-93
"43580",NA,19193,"Woodbury County, IA","County or equivalent",2002,103019,-294,657,1631,974,-883,383,-1266,-68
"43580",NA,31043,"Dakota County, NE","County or equivalent",2002,20272,2,238,403,165,-227,147,-374,-9
"43580",NA,31051,"Dixon County, NE","County or equivalent",2002,6184,-67,-7,77,84,-57,14,-71,-3
"43580",NA,46127,"Union County, SD","County or equivalent",2002,12805,169,73,169,96,109,20,89,-13
"43620",NA,NA,"Sioux Falls, SD","Metropolitan Statistical Area",2002,197524,4310,1526,2965,1439,1938,417,1521,846
"43620",NA,46083,"Lincoln County, SD","County or equivalent",2002,27726,1558,280,427,147,1201,18,1183,77
"43620",NA,46087,"McCook County, SD","County or equivalent",2002,5792,-77,16,82,66,-90,0,-90,-3
"43620",NA,46099,"Minnehaha County, SD","County or equivalent",2002,155436,3001,1263,2369,1106,961,399,562,777
"43620",NA,46125,"Turner County, SD","County or equivalent",2002,8570,-172,-33,87,120,-134,0,-134,-5
"43780",NA,NA,"South Bend-Mishawaka, IN-MI","Metropolitan Statistical Area",2002,316079,-509,1362,4292,2930,-1630,628,-2258,-241
"43780",NA,18141,"St. Joseph County, IN","County or equivalent",2002,265042,-435,1309,3742,2433,-1553,608,-2161,-191
"43780",NA,26027,"Cass County, MI","County or equivalent",2002,51037,-74,53,550,497,-77,20,-97,-50
"43900",NA,NA,"Spartanburg, SC","Metropolitan Statistical Area",2002,258949,2256,875,3385,2510,1599,469,1130,-218
"43900",NA,45083,"Spartanburg County, SC","County or equivalent",2002,258949,2256,875,3385,2510,1599,469,1130,-218
"44060",NA,NA,"Spokane, WA","Metropolitan Statistical Area",2002,427083,4303,1807,5469,3662,2876,616,2260,-380
"44060",NA,53063,"Spokane County, WA","County or equivalent",2002,427083,4303,1807,5469,3662,2876,616,2260,-380
"44100",NA,NA,"Springfield, IL","Metropolitan Statistical Area",2002,203931,1165,633,2555,1922,140,79,61,392
"44100",NA,17129,"Menard County, IL","County or equivalent",2002,12476,-8,-17,121,138,22,2,20,-13
"44100",NA,17167,"Sangamon County, IL","County or equivalent",2002,191455,1173,650,2434,1784,118,77,41,405
"44140",NA,NA,"Springfield, MA","Metropolitan Statistical Area",2002,683528,3233,1297,7694,6397,2579,1676,903,-643
"44140",NA,25011,"Franklin County, MA","County or equivalent",2002,71887,218,44,668,624,241,113,128,-67
"44140",NA,25013,"Hampden County, MA","County or equivalent",2002,458747,2386,1151,5759,4608,1664,1259,405,-429
"44140",NA,25015,"Hampshire County, MA","County or equivalent",2002,152894,629,102,1267,1165,674,304,370,-147
"44180",NA,NA,"Springfield, MO","Metropolitan Statistical Area",2002,379641,4918,1290,4852,3562,3925,206,3719,-297
"44180",NA,29043,"Christian County, MO","County or equivalent",2002,58863,1933,397,800,403,1557,5,1552,-21
"44180",NA,29059,"Dallas County, MO","County or equivalent",2002,15832,98,34,214,180,77,2,75,-13
"44180",NA,29077,"Greene County, MO","County or equivalent",2002,244708,2043,662,3058,2396,1601,163,1438,-220
"44180",NA,29167,"Polk County, MO","County or equivalent",2002,27782,350,27,338,311,338,29,309,-15
"44180",NA,29225,"Webster County, MO","County or equivalent",2002,32456,494,170,442,272,352,7,345,-28
"44220",NA,NA,"Springfield, OH","Metropolitan Statistical Area",2002,143402,-524,218,1823,1605,-622,19,-641,-120
"44220",NA,39023,"Clark County, OH","County or equivalent",2002,143402,-524,218,1823,1605,-622,19,-641,-120
"44300",NA,NA,"State College, PA","Metropolitan Statistical Area",2002,139266,2430,333,1225,892,2188,626,1562,-91
"44300",NA,42027,"Centre County, PA","County or equivalent",2002,139266,2430,333,1225,892,2188,626,1562,-91
"44700",NA,NA,"Stockton, CA","Metropolitan Statistical Area",2002,608858,17595,5609,10141,4532,12307,3070,9237,-321
"44700",NA,6077,"San Joaquin County, CA","County or equivalent",2002,608858,17595,5609,10141,4532,12307,3070,9237,-321
"44940",NA,NA,"Sumter, SC","Metropolitan Statistical Area",2002,104851,639,698,1601,903,38,-160,198,-97
"44940",NA,45085,"Sumter County, SC","County or equivalent",2002,104851,639,698,1601,903,38,-160,198,-97
"45060",NA,NA,"Syracuse, NY","Metropolitan Statistical Area",2002,648805,-97,2121,7817,5696,-1642,1015,-2657,-576
"45060",NA,36053,"Madison County, NY","County or equivalent",2002,69489,44,207,767,560,-97,30,-127,-66
"45060",NA,36067,"Onondaga County, NY","County or equivalent",2002,457033,-250,1524,5645,4121,-1378,960,-2338,-396
"45060",NA,36075,"Oswego County, NY","County or equivalent",2002,122283,109,390,1405,1015,-167,25,-192,-114
"45220",NA,NA,"Tallahassee, FL","Metropolitan Statistical Area",2002,327520,2999,1603,3997,2394,1683,575,1108,-287
"45220",NA,12039,"Gadsden County, FL","County or equivalent",2002,45168,-295,208,700,492,-470,74,-544,-33
"45220",NA,12065,"Jefferson County, FL","County or equivalent",2002,13751,365,19,162,143,352,-1,353,-6
"45220",NA,12073,"Leon County, FL","County or equivalent",2002,243634,2044,1282,2864,1582,991,496,495,-229
"45220",NA,12129,"Wakulla County, FL","County or equivalent",2002,24967,885,94,271,177,810,6,804,-19
"45300",NA,NA,"Tampa-St. Petersburg-Clearwater, FL","Metropolitan Statistical Area",2002,2483308,41049,7,29175,29168,42367,8082,34285,-1325
"45300",NA,12053,"Hernando County, FL","County or equivalent",2002,137639,3562,-976,1231,2207,4519,84,4435,19
"45300",NA,12057,"Hillsborough County, FL","County or equivalent",2002,1050822,24434,6098,14956,8858,18916,4514,14402,-580
"45300",NA,12101,"Pasco County, FL","County or equivalent",2002,371304,12763,-1435,3896,5331,14125,644,13481,73
"45300",NA,12103,"Pinellas County, FL","County or equivalent",2002,923543,290,-3680,9092,12772,4807,2840,1967,-837
"45460",NA,NA,"Terre Haute, IN","Metropolitan Statistical Area",2002,169418,-779,108,2154,2046,-753,117,-870,-134
"45460",NA,18021,"Clay County, IN","County or equivalent",2002,26398,-161,51,356,305,-194,9,-203,-18
"45460",NA,18153,"Sullivan County, IN","County or equivalent",2002,21717,-8,-17,270,287,29,1,28,-20
"45460",NA,18165,"Vermillion County, IN","County or equivalent",2002,16499,-112,-46,190,236,-51,5,-56,-15
"45460",NA,18167,"Vigo County, IN","County or equivalent",2002,104804,-498,120,1338,1218,-537,102,-639,-81
"45500",NA,NA,"Texarkana, TX-Texarkana, AR","Metropolitan Statistical Area",2002,130187,319,369,1713,1344,73,74,-1,-123
"45500",NA,5091,"Miller County, AR","County or equivalent",2002,40988,350,227,594,367,163,25,138,-40
"45500",NA,48037,"Bowie County, TX","County or equivalent",2002,89199,-31,142,1119,977,-90,49,-139,-83
"45780",NA,NA,"Toledo, OH","Metropolitan Statistical Area",2002,658315,-1092,2416,8564,6148,-2992,621,-3613,-516
"45780",NA,39051,"Fulton County, OH","County or equivalent",2002,42205,53,176,519,343,-84,9,-93,-39
"45780",NA,39095,"Lucas County, OH","County or equivalent",2002,453244,-1148,1907,6300,4393,-2702,495,-3197,-353
"45780",NA,39123,"Ottawa County, OH","County or equivalent",2002,40915,-57,-25,428,453,-19,3,-22,-13
"45780",NA,39173,"Wood County, OH","County or equivalent",2002,121951,60,358,1317,959,-187,114,-301,-111
"45820",NA,NA,"Topeka, KS","Metropolitan Statistical Area",2002,224977,94,791,3095,2304,-507,198,-705,-190
"45820",NA,20085,"Jackson County, KS","County or equivalent",2002,12840,153,15,166,151,150,0,150,-12
"45820",NA,20087,"Jefferson County, KS","County or equivalent",2002,18490,27,40,200,160,5,4,1,-18
"45820",NA,20139,"Osage County, KS","County or equivalent",2002,16655,14,-23,158,181,52,1,51,-15
"45820",NA,20177,"Shawnee County, KS","County or equivalent",2002,170285,-25,759,2498,1739,-646,193,-839,-138
"45820",NA,20197,"Wabaunsee County, KS","County or equivalent",2002,6707,-75,0,73,73,-68,0,-68,-7
"45940",NA,NA,"Trenton-Ewing, NJ","Metropolitan Statistical Area",2002,356213,2219,1520,4447,2927,1025,2164,-1139,-326
"45940",NA,34021,"Mercer County, NJ","County or equivalent",2002,356213,2219,1520,4447,2927,1025,2164,-1139,-326
"46060",NA,NA,"Tucson, AZ","Metropolitan Statistical Area",2002,885797,20137,4548,12287,7739,12051,2916,9135,3538
"46060",NA,4019,"Pima County, AZ","County or equivalent",2002,885797,20137,4548,12287,7739,12051,2916,9135,3538
"46140",NA,NA,"Tulsa, OK","Metropolitan Statistical Area",2002,874542,6972,5130,13152,8022,2557,1813,744,-715
"46140",NA,40037,"Creek County, OK","County or equivalent",2002,68357,447,211,908,697,296,8,288,-60
"46140",NA,40111,"Okmulgee County, OK","County or equivalent",2002,39514,-66,52,540,488,-78,11,-89,-40
"46140",NA,40113,"Osage County, OK","County or equivalent",2002,44873,-63,112,479,367,-128,20,-148,-47
"46140",NA,40117,"Pawnee County, OK","County or equivalent",2002,16734,-33,1,202,201,-16,1,-17,-18
"46140",NA,40131,"Rogers County, OK","County or equivalent",2002,74941,1976,296,902,606,1713,32,1681,-33
"46140",NA,40143,"Tulsa County, OK","County or equivalent",2002,569943,3286,4072,9370,5298,-293,1698,-1991,-493
"46140",NA,40145,"Wagoner County, OK","County or equivalent",2002,60180,1425,386,751,365,1063,43,1020,-24
"46220",NA,NA,"Tuscaloosa, AL","Metropolitan Statistical Area",2002,194004,23,822,2635,1813,-633,227,-860,-166
"46220",NA,1063,"Greene County, AL","County or equivalent",2002,9838,-23,35,146,111,-48,1,-49,-10
"46220",NA,1065,"Hale County, AL","County or equivalent",2002,18031,-225,43,236,193,-256,1,-257,-12
"46220",NA,1125,"Tuscaloosa County, AL","County or equivalent",2002,166135,271,744,2253,1509,-329,225,-554,-144
"46340",NA,NA,"Tyler, TX","Metropolitan Statistical Area",2002,180502,3014,974,2713,1739,2175,557,1618,-135
"46340",NA,48423,"Smith County, TX","County or equivalent",2002,180502,3014,974,2713,1739,2175,557,1618,-135
"46540",NA,NA,"Utica-Rome, NY","Metropolitan Statistical Area",2002,296463,-1195,-251,3151,3402,-691,723,-1414,-253
"46540",NA,36043,"Herkimer County, NY","County or equivalent",2002,63395,-562,-57,653,710,-455,17,-472,-50
"46540",NA,36065,"Oneida County, NY","County or equivalent",2002,233068,-633,-194,2498,2692,-236,706,-942,-203
"46660",NA,NA,"Valdosta, GA","Metropolitan Statistical Area",2002,121486,1737,786,1731,945,1038,-12,1050,-87
"46660",NA,13027,"Brooks County, GA","County or equivalent",2002,16244,-65,18,211,193,-68,11,-79,-15
"46660",NA,13101,"Echols County, GA","County or equivalent",2002,3811,0,38,61,23,-35,49,-84,-3
"46660",NA,13173,"Lanier County, GA","County or equivalent",2002,7158,53,28,90,62,32,2,30,-7
"46660",NA,13185,"Lowndes County, GA","County or equivalent",2002,94273,1749,702,1369,667,1109,-74,1183,-62
"46700",NA,NA,"Vallejo-Fairfield, CA","Metropolitan Statistical Area",2002,408039,4084,3274,5843,2569,1229,1200,29,-419
"46700",NA,6095,"Solano County, CA","County or equivalent",2002,408039,4084,3274,5843,2569,1229,1200,29,-419
"47020",NA,NA,"Victoria, TX","Metropolitan Statistical Area",2002,112212,-98,836,1795,959,-860,208,-1068,-74
"47020",NA,48057,"Calhoun County, TX","County or equivalent",2002,20364,-284,153,337,184,-435,90,-525,-2
"47020",NA,48175,"Goliad County, TX","County or equivalent",2002,7010,13,7,93,86,13,4,9,-7
"47020",NA,48469,"Victoria County, TX","County or equivalent",2002,84838,173,676,1365,689,-438,114,-552,-65
"47220",NA,NA,"Vineland-Millville-Bridgeton, NJ","Metropolitan Statistical Area",2002,147525,890,571,2146,1575,466,466,0,-147
"47220",NA,34011,"Cumberland County, NJ","County or equivalent",2002,147525,890,571,2146,1575,466,466,0,-147
"47260",NA,NA,"Virginia Beach-Norfolk-Newport News, VA-NC","Metropolitan Statistical Area",2002,1605568,18435,10934,23068,12134,8353,-3855,12208,-852
"47260",NA,37053,"Currituck County, NC","County or equivalent",2002,19475,718,47,208,161,672,-10,682,-1
"47260",NA,51073,"Gloucester County, VA","County or equivalent",2002,35647,477,135,438,303,379,-24,403,-37
"47260",NA,51093,"Isle of Wight County, VA","County or equivalent",2002,30645,443,67,371,304,393,-2,395,-17
"47260",NA,51095,"James City County, VA","County or equivalent",2002,51313,1743,114,513,399,1641,39,1602,-12
"47260",NA,51115,"Mathews County, VA","County or equivalent",2002,9185,-80,-52,78,130,-20,-2,-18,-8
"47260",NA,51181,"Surry County, VA","County or equivalent",2002,6900,59,-14,69,83,78,0,78,-5
"47260",NA,51199,"York County, VA","County or equivalent",2002,58814,1188,317,622,305,898,-137,1035,-27
"47260",NA,51550,"Chesapeake city, VA","County or equivalent",2002,204575,2065,1283,2738,1455,956,-264,1220,-174
"47260",NA,51650,"Hampton city, VA","County or equivalent",2002,144939,-257,753,1896,1143,-883,-275,-608,-127
"47260",NA,51700,"Newport News city, VA","County or equivalent",2002,181230,1038,1774,3128,1354,-564,-318,-246,-172
"47260",NA,51710,"Norfolk city, VA","County or equivalent",2002,240220,5532,2043,4137,2094,3220,-1336,4556,269
"47260",NA,51735,"Poquoson city, VA","County or equivalent",2002,11622,143,-7,77,84,157,-6,163,-7
"47260",NA,51740,"Portsmouth city, VA","County or equivalent",2002,99571,-166,454,1524,1070,-523,-257,-266,-97
"47260",NA,51800,"Suffolk city, VA","County or equivalent",2002,69280,2866,375,999,624,2480,-53,2533,11
"47260",NA,51810,"Virginia Beach city, VA","County or equivalent",2002,430525,2947,3685,6163,2478,-294,-1235,941,-444
"47260",NA,51830,"Williamsburg city, VA","County or equivalent",2002,11627,-281,-40,107,147,-237,25,-262,-4
"47300",NA,NA,"Visalia-Porterville, CA","Metropolitan Statistical Area",2002,378824,5955,4605,7282,2677,1714,2400,-686,-364
"47300",NA,6107,"Tulare County, CA","County or equivalent",2002,378824,5955,4605,7282,2677,1714,2400,-686,-364
"47380",NA,NA,"Waco, TX","Metropolitan Statistical Area",2002,217292,1723,1254,3221,1967,679,593,86,-210
"47380",NA,48309,"McLennan County, TX","County or equivalent",2002,217292,1723,1254,3221,1967,679,593,86,-210
"47580",NA,NA,"Warner Robins, GA","Metropolitan Statistical Area",2002,116364,3090,795,1659,864,2336,-152,2488,-41
"47580",NA,13153,"Houston County, GA","County or equivalent",2002,116364,3090,795,1659,864,2336,-152,2488,-41
"47900",NA,NA,"Washington-Arlington-Alexandria, DC-VA-MD-WV","Metropolitan Statistical Area",2002,5014345,86230,44271,74782,30511,34776,33480,1296,7183
"47900",13644,NA,"Bethesda-Frederick-Gaithersburg, MD","Metropolitan Division",2002,1116731,19911,9117,16024,6907,9021,9336,-315,1773
"47900",13644,24021,"Frederick County, MD","County or equivalent",2002,208498,6556,1636,3000,1364,4994,223,4771,-74
"47900",13644,24031,"Montgomery County, MD","County or equivalent",2002,908233,13355,7481,13024,5543,4027,9113,-5086,1847
"47900",47894,NA,"Washington-Arlington-Alexandria, DC-VA-MD-WV","Metropolitan Division",2002,3897614,66319,35154,58758,23604,25755,24144,1611,5410
"47900",47894,11001,"District of Columbia, DC","County or equivalent",2002,579112,1434,1712,7625,5913,-4087,3469,-7556,3809
"47900",47894,24009,"Calvert County, MD","County or equivalent",2002,80380,3047,491,1011,520,2567,16,2551,-11
"47900",47894,24017,"Charles County, MD","County or equivalent",2002,127777,3086,795,1665,870,2348,-51,2399,-57
"47900",47894,24033,"Prince George's County, MD","County or equivalent",2002,823186,8497,7117,12362,5245,2192,4139,-1947,-812
"47900",47894,51013,"Arlington County, VA","County or equivalent",2002,195724,2174,1715,2831,1116,-1334,2894,-4228,1793
"47900",47894,51043,"Clarke County, VA","County or equivalent",2002,13086,132,-7,125,132,147,10,137,-8
"47900",47894,51059,"Fairfax County, VA","County or equivalent",2002,989315,4648,10271,14598,4327,-5025,9655,-14680,-598
"47900",47894,51061,"Fauquier County, VA","County or equivalent",2002,59195,1915,319,723,404,1611,66,1545,-15
"47900",47894,51107,"Loudoun County, VA","County or equivalent",2002,203007,13358,3328,4035,707,9953,835,9118,77
"47900",47894,51153,"Prince William County, VA","County or equivalent",2002,309312,12232,4390,5566,1176,7942,733,7209,-100
"47900",47894,51177,"Spotsylvania County, VA","County or equivalent",2002,101849,5446,967,1562,595,4442,27,4415,37
"47900",47894,51179,"Stafford County, VA","County or equivalent",2002,103645,5544,1030,1469,439,4467,-148,4615,47
"47900",47894,51187,"Warren County, VA","County or equivalent",2002,32804,752,151,439,288,613,7,606,-12
"47900",47894,51510,"Alexandria city, VA","County or equivalent",2002,134516,1426,1667,2487,820,-1604,1806,-3410,1363
"47900",47894,51600,"Fairfax city, VA","County or equivalent",2002,22038,139,31,229,198,125,284,-159,-17
"47900",47894,51610,"Falls Church city, VA","County or equivalent",2002,10559,51,115,184,69,-56,66,-122,-8
"47900",47894,51630,"Fredericksburg city, VA","County or equivalent",2002,20294,390,142,362,220,273,39,234,-25
"47900",47894,51683,"Manassas city, VA","County or equivalent",2002,36281,453,468,631,163,19,211,-192,-34
"47900",47894,51685,"Manassas Park city, VA","County or equivalent",2002,10849,202,199,224,25,12,70,-58,-9
"47900",47894,54037,"Jefferson County, WV","County or equivalent",2002,44685,1393,253,630,377,1150,16,1134,-10
"47940",NA,NA,"Waterloo-Cedar Falls, IA","Metropolitan Statistical Area",2002,162133,-1181,462,1970,1508,-1546,392,-1938,-97
"47940",NA,19013,"Black Hawk County, IA","County or equivalent",2002,126622,-1002,462,1604,1142,-1398,386,-1784,-66
"47940",NA,19017,"Bremer County, IA","County or equivalent",2002,23206,-197,4,241,237,-182,6,-188,-19
"47940",NA,19075,"Grundy County, IA","County or equivalent",2002,12305,18,-4,125,129,34,0,34,-12
"48140",NA,NA,"Wausau, WI","Metropolitan Statistical Area",2002,126313,178,519,1515,996,-228,104,-332,-113
"48140",NA,55073,"Marathon County, WI","County or equivalent",2002,126313,178,519,1515,996,-228,104,-332,-113
"48260",NA,NA,"Weirton-Steubenville, WV-OH","Metropolitan Statistical Area",2002,128885,-1360,-575,1229,1804,-681,15,-696,-104
"48260",NA,39081,"Jefferson County, OH","County or equivalent",2002,71957,-841,-363,661,1024,-426,17,-443,-52
"48260",NA,54009,"Brooke County, WV","County or equivalent",2002,24979,-174,-116,225,341,-33,-1,-32,-25
"48260",NA,54029,"Hancock County, WV","County or equivalent",2002,31949,-345,-96,343,439,-222,-1,-221,-27
"48300",NA,NA,"Wenatchee, WA","Metropolitan Statistical Area",2002,99841,413,548,1358,810,-51,441,-492,-84
"48300",NA,53007,"Chelan County, WA","County or equivalent",2002,66856,200,353,932,579,-98,291,-389,-55
"48300",NA,53017,"Douglas County, WA","County or equivalent",2002,32985,213,195,426,231,47,150,-103,-29
"48540",NA,NA,"Wheeling, WV-OH","Metropolitan Statistical Area",2002,150660,-655,-328,1538,1866,-206,36,-242,-121
"48540",NA,39013,"Belmont County, OH","County or equivalent",2002,69657,91,-186,708,894,333,10,323,-56
"48540",NA,54051,"Marshall County, WV","County or equivalent",2002,34827,-334,-15,359,374,-288,1,-289,-31
"48540",NA,54069,"Ohio County, WV","County or equivalent",2002,46176,-412,-127,471,598,-251,25,-276,-34
"48620",NA,NA,"Wichita, KS","Metropolitan Statistical Area",2002,578582,4086,4200,8997,4797,413,1265,-852,-527
"48620",NA,20015,"Butler County, KS","County or equivalent",2002,60132,401,232,747,515,223,37,186,-54
"48620",NA,20079,"Harvey County, KS","County or equivalent",2002,33165,256,93,435,342,194,55,139,-31
"48620",NA,20173,"Sedgwick County, KS","County or equivalent",2002,459925,3703,3772,7468,3696,361,1170,-809,-430
"48620",NA,20191,"Sumner County, KS","County or equivalent",2002,25360,-274,103,347,244,-365,3,-368,-12
"48660",NA,NA,"Wichita Falls, TX","Metropolitan Statistical Area",2002,150276,161,627,2099,1472,-328,-279,-49,-138
"48660",NA,48009,"Archer County, TX","County or equivalent",2002,8877,83,24,91,67,66,0,66,-7
"48660",NA,48077,"Clay County, TX","County or equivalent",2002,11325,169,-12,90,102,188,0,188,-7
"48660",NA,48485,"Wichita County, TX","County or equivalent",2002,130074,-91,615,1918,1303,-582,-279,-303,-124
"48700",NA,NA,"Williamsport, PA","Metropolitan Statistical Area",2002,118519,-596,88,1284,1196,-588,13,-601,-96
"48700",NA,42081,"Lycoming County, PA","County or equivalent",2002,118519,-596,88,1284,1196,-588,13,-601,-96
"48900",NA,NA,"Wilmington, NC","Metropolitan Statistical Area",2002,288132,6457,827,3366,2539,5748,427,5321,-118
"48900",NA,37019,"Brunswick County, NC","County or equivalent",2002,78528,2391,170,893,723,2223,102,2121,-2
"48900",NA,37129,"New Hanover County, NC","County or equivalent",2002,167023,3217,530,1972,1442,2785,227,2558,-98
"48900",NA,37141,"Pender County, NC","County or equivalent",2002,42581,849,127,501,374,740,98,642,-18
"49020",NA,NA,"Winchester, VA-WV","Metropolitan Statistical Area",2002,108194,2329,473,1347,874,1923,176,1747,-67
"49020",NA,51069,"Frederick County, VA","County or equivalent",2002,62787,1705,335,757,422,1392,42,1350,-22
"49020",NA,51840,"Winchester city, VA","County or equivalent",2002,24606,383,128,381,253,287,131,156,-32
"49020",NA,54027,"Hampshire County, WV","County or equivalent",2002,20801,241,10,209,199,244,3,241,-13
"49180",NA,NA,"Winston-Salem, NC","Metropolitan Statistical Area",2002,432420,4317,2121,6009,3888,2601,1618,983,-405
"49180",NA,37059,"Davie County, NC","County or equivalent",2002,36523,575,110,469,359,491,76,415,-26
"49180",NA,37067,"Forsyth County, NC","County or equivalent",2002,313897,3391,1828,4594,2766,1867,1397,470,-304
"49180",NA,37169,"Stokes County, NC","County or equivalent",2002,44822,-49,80,483,403,-88,46,-134,-41
"49180",NA,37197,"Yadkin County, NC","County or equivalent",2002,37178,400,103,463,360,331,99,232,-34
"49340",NA,NA,"Worcester, MA","Metropolitan Statistical Area",2002,767534,6718,3206,10070,6864,4220,2495,1725,-708
"49340",NA,25027,"Worcester County, MA","County or equivalent",2002,767534,6718,3206,10070,6864,4220,2495,1725,-708
"49420",NA,NA,"Yakima, WA","Metropolitan Statistical Area",2002,223485,606,2337,4072,1735,-1587,1099,-2686,-144
"49420",NA,53077,"Yakima County, WA","County or equivalent",2002,223485,606,2337,4072,1735,-1587,1099,-2686,-144
"49620",NA,NA,"York-Hanover, PA","Metropolitan Statistical Area",2002,388708,3411,1369,4656,3287,2368,273,2095,-326
"49620",NA,42133,"York County, PA","County or equivalent",2002,388708,3411,1369,4656,3287,2368,273,2095,-326
"49660",NA,NA,"Youngstown-Warren-Boardman, OH-PA","Metropolitan Statistical Area",2002,593749,-4741,-433,6532,6965,-3831,184,-4015,-477
"49660",NA,39099,"Mahoning County, OH","County or equivalent",2002,252204,-2646,-269,2799,3068,-2183,106,-2289,-194
"49660",NA,39155,"Trumbull County, OH","County or equivalent",2002,222242,-1651,-42,2431,2473,-1431,48,-1479,-178
"49660",NA,42085,"Mercer County, PA","County or equivalent",2002,119303,-444,-122,1302,1424,-217,30,-247,-105
"49700",NA,NA,"Yuba City, CA","Metropolitan Statistical Area",2002,144151,2885,1041,2260,1219,1949,608,1341,-105
"49700",NA,6101,"Sutter County, CA","County or equivalent",2002,81763,1832,560,1251,691,1332,517,815,-60
"49700",NA,6115,"Yuba County, CA","County or equivalent",2002,62388,1053,481,1009,528,617,91,526,-45
"49740",NA,NA,"Yuma, AZ","Metropolitan Statistical Area",2002,166097,2879,1997,3099,1102,1038,870,168,-156
"49740",NA,4027,"Yuma County, AZ","County or equivalent",2002,166097,2879,1997,3099,1102,1038,870,168,-156
" ",NA,NA,"","",2002,NA,NA,NA,NA,NA,NA,NA,NA,NA
" ",NA,NA,"Micropolitan Statistical Area","",2002,NA,NA,NA,NA,NA,NA,NA,NA,NA
" ",NA,NA,"","",2002,NA,NA,NA,NA,NA,NA,NA,NA,NA
"10020",NA,NA,"Abbeville, LA","Micropolitan Statistical Area",2002,54200,262,249,812,563,67,55,12,-54
"10020",NA,22113,"Vermilion Parish, LA","County or equivalent",2002,54200,262,249,812,563,67,55,12,-54
"10100",NA,NA,"Aberdeen, SD","Micropolitan Statistical Area",2002,39121,-285,55,453,398,-312,12,-324,-28
"10100",NA,46013,"Brown County, SD","County or equivalent",2002,34907,-208,66,414,348,-249,10,-259,-25
"10100",NA,46045,"Edmunds County, SD","County or equivalent",2002,4214,-77,-11,39,50,-63,2,-65,-3
"10140",NA,NA,"Aberdeen, WA","Micropolitan Statistical Area",2002,68300,303,-26,763,789,392,93,299,-63
"10140",NA,53027,"Grays Harbor County, WA","County or equivalent",2002,68300,303,-26,763,789,392,93,299,-63
"10220",NA,NA,"Ada, OK","Micropolitan Statistical Area",2002,35029,101,74,493,419,61,26,35,-34
"10220",NA,40123,"Pontotoc County, OK","County or equivalent",2002,35029,101,74,493,419,61,26,35,-34
"10300",NA,NA,"Adrian, MI","Micropolitan Statistical Area",2002,100185,599,323,1189,866,363,55,308,-87
"10300",NA,26091,"Lenawee County, MI","County or equivalent",2002,100185,599,323,1189,866,363,55,308,-87
"10460",NA,NA,"Alamogordo, NM","Micropolitan Statistical Area",2002,61478,105,423,896,473,-272,156,-428,-46
"10460",NA,35035,"Otero County, NM","County or equivalent",2002,61478,105,423,896,473,-272,156,-428,-46
"10540",NA,NA,"Albany-Lebanon, OR","Micropolitan Statistical Area",2002,104658,1061,368,1414,1046,792,100,692,-99
"10540",NA,41043,"Linn County, OR","County or equivalent",2002,104658,1061,368,1414,1046,792,100,692,-99
"10620",NA,NA,"Albemarle, NC","Micropolitan Statistical Area",2002,58507,-83,159,757,598,-187,95,-282,-55
"10620",NA,37167,"Stanly County, NC","County or equivalent",2002,58507,-83,159,757,598,-187,95,-282,-55
"10660",NA,NA,"Albert Lea, MN","Micropolitan Statistical Area",2002,31975,-461,-31,350,381,-415,47,-462,-15
"10660",NA,27047,"Freeborn County, MN","County or equivalent",2002,31975,-461,-31,350,381,-415,47,-462,-15
"10700",NA,NA,"Albertville, AL","Micropolitan Statistical Area",2002,82819,668,315,1251,936,431,253,178,-78
"10700",NA,1095,"Marshall County, AL","County or equivalent",2002,82819,668,315,1251,936,431,253,178,-78
"10760",NA,NA,"Alexander City, AL","Micropolitan Statistical Area",2002,52476,-655,-131,593,724,-486,2,-488,-38
"10760",NA,1037,"Coosa County, AL","County or equivalent",2002,11558,-207,2,121,119,-201,0,-201,-8
"10760",NA,1123,"Tallapoosa County, AL","County or equivalent",2002,40918,-448,-133,472,605,-285,2,-287,-30
"10820",NA,NA,"Alexandria, MN","Micropolitan Statistical Area",2002,33651,407,14,359,345,417,2,415,-24
"10820",NA,27041,"Douglas County, MN","County or equivalent",2002,33651,407,14,359,345,417,2,415,-24
"10860",NA,NA,"Alice, TX","Micropolitan Statistical Area",2002,39911,162,236,627,391,-35,17,-52,-39
"10860",NA,48249,"Jim Wells County, TX","County or equivalent",2002,39911,162,236,627,391,-35,17,-52,-39
"10880",NA,NA,"Allegan, MI","Micropolitan Statistical Area",2002,108779,1043,474,1400,926,666,116,550,-97
"10880",NA,26005,"Allegan County, MI","County or equivalent",2002,108779,1043,474,1400,926,666,116,550,-97
"10940",NA,NA,"Alma, MI","Micropolitan Statistical Area",2002,42322,-147,44,455,411,-156,13,-169,-35
"10940",NA,26057,"Gratiot County, MI","County or equivalent",2002,42322,-147,44,455,411,-156,13,-169,-35
"10980",NA,NA,"Alpena, MI","Micropolitan Statistical Area",2002,30846,-282,-29,312,341,-224,6,-230,-29
"10980",NA,26007,"Alpena County, MI","County or equivalent",2002,30846,-282,-29,312,341,-224,6,-230,-29
"11060",NA,NA,"Altus, OK","Micropolitan Statistical Area",2002,27342,-543,189,447,258,-726,-51,-675,-6
"11060",NA,40065,"Jackson County, OK","County or equivalent",2002,27342,-543,189,447,258,-726,-51,-675,-6
"11140",NA,NA,"Americus, GA","Micropolitan Statistical Area",2002,36887,-120,207,580,373,-303,41,-344,-24
"11140",NA,13249,"Schley County, GA","County or equivalent",2002,3796,1,-2,38,40,6,7,-1,-3
"11140",NA,13261,"Sumter County, GA","County or equivalent",2002,33091,-121,209,542,333,-309,34,-343,-21
"11220",NA,NA,"Amsterdam, NY","Micropolitan Statistical Area",2002,49012,-327,-63,586,649,-224,18,-242,-40
"11220",NA,36057,"Montgomery County, NY","County or equivalent",2002,49012,-327,-63,586,649,-224,18,-242,-40
"11380",NA,NA,"Andrews, TX","Micropolitan Statistical Area",2002,12870,109,88,204,116,34,16,18,-13
"11380",NA,48003,"Andrews County, TX","County or equivalent",2002,12870,109,88,204,116,34,16,18,-13
"11420",NA,NA,"Angola, IN","Micropolitan Statistical Area",2002,33342,-130,183,435,252,-289,24,-313,-24
"11420",NA,18151,"Steuben County, IN","County or equivalent",2002,33342,-130,183,435,252,-289,24,-313,-24
"11580",NA,NA,"Arcadia, FL","Micropolitan Statistical Area",2002,32598,32,170,451,281,-98,394,-492,-40
"11580",NA,12027,"DeSoto County, FL","County or equivalent",2002,32598,32,170,451,281,-98,394,-492,-40
"11620",NA,NA,"Ardmore, OK","Micropolitan Statistical Area",2002,54676,355,52,759,707,354,34,320,-51
"11620",NA,40019,"Carter County, OK","County or equivalent",2002,45883,290,54,646,592,281,24,257,-45
"11620",NA,40085,"Love County, OK","County or equivalent",2002,8793,65,-2,113,115,73,10,63,-6
"11660",NA,NA,"Arkadelphia, AR","Micropolitan Statistical Area",2002,23537,-114,24,252,228,-121,31,-152,-17
"11660",NA,5019,"Clark County, AR","County or equivalent",2002,23537,-114,24,252,228,-121,31,-152,-17
"11740",NA,NA,"Ashland, OH","Micropolitan Statistical Area",2002,53051,224,242,709,467,35,20,15,-53
"11740",NA,39005,"Ashland County, OH","County or equivalent",2002,53051,224,242,709,467,35,20,15,-53
"11780",NA,NA,"Ashtabula, OH","Micropolitan Statistical Area",2002,102597,-66,142,1240,1098,-112,41,-153,-96
"11780",NA,39007,"Ashtabula County, OH","County or equivalent",2002,102597,-66,142,1240,1098,-112,41,-153,-96
"11820",NA,NA,"Astoria, OR","Micropolitan Statistical Area",2002,35607,69,6,416,410,97,41,56,-34
"11820",NA,41007,"Clatsop County, OR","County or equivalent",2002,35607,69,6,416,410,97,41,56,-34
"11860",NA,NA,"Atchison, KS","Micropolitan Statistical Area",2002,16703,-91,6,201,195,-83,5,-88,-14
"11860",NA,20005,"Atchison County, KS","County or equivalent",2002,16703,-91,6,201,195,-83,5,-88,-14
"11900",NA,NA,"Athens, OH","Micropolitan Statistical Area",2002,63052,220,142,652,510,141,159,-18,-63
"11900",NA,39009,"Athens County, OH","County or equivalent",2002,63052,220,142,652,510,141,159,-18,-63
"11940",NA,NA,"Athens, TN","Micropolitan Statistical Area",2002,50028,253,55,613,558,238,28,210,-40
"11940",NA,47107,"McMinn County, TN","County or equivalent",2002,50028,253,55,613,558,238,28,210,-40
"11980",NA,NA,"Athens, TX","Micropolitan Statistical Area",2002,75064,1022,90,980,890,975,99,876,-43
"11980",NA,48213,"Henderson County, TX","County or equivalent",2002,75064,1022,90,980,890,975,99,876,-43
"12140",NA,NA,"Auburn, IN","Micropolitan Statistical Area",2002,40621,170,297,621,324,-89,18,-107,-38
"12140",NA,18033,"DeKalb County, IN","County or equivalent",2002,40621,170,297,621,324,-89,18,-107,-38
"12180",NA,NA,"Auburn, NY","Micropolitan Statistical Area",2002,81253,-27,190,914,724,-144,33,-177,-73
"12180",NA,36011,"Cayuga County, NY","County or equivalent",2002,81253,-27,190,914,724,-144,33,-177,-73
"12300",NA,NA,"Augusta-Waterville, ME","Micropolitan Statistical Area",2002,118422,457,63,1238,1175,497,36,461,-103
"12300",NA,23011,"Kennebec County, ME","County or equivalent",2002,118422,457,63,1238,1175,497,36,461,-103
"12380",NA,NA,"Austin, MN","Micropolitan Statistical Area",2002,38483,-187,121,525,404,-274,97,-371,-34
"12380",NA,27099,"Mower County, MN","County or equivalent",2002,38483,-187,121,525,404,-274,97,-371,-34
"12460",NA,NA,"Bainbridge, GA","Micropolitan Statistical Area",2002,28060,88,119,409,290,-2,45,-47,-29
"12460",NA,13087,"Decatur County, GA","County or equivalent",2002,28060,88,119,409,290,-2,45,-47,-29
"12660",NA,NA,"Baraboo, WI","Micropolitan Statistical Area",2002,55792,388,198,750,552,242,37,205,-52
"12660",NA,55111,"Sauk County, WI","County or equivalent",2002,55792,388,198,750,552,242,37,205,-52
"12740",NA,NA,"Barre, VT","Micropolitan Statistical Area",2002,58729,287,137,630,493,204,68,136,-54
"12740",NA,50023,"Washington County, VT","County or equivalent",2002,58729,287,137,630,493,204,68,136,-54
"12780",NA,NA,"Bartlesville, OK","Micropolitan Statistical Area",2002,48953,93,17,577,560,121,74,47,-45
"12780",NA,40147,"Washington County, OK","County or equivalent",2002,48953,93,17,577,560,121,74,47,-45
"12820",NA,NA,"Bastrop, LA","Micropolitan Statistical Area",2002,30361,-269,80,445,365,-331,2,-333,-18
"12820",NA,22067,"Morehouse Parish, LA","County or equivalent",2002,30361,-269,80,445,365,-331,2,-333,-18
"12860",NA,NA,"Batavia, NY","Micropolitan Statistical Area",2002,59661,-237,65,634,569,-251,31,-282,-51
"12860",NA,36037,"Genesee County, NY","County or equivalent",2002,59661,-237,65,634,569,-251,31,-282,-51
"12900",NA,NA,"Batesville, AR","Micropolitan Statistical Area",2002,34130,-27,75,452,377,-68,19,-87,-34
"12900",NA,5063,"Independence County, AR","County or equivalent",2002,34130,-27,75,452,377,-68,19,-87,-34
"13060",NA,NA,"Bay City, TX","Micropolitan Statistical Area",2002,37770,-124,191,564,373,-293,157,-450,-22
"13060",NA,48321,"Matagorda County, TX","County or equivalent",2002,37770,-124,191,564,373,-293,157,-450,-22
"13100",NA,NA,"Beatrice, NE","Micropolitan Statistical Area",2002,23117,25,-1,254,255,46,2,44,-20
"13100",NA,31067,"Gage County, NE","County or equivalent",2002,23117,25,-1,254,255,46,2,44,-20
"13180",NA,NA,"Beaver Dam, WI","Micropolitan Statistical Area",2002,86605,340,56,931,875,363,35,328,-79
"13180",NA,55027,"Dodge County, WI","County or equivalent",2002,86605,340,56,931,875,363,35,328,-79
"13220",NA,NA,"Beckley, WV","Micropolitan Statistical Area",2002,78854,526,-23,895,918,605,27,578,-56
"13220",NA,54081,"Raleigh County, WV","County or equivalent",2002,78854,526,-23,895,918,605,27,578,-56
"13260",NA,NA,"Bedford, IN","Micropolitan Statistical Area",2002,45959,23,74,552,478,-7,11,-18,-44
"13260",NA,18093,"Lawrence County, IN","County or equivalent",2002,45959,23,74,552,478,-7,11,-18,-44
"13300",NA,NA,"Beeville, TX","Micropolitan Statistical Area",2002,31973,155,132,371,239,54,4,50,-31
"13300",NA,48025,"Bee County, TX","County or equivalent",2002,31973,155,132,371,239,54,4,50,-31
"13340",NA,NA,"Bellefontaine, OH","Micropolitan Statistical Area",2002,46214,267,217,656,439,92,23,69,-42
"13340",NA,39091,"Logan County, OH","County or equivalent",2002,46214,267,217,656,439,92,23,69,-42
"13420",NA,NA,"Bemidji, MN","Micropolitan Statistical Area",2002,41055,629,224,575,351,439,24,415,-34
"13420",NA,27007,"Beltrami County, MN","County or equivalent",2002,41055,629,224,575,351,439,24,415,-34
"13500",NA,NA,"Bennettsville, SC","Micropolitan Statistical Area",2002,28472,-75,50,408,358,-95,2,-97,-30
"13500",NA,45069,"Marlboro County, SC","County or equivalent",2002,28472,-75,50,408,358,-95,2,-97,-30
"13540",NA,NA,"Bennington, VT","Micropolitan Statistical Area",2002,36953,46,-6,372,378,87,31,56,-35
"13540",NA,50003,"Bennington County, VT","County or equivalent",2002,36953,46,-6,372,378,87,31,56,-35
"13620",NA,NA,"Berlin, NH-VT","Micropolitan Statistical Area",2002,39361,-35,-114,366,480,113,14,99,-34
"13620",NA,33007,"Coos County, NH","County or equivalent",2002,32831,-79,-128,295,423,78,11,67,-29
"13620",NA,50009,"Essex County, VT","County or equivalent",2002,6530,44,14,71,57,35,3,32,-5
"13660",NA,NA,"Big Rapids, MI","Micropolitan Statistical Area",2002,41418,530,153,510,357,404,52,352,-27
"13660",NA,26107,"Mecosta County, MI","County or equivalent",2002,41418,530,153,510,357,404,52,352,-27
"13700",NA,NA,"Big Spring, TX","Micropolitan Statistical Area",2002,32969,-58,52,443,391,-81,25,-106,-29
"13700",NA,48227,"Howard County, TX","County or equivalent",2002,32969,-58,52,443,391,-81,25,-106,-29
"13860",NA,NA,"Bishop, CA","Micropolitan Statistical Area",2002,18081,139,-13,187,200,165,42,123,-13
"13860",NA,6027,"Inyo County, CA","County or equivalent",2002,18081,139,-13,187,200,165,42,123,-13
"13940",NA,NA,"Blackfoot, ID","Micropolitan Statistical Area",2002,41994,-25,448,728,280,-448,74,-522,-25
"13940",NA,16011,"Bingham County, ID","County or equivalent",2002,41994,-25,448,728,280,-448,74,-522,-25
"14100",NA,NA,"Bloomsburg-Berwick, PA","Micropolitan Statistical Area",2002,82455,-52,-31,836,867,53,26,27,-74
"14100",NA,42037,"Columbia County, PA","County or equivalent",2002,64339,83,-25,601,626,165,18,147,-57
"14100",NA,42093,"Montour County, PA","County or equivalent",2002,18116,-135,-6,235,241,-112,8,-120,-17
"14140",NA,NA,"Bluefield, WV-VA","Micropolitan Statistical Area",2002,105944,111,-148,1234,1382,355,22,333,-96
"14140",NA,51185,"Tazewell County, VA","County or equivalent",2002,43955,-28,-99,462,561,113,11,102,-42
"14140",NA,54055,"Mercer County, WV","County or equivalent",2002,61989,139,-49,772,821,242,11,231,-54
"14180",NA,NA,"Blytheville, AR","Micropolitan Statistical Area",2002,49863,-1103,266,842,576,-1360,29,-1389,-9
"14180",NA,5093,"Mississippi County, AR","County or equivalent",2002,49863,-1103,266,842,576,-1360,29,-1389,-9
"14220",NA,NA,"Bogalusa, LA","Micropolitan Statistical Area",2002,43766,-9,172,669,497,-142,0,-142,-39
"14220",NA,22117,"Washington Parish, LA","County or equivalent",2002,43766,-9,172,669,497,-142,0,-142,-39
"14300",NA,NA,"Bonham, TX","Micropolitan Statistical Area",2002,31580,279,-74,344,418,390,29,361,-37
"14300",NA,48147,"Fannin County, TX","County or equivalent",2002,31580,279,-74,344,418,390,29,361,-37
"14340",NA,NA,"Boone, IA","Micropolitan Statistical Area",2002,26044,-176,-3,271,274,-152,5,-157,-21
"14340",NA,19015,"Boone County, IA","County or equivalent",2002,26044,-176,-3,271,274,-152,5,-157,-21
"14380",NA,NA,"Boone, NC","Micropolitan Statistical Area",2002,43393,167,43,333,290,165,48,117,-41
"14380",NA,37189,"Watauga County, NC","County or equivalent",2002,43393,167,43,333,290,165,48,117,-41
"14420",NA,NA,"Borger, TX","Micropolitan Statistical Area",2002,23023,-144,79,335,256,-207,46,-253,-16
"14420",NA,48233,"Hutchinson County, TX","County or equivalent",2002,23023,-144,79,335,256,-207,46,-253,-16
"14580",NA,NA,"Bozeman, MT","Micropolitan Statistical Area",2002,71967,1797,509,857,348,1322,86,1236,-34
"14580",NA,30031,"Gallatin County, MT","County or equivalent",2002,71967,1797,509,857,348,1322,86,1236,-34
"14620",NA,NA,"Bradford, PA","Micropolitan Statistical Area",2002,45351,132,17,508,491,153,4,149,-38
"14620",NA,42083,"McKean County, PA","County or equivalent",2002,45351,132,17,508,491,153,4,149,-38
"14660",NA,NA,"Brainerd, MN","Micropolitan Statistical Area",2002,85075,1326,210,1040,830,1166,14,1152,-50
"14660",NA,27021,"Cass County, MN","County or equivalent",2002,27887,274,31,328,297,264,2,262,-21
"14660",NA,27035,"Crow Wing County, MN","County or equivalent",2002,57188,1052,179,712,533,902,12,890,-29
"14700",NA,NA,"Branson, MO","Micropolitan Statistical Area",2002,70231,1096,91,831,740,1042,41,1001,-37
"14700",NA,29209,"Stone County, MO","County or equivalent",2002,29328,424,-37,280,317,473,12,461,-12
"14700",NA,29213,"Taney County, MO","County or equivalent",2002,40903,672,128,551,423,569,29,540,-25
"14780",NA,NA,"Brenham, TX","Micropolitan Statistical Area",2002,30696,249,26,375,349,246,68,178,-23
"14780",NA,48477,"Washington County, TX","County or equivalent",2002,30696,249,26,375,349,246,68,178,-23
"14820",NA,NA,"Brevard, NC","Micropolitan Statistical Area",2002,29402,103,-91,257,348,220,30,190,-26
"14820",NA,37175,"Transylvania County, NC","County or equivalent",2002,29402,103,-91,257,348,220,30,190,-26
"14940",NA,NA,"Brigham City, UT","Micropolitan Statistical Area",2002,44511,888,492,801,309,141,50,91,255
"14940",NA,49003,"Box Elder County, UT","County or equivalent",2002,44511,888,492,801,309,141,50,91,255
"15020",NA,NA,"Brookhaven, MS","Micropolitan Statistical Area",2002,33297,131,61,433,372,103,4,99,-33
"15020",NA,28085,"Lincoln County, MS","County or equivalent",2002,33297,131,61,433,372,103,4,99,-33
"15060",NA,NA,"Brookings, OR","Micropolitan Statistical Area",2002,21381,281,-186,142,328,473,9,464,-6
"15060",NA,41015,"Curry County, OR","County or equivalent",2002,21381,281,-186,142,328,473,9,464,-6
"15100",NA,NA,"Brookings, SD","Micropolitan Statistical Area",2002,28508,169,174,342,168,22,41,-19,-27
"15100",NA,46011,"Brookings County, SD","County or equivalent",2002,28508,169,174,342,168,22,41,-19,-27
"15140",NA,NA,"Brownsville, TN","Micropolitan Statistical Area",2002,19538,-301,60,289,229,-354,18,-372,-7
"15140",NA,47075,"Haywood County, TN","County or equivalent",2002,19538,-301,60,289,229,-354,18,-372,-7
"15220",NA,NA,"Brownwood, TX","Micropolitan Statistical Area",2002,37803,185,18,497,479,200,25,175,-33
"15220",NA,48049,"Brown County, TX","County or equivalent",2002,37803,185,18,497,479,200,25,175,-33
"15340",NA,NA,"Bucyrus, OH","Micropolitan Statistical Area",2002,46170,-339,53,551,498,-355,3,-358,-37
"15340",NA,39033,"Crawford County, OH","County or equivalent",2002,46170,-339,53,551,498,-355,3,-358,-37
"15420",NA,NA,"Burley, ID","Micropolitan Statistical Area",2002,40677,-296,368,700,332,-651,130,-781,-13
"15420",NA,16031,"Cassia County, ID","County or equivalent",2002,21320,-147,202,375,173,-341,54,-395,-8
"15420",NA,16067,"Minidoka County, ID","County or equivalent",2002,19357,-149,166,325,159,-310,76,-386,-5
"15460",NA,NA,"Burlington, IA-IL","Micropolitan Statistical Area",2002,49409,-689,38,557,519,-699,26,-725,-28
"15460",NA,17071,"Henderson County, IL","County or equivalent",2002,8104,-78,-29,61,90,-41,1,-42,-8
"15460",NA,19057,"Des Moines County, IA","County or equivalent",2002,41305,-611,67,496,429,-658,25,-683,-20
"15580",NA,NA,"Butte-Silver Bow, MT","Micropolitan Statistical Area",2002,33348,-363,-62,372,434,-279,6,-285,-22
"15580",NA,30093,"Silver Bow County, MT","County or equivalent",2002,33348,-363,-62,372,434,-279,6,-285,-22
"15620",NA,NA,"Cadillac, MI","Micropolitan Statistical Area",2002,45591,305,133,560,427,214,11,203,-42
"15620",NA,26113,"Missaukee County, MI","County or equivalent",2002,14838,244,43,174,131,211,-1,212,-10
"15620",NA,26165,"Wexford County, MI","County or equivalent",2002,30753,61,90,386,296,3,12,-9,-32
"15660",NA,NA,"Calhoun, GA","Micropolitan Statistical Area",2002,46539,998,389,804,415,645,207,438,-36
"15660",NA,13129,"Gordon County, GA","County or equivalent",2002,46539,998,389,804,415,645,207,438,-36
"15700",NA,NA,"Cambridge, MD","Micropolitan Statistical Area",2002,30433,-169,-119,296,415,-20,7,-27,-30
"15700",NA,24019,"Dorchester County, MD","County or equivalent",2002,30433,-169,-119,296,415,-20,7,-27,-30
"15740",NA,NA,"Cambridge, OH","Micropolitan Statistical Area",2002,40952,119,71,496,425,86,1,85,-38
"15740",NA,39059,"Guernsey County, OH","County or equivalent",2002,40952,119,71,496,425,86,1,85,-38
"15780",NA,NA,"Camden, AR","Micropolitan Statistical Area",2002,33211,-416,-11,420,431,-388,16,-404,-17
"15780",NA,5013,"Calhoun County, AR","County or equivalent",2002,5604,25,-12,53,65,43,6,37,-6
"15780",NA,5103,"Ouachita County, AR","County or equivalent",2002,27607,-441,1,367,366,-431,10,-441,-11
"15820",NA,NA,"Campbellsville, KY","Micropolitan Statistical Area",2002,23280,344,38,294,256,320,7,313,-14
"15820",NA,21217,"Taylor County, KY","County or equivalent",2002,23280,344,38,294,256,320,7,313,-14
"15860",NA,NA,"Canon City, CO","Micropolitan Statistical Area",2002,47203,453,-66,406,472,554,17,537,-35
"15860",NA,8043,"Fremont County, CO","County or equivalent",2002,47203,453,-66,406,472,554,17,537,-35
"15900",NA,NA,"Canton, IL","Micropolitan Statistical Area",2002,37493,-356,-69,401,470,-260,0,-260,-27
"15900",NA,17057,"Fulton County, IL","County or equivalent",2002,37493,-356,-69,401,470,-260,0,-260,-27
"16020",NA,NA,"Cape Girardeau-Jackson, MO-IL","Micropolitan Statistical Area",2002,91144,240,181,1147,966,154,34,120,-95
"16020",NA,17003,"Alexander County, IL","County or equivalent",2002,9400,-44,9,129,120,-43,1,-44,-10
"16020",NA,29017,"Bollinger County, MO","County or equivalent",2002,12249,9,33,159,126,-10,0,-10,-14
"16020",NA,29031,"Cape Girardeau County, MO","County or equivalent",2002,69495,275,139,859,720,207,33,174,-71
"16060",NA,NA,"Carbondale, IL","Micropolitan Statistical Area",2002,58567,-784,202,648,446,-970,261,-1231,-16
"16060",NA,17077,"Jackson County, IL","County or equivalent",2002,58567,-784,202,648,446,-970,261,-1231,-16
"16100",NA,NA,"Carlsbad-Artesia, NM","Micropolitan Statistical Area",2002,50805,129,228,778,550,-49,43,-92,-50
"16100",NA,35015,"Eddy County, NM","County or equivalent",2002,50805,129,228,778,550,-49,43,-92,-50
"16260",NA,NA,"Cedar City, UT","Micropolitan Statistical Area",2002,35657,927,574,756,182,383,67,316,-30
"16260",NA,49021,"Iron County, UT","County or equivalent",2002,35657,927,574,756,182,383,67,316,-30
"16340",NA,NA,"Cedartown, GA","Micropolitan Statistical Area",2002,39366,608,311,737,426,332,138,194,-35
"16340",NA,13233,"Polk County, GA","County or equivalent",2002,39366,608,311,737,426,332,138,194,-35
"16380",NA,NA,"Celina, OH","Micropolitan Statistical Area",2002,40775,-12,205,545,340,-184,10,-194,-33
"16380",NA,39107,"Mercer County, OH","County or equivalent",2002,40775,-12,205,545,340,-184,10,-194,-33
"16420",NA,NA,"Central City, KY","Micropolitan Statistical Area",2002,31555,-154,-28,351,379,-98,0,-98,-28
"16420",NA,21177,"Muhlenberg County, KY","County or equivalent",2002,31555,-154,-28,351,379,-98,0,-98,-28
"16460",NA,NA,"Centralia, IL","Micropolitan Statistical Area",2002,40897,-470,-14,494,508,-427,0,-427,-29
"16460",NA,17121,"Marion County, IL","County or equivalent",2002,40897,-470,-14,494,508,-427,0,-427,-29
"16500",NA,NA,"Centralia, WA","Micropolitan Statistical Area",2002,69334,443,72,843,771,431,117,314,-60
"16500",NA,53041,"Lewis County, WA","County or equivalent",2002,69334,443,72,843,771,431,117,314,-60
"16540",NA,NA,"Chambersburg, PA","Micropolitan Statistical Area",2002,131225,1076,324,1533,1209,878,122,756,-126
"16540",NA,42055,"Franklin County, PA","County or equivalent",2002,131225,1076,324,1533,1209,878,122,756,-126
"16660",NA,NA,"Charleston-Mattoon, IL","Micropolitan Statistical Area",2002,63085,-386,92,714,622,-431,38,-469,-47
"16660",NA,17029,"Coles County, IL","County or equivalent",2002,52029,-290,102,589,487,-354,34,-388,-38
"16660",NA,17035,"Cumberland County, IL","County or equivalent",2002,11056,-96,-10,125,135,-77,4,-81,-9
"16900",NA,NA,"Chester, SC","Micropolitan Statistical Area",2002,33867,-67,193,509,316,-223,12,-235,-37
"16900",NA,45023,"Chester County, SC","County or equivalent",2002,33867,-67,193,509,316,-223,12,-235,-37
"17060",NA,NA,"Chillicothe, OH","Micropolitan Statistical Area",2002,73895,303,208,932,724,166,21,145,-71
"17060",NA,39141,"Ross County, OH","County or equivalent",2002,73895,303,208,932,724,166,21,145,-71
"17180",NA,NA,"City of The Dalles, OR","Micropolitan Statistical Area",2002,23491,-208,-28,287,315,-164,38,-202,-16
"17180",NA,41065,"Wasco County, OR","County or equivalent",2002,23491,-208,-28,287,315,-164,38,-202,-16
"17200",NA,NA,"Claremont, NH","Micropolitan Statistical Area",2002,41188,322,62,476,414,291,24,267,-31
"17200",NA,33019,"Sullivan County, NH","County or equivalent",2002,41188,322,62,476,414,291,24,267,-31
"17220",NA,NA,"Clarksburg, WV","Micropolitan Statistical Area",2002,91234,-162,-134,1022,1156,61,30,31,-89
"17220",NA,54017,"Doddridge County, WV","County or equivalent",2002,7433,-65,-15,74,89,-43,-1,-42,-7
"17220",NA,54033,"Harrison County, WV","County or equivalent",2002,67813,-48,-67,792,859,83,31,52,-64
"17220",NA,54091,"Taylor County, WV","County or equivalent",2002,15988,-49,-52,156,208,21,0,21,-18
"17260",NA,NA,"Clarksdale, MS","Micropolitan Statistical Area",2002,29837,-431,184,539,355,-602,11,-613,-13
"17260",NA,28027,"Coahoma County, MS","County or equivalent",2002,29837,-431,184,539,355,-602,11,-613,-13
"17340",NA,NA,"Clearlake, CA","Micropolitan Statistical Area",2002,61657,1349,-203,616,819,1562,104,1458,-10
"17340",NA,6033,"Lake County, CA","County or equivalent",2002,61657,1349,-203,616,819,1562,104,1458,-10
"17380",NA,NA,"Cleveland, MS","Micropolitan Statistical Area",2002,39210,-854,212,638,426,-1062,5,-1067,-4
"17380",NA,28011,"Bolivar County, MS","County or equivalent",2002,39210,-854,212,638,426,-1062,5,-1067,-4
"17500",NA,NA,"Clewiston, FL","Micropolitan Statistical Area",2002,36209,44,415,681,266,-358,409,-767,-13
"17500",NA,12051,"Hendry County, FL","County or equivalent",2002,36209,44,415,681,266,-358,409,-767,-13
"17540",NA,NA,"Clinton, IA","Micropolitan Statistical Area",2002,49600,-241,70,603,533,-272,32,-304,-39
"17540",NA,19045,"Clinton County, IA","County or equivalent",2002,49600,-241,70,603,533,-272,32,-304,-39
"17580",NA,NA,"Clovis, NM","Micropolitan Statistical Area",2002,44648,17,398,815,417,-347,-61,-286,-34
"17580",NA,35009,"Curry County, NM","County or equivalent",2002,44648,17,398,815,417,-347,-61,-286,-34
"17700",NA,NA,"Coffeyville, KS","Micropolitan Statistical Area",2002,35165,-590,-14,488,502,-557,23,-580,-19
"17700",NA,20125,"Montgomery County, KS","County or equivalent",2002,35165,-590,-14,488,502,-557,23,-580,-19
"17740",NA,NA,"Coldwater, MI","Micropolitan Statistical Area",2002,46516,507,115,542,427,427,83,344,-35
"17740",NA,26023,"Branch County, MI","County or equivalent",2002,46516,507,115,542,427,427,83,344,-35
"17940",NA,NA,"Columbia, TN","Micropolitan Statistical Area",2002,71208,1073,326,987,661,800,106,694,-53
"17940",NA,47119,"Maury County, TN","County or equivalent",2002,71208,1073,326,987,661,800,106,694,-53
"18060",NA,NA,"Columbus, MS","Micropolitan Statistical Area",2002,60680,-287,397,913,516,-644,-52,-592,-40
"18060",NA,28087,"Lowndes County, MS","County or equivalent",2002,60680,-287,397,913,516,-644,-52,-592,-40
"18100",NA,NA,"Columbus, NE","Micropolitan Statistical Area",2002,31059,-337,155,407,252,-469,65,-534,-23
"18100",NA,31141,"Platte County, NE","County or equivalent",2002,31059,-337,155,407,252,-469,65,-534,-23
"18180",NA,NA,"Concord, NH","Micropolitan Statistical Area",2002,141404,2807,515,1624,1109,2354,147,2207,-62
"18180",NA,33013,"Merrimack County, NH","County or equivalent",2002,141404,2807,515,1624,1109,2354,147,2207,-62
"18220",NA,NA,"Connersville, IN","Micropolitan Statistical Area",2002,25061,-190,-22,294,316,-150,1,-151,-18
"18220",NA,18041,"Fayette County, IN","County or equivalent",2002,25061,-190,-22,294,316,-150,1,-151,-18
"18260",NA,NA,"Cookeville, TN","Micropolitan Statistical Area",2002,95463,957,107,1134,1027,924,150,774,-74
"18260",NA,47087,"Jackson County, TN","County or equivalent",2002,11089,-25,-42,97,139,27,4,23,-10
"18260",NA,47133,"Overton County, TN","County or equivalent",2002,20213,30,-44,226,270,90,-1,91,-16
"18260",NA,47141,"Putnam County, TN","County or equivalent",2002,64161,952,193,811,618,807,147,660,-48
"18300",NA,NA,"Coos Bay, OR","Micropolitan Statistical Area",2002,62250,81,-300,587,887,430,36,394,-49
"18300",NA,41011,"Coos County, OR","County or equivalent",2002,62250,81,-300,587,887,430,36,394,-49
"18340",NA,NA,"Corbin, KY","Micropolitan Statistical Area",2002,36673,227,70,490,420,193,9,184,-36
"18340",NA,21235,"Whitley County, KY","County or equivalent",2002,36673,227,70,490,420,193,9,184,-36
"18380",NA,NA,"Cordele, GA","Micropolitan Statistical Area",2002,21979,-40,93,331,238,-116,34,-150,-17
"18380",NA,13081,"Crisp County, GA","County or equivalent",2002,21979,-40,93,331,238,-116,34,-150,-17
"18420",NA,NA,"Corinth, MS","Micropolitan Statistical Area",2002,34743,90,76,486,410,50,23,27,-36
"18420",NA,28003,"Alcorn County, MS","County or equivalent",2002,34743,90,76,486,410,50,23,27,-36
"18460",NA,NA,"Cornelia, GA","Micropolitan Statistical Area",2002,37562,573,186,511,325,418,145,273,-31
"18460",NA,13137,"Habersham County, GA","County or equivalent",2002,37562,573,186,511,325,418,145,273,-31
"18500",NA,NA,"Corning, NY","Micropolitan Statistical Area",2002,99007,68,98,1151,1053,66,49,17,-96
"18500",NA,36101,"Steuben County, NY","County or equivalent",2002,99007,68,98,1151,1053,66,49,17,-96
"18620",NA,NA,"Corsicana, TX","Micropolitan Statistical Area",2002,46648,670,151,668,517,564,247,317,-45
"18620",NA,48349,"Navarro County, TX","County or equivalent",2002,46648,670,151,668,517,564,247,317,-45
"18660",NA,NA,"Cortland, NY","Micropolitan Statistical Area",2002,48425,-184,140,550,410,-283,33,-316,-41
"18660",NA,36023,"Cortland County, NY","County or equivalent",2002,48425,-184,140,550,410,-283,33,-316,-41
"18740",NA,NA,"Coshocton, OH","Micropolitan Statistical Area",2002,36856,42,119,475,356,-38,27,-65,-39
"18740",NA,39031,"Coshocton County, OH","County or equivalent",2002,36856,42,119,475,356,-38,27,-65,-39
"18820",NA,NA,"Crawfordsville, IN","Micropolitan Statistical Area",2002,37727,-37,145,509,364,-153,50,-203,-29
"18820",NA,18107,"Montgomery County, IN","County or equivalent",2002,37727,-37,145,509,364,-153,50,-203,-29
"18860",NA,NA,"Crescent City, CA","Micropolitan Statistical Area",2002,27492,148,63,309,246,114,61,53,-29
"18860",NA,6015,"Del Norte County, CA","County or equivalent",2002,27492,148,63,309,246,114,61,53,-29
"18900",NA,NA,"Crossville, TN","Micropolitan Statistical Area",2002,48598,905,-61,477,538,986,10,976,-20
"18900",NA,47035,"Cumberland County, TN","County or equivalent",2002,48598,905,-61,477,538,986,10,976,-20
"18940",NA,NA,"Crowley, LA","Micropolitan Statistical Area",2002,58803,71,294,924,630,-171,8,-179,-52
"18940",NA,22001,"Acadia Parish, LA","County or equivalent",2002,58803,71,294,924,630,-171,8,-179,-52
"18980",NA,NA,"Cullman, AL","Micropolitan Statistical Area",2002,77790,138,39,966,927,171,90,81,-72
"18980",NA,1043,"Cullman County, AL","County or equivalent",2002,77790,138,39,966,927,171,90,81,-72
"19020",NA,NA,"Culpeper, VA","Micropolitan Statistical Area",2002,36644,1327,174,507,333,1155,69,1086,-2
"19020",NA,51047,"Culpeper County, VA","County or equivalent",2002,36644,1327,174,507,333,1155,69,1086,-2
"19220",NA,NA,"Danville, KY","Micropolitan Statistical Area",2002,51632,229,59,643,584,215,63,152,-45
"19220",NA,21021,"Boyle County, KY","County or equivalent",2002,27667,59,-22,297,319,106,50,56,-25
"19220",NA,21137,"Lincoln County, KY","County or equivalent",2002,23965,170,81,346,265,109,13,96,-20
"19300",NA,NA,"Daphne-Fairhope-Foley, AL","Micropolitan Statistical Area",2002,148031,3095,307,1753,1446,2758,163,2595,30
"19300",NA,1003,"Baldwin County, AL","County or equivalent",2002,148031,3095,307,1753,1446,2758,163,2595,30
"19540",NA,NA,"Decatur, IN","Micropolitan Statistical Area",2002,33497,-57,304,592,288,-339,9,-348,-22
"19540",NA,18001,"Adams County, IN","County or equivalent",2002,33497,-57,304,592,288,-339,9,-348,-22
"19580",NA,NA,"Defiance, OH","Micropolitan Statistical Area",2002,39129,-242,151,487,336,-367,15,-382,-26
"19580",NA,39039,"Defiance County, OH","County or equivalent",2002,39129,-242,151,487,336,-367,15,-382,-26
"19620",NA,NA,"Del Rio, TX","Micropolitan Statistical Area",2002,45471,373,539,879,340,-128,153,-281,-38
"19620",NA,48465,"Val Verde County, TX","County or equivalent",2002,45471,373,539,879,340,-128,153,-281,-38
"19700",NA,NA,"Deming, NM","Micropolitan Statistical Area",2002,25051,211,161,406,245,71,165,-94,-21
"19700",NA,35029,"Luna County, NM","County or equivalent",2002,25051,211,161,406,245,71,165,-94,-21
"19760",NA,NA,"De Ridder, LA","Micropolitan Statistical Area",2002,33081,18,131,442,311,-83,-4,-79,-30
"19760",NA,22011,"Beauregard Parish, LA","County or equivalent",2002,33081,18,131,442,311,-83,-4,-79,-30
"19860",NA,NA,"Dickinson, ND","Micropolitan Statistical Area",2002,23013,-228,35,253,218,-248,11,-259,-15
"19860",NA,38007,"Billings County, ND","County or equivalent",2002,860,-23,8,11,3,-29,2,-31,-2
"19860",NA,38089,"Stark County, ND","County or equivalent",2002,22153,-205,27,242,215,-219,9,-228,-13
"19900",NA,NA,"Dillon, SC","Micropolitan Statistical Area",2002,30793,-90,158,511,353,-226,21,-247,-22
"19900",NA,45033,"Dillon County, SC","County or equivalent",2002,30793,-90,158,511,353,-226,21,-247,-22
"19940",NA,NA,"Dixon, IL","Micropolitan Statistical Area",2002,35483,-433,-28,353,381,-384,15,-399,-21
"19940",NA,17103,"Lee County, IL","County or equivalent",2002,35483,-433,-28,353,381,-384,15,-399,-21
"19980",NA,NA,"Dodge City, KS","Micropolitan Statistical Area",2002,32164,-117,370,648,278,-485,415,-900,-2
"19980",NA,20057,"Ford County, KS","County or equivalent",2002,32164,-117,370,648,278,-485,415,-900,-2
"20060",NA,NA,"Douglas, GA","Micropolitan Statistical Area",2002,46207,403,410,827,417,36,189,-153,-43
"20060",NA,13003,"Atkinson County, GA","County or equivalent",2002,7709,81,76,154,78,12,56,-44,-7
"20060",NA,13069,"Coffee County, GA","County or equivalent",2002,38498,322,334,673,339,24,133,-109,-36
"20140",NA,NA,"Dublin, GA","Micropolitan Statistical Area",2002,54525,908,239,779,540,708,29,679,-39
"20140",NA,13167,"Johnson County, GA","County or equivalent",2002,8922,446,23,120,97,418,2,416,5
"20140",NA,13175,"Laurens County, GA","County or equivalent",2002,45603,462,216,659,443,290,27,263,-44
"20180",NA,NA,"DuBois, PA","Micropolitan Statistical Area",2002,82979,-2,-101,799,900,175,13,162,-76
"20180",NA,42033,"Clearfield County, PA","County or equivalent",2002,82979,-2,-101,799,900,175,13,162,-76
"20300",NA,NA,"Dumas, TX","Micropolitan Statistical Area",2002,19970,-210,238,385,147,-444,153,-597,-4
"20300",NA,48341,"Moore County, TX","County or equivalent",2002,19970,-210,238,385,147,-444,153,-597,-4
"20340",NA,NA,"Duncan, OK","Micropolitan Statistical Area",2002,42462,-162,-40,519,559,-77,0,-77,-45
"20340",NA,40137,"Stephens County, OK","County or equivalent",2002,42462,-162,-40,519,559,-77,0,-77,-45
"20380",NA,NA,"Dunn, NC","Micropolitan Statistical Area",2002,96566,2976,745,1456,711,2253,115,2138,-22
"20380",NA,37085,"Harnett County, NC","County or equivalent",2002,96566,2976,745,1456,711,2253,115,2138,-22
"20420",NA,NA,"Durango, CO","Micropolitan Statistical Area",2002,45967,874,215,457,242,684,31,653,-25
"20420",NA,8067,"La Plata County, CO","County or equivalent",2002,45967,874,215,457,242,684,31,653,-25
"20460",NA,NA,"Durant, OK","Micropolitan Statistical Area",2002,36764,305,136,508,372,200,45,155,-31
"20460",NA,40013,"Bryan County, OK","County or equivalent",2002,36764,305,136,508,372,200,45,155,-31
"20540",NA,NA,"Dyersburg, TN","Micropolitan Statistical Area",2002,37064,-43,94,520,426,-104,38,-142,-33
"20540",NA,47045,"Dyer County, TN","County or equivalent",2002,37064,-43,94,520,426,-104,38,-142,-33
"20580",NA,NA,"Eagle Pass, TX","Micropolitan Statistical Area",2002,48373,794,894,1170,276,-62,296,-358,-38
"20580",NA,48323,"Maverick County, TX","County or equivalent",2002,48373,794,894,1170,276,-62,296,-358,-38
"20620",NA,NA,"East Liverpool-Salem, OH","Micropolitan Statistical Area",2002,111069,-329,0,1270,1270,-229,18,-247,-100
"20620",NA,39029,"Columbiana County, OH","County or equivalent",2002,111069,-329,0,1270,1270,-229,18,-247,-100
"20660",NA,NA,"Easton, MD","Micropolitan Statistical Area",2002,34344,246,-43,357,400,323,30,293,-34
"20660",NA,24041,"Talbot County, MD","County or equivalent",2002,34344,246,-43,357,400,323,30,293,-34
"20700",NA,NA,"East Stroudsburg, PA","Micropolitan Statistical Area",2002,148241,4698,365,1517,1152,4332,143,4189,1
"20700",NA,42089,"Monroe County, PA","County or equivalent",2002,148241,4698,365,1517,1152,4332,143,4189,1
"20780",NA,NA,"Edwards, CO","Micropolitan Statistical Area",2002,52282,1087,780,899,119,355,691,-336,-48
"20780",NA,8037,"Eagle County, CO","County or equivalent",2002,44501,1118,689,770,81,476,593,-117,-47
"20780",NA,8065,"Lake County, CO","County or equivalent",2002,7781,-31,91,129,38,-121,98,-219,-1
"20820",NA,NA,"Effingham, IL","Micropolitan Statistical Area",2002,34313,-46,98,452,354,-115,13,-128,-29
"20820",NA,17049,"Effingham County, IL","County or equivalent",2002,34313,-46,98,452,354,-115,13,-128,-29
"20900",NA,NA,"El Campo, TX","Micropolitan Statistical Area",2002,40901,-81,163,626,463,-209,125,-334,-35
"20900",NA,48481,"Wharton County, TX","County or equivalent",2002,40901,-81,163,626,463,-209,125,-334,-35
"20980",NA,NA,"El Dorado, AR","Micropolitan Statistical Area",2002,45026,-24,23,594,571,-2,32,-34,-45
"20980",NA,5139,"Union County, AR","County or equivalent",2002,45026,-24,23,594,571,-2,32,-34,-45
"21020",NA,NA,"Elizabeth City, NC","Micropolitan Statistical Area",2002,54362,913,82,650,568,860,-7,867,-29
"21020",NA,37029,"Camden County, NC","County or equivalent",2002,7382,301,6,78,72,291,-6,297,4
"21020",NA,37139,"Pasquotank County, NC","County or equivalent",2002,35498,598,117,448,331,502,1,501,-21
"21020",NA,37143,"Perquimans County, NC","County or equivalent",2002,11482,14,-41,124,165,67,-2,69,-12
"21120",NA,NA,"Elk City, OK","Micropolitan Statistical Area",2002,19846,70,25,293,268,66,10,56,-21
"21120",NA,40009,"Beckham County, OK","County or equivalent",2002,19846,70,25,293,268,66,10,56,-21
"21220",NA,NA,"Elko, NV","Micropolitan Statistical Area",2002,45636,-986,360,609,249,-1348,154,-1502,2
"21220",NA,32007,"Elko County, NV","County or equivalent",2002,44044,-959,350,588,238,-1312,143,-1455,3
"21220",NA,32011,"Eureka County, NV","County or equivalent",2002,1592,-27,10,21,11,-36,11,-47,-1
"21260",NA,NA,"Ellensburg, WA","Micropolitan Statistical Area",2002,34764,876,93,343,250,798,78,720,-15
"21260",NA,53037,"Kittitas County, WA","County or equivalent",2002,34764,876,93,343,250,798,78,720,-15
"21380",NA,NA,"Emporia, KS","Micropolitan Statistical Area",2002,38777,-204,277,613,336,-463,189,-652,-18
"21380",NA,20017,"Chase County, KS","County or equivalent",2002,3027,47,56,90,34,-5,6,-11,-4
"21380",NA,20111,"Lyon County, KS","County or equivalent",2002,35750,-251,221,523,302,-458,183,-641,-14
"21420",NA,NA,"Enid, OK","Micropolitan Statistical Area",2002,57119,-62,68,809,741,-75,-14,-61,-55
"21420",NA,40047,"Garfield County, OK","County or equivalent",2002,57119,-62,68,809,741,-75,-14,-61,-55
"21460",NA,NA,"Enterprise-Ozark, AL","Micropolitan Statistical Area",2002,92804,235,376,1251,875,-55,-159,104,-86
"21460",NA,1031,"Coffee County, AL","County or equivalent",2002,43754,175,92,525,433,121,-29,150,-38
"21460",NA,1045,"Dale County, AL","County or equivalent",2002,49050,60,284,726,442,-176,-130,-46,-48
"21540",NA,NA,"Escanaba, MI","Micropolitan Statistical Area",2002,38257,-82,10,427,417,-56,7,-63,-36
"21540",NA,26041,"Delta County, MI","County or equivalent",2002,38257,-82,10,427,417,-56,7,-63,-36
"21580",NA,NA,"Espanola, NM","Micropolitan Statistical Area",2002,40888,-93,354,696,342,-423,94,-517,-24
"21580",NA,35039,"Rio Arriba County, NM","County or equivalent",2002,40888,-93,354,696,342,-423,94,-517,-24
"21640",NA,NA,"Eufaula, AL-GA","Micropolitan Statistical Area",2002,31852,12,46,412,366,-216,45,-261,182
"21640",NA,1005,"Barbour County, AL","County or equivalent",2002,29266,56,43,377,334,-171,41,-212,184
"21640",NA,13239,"Quitman County, GA","County or equivalent",2002,2586,-44,3,35,32,-45,4,-49,-2
"21700",NA,NA,"Eureka-Arcata-Fortuna, CA","Micropolitan Statistical Area",2002,127784,781,226,1464,1238,675,135,540,-120
"21700",NA,6023,"Humboldt County, CA","County or equivalent",2002,127784,781,226,1464,1238,675,135,540,-120
"21740",NA,NA,"Evanston, WY","Micropolitan Statistical Area",2002,19565,160,188,300,112,-9,12,-21,-19
"21740",NA,56041,"Uinta County, WY","County or equivalent",2002,19565,160,188,300,112,-9,12,-21,-19
"21860",NA,NA,"Fairmont, MN","Micropolitan Statistical Area",2002,21198,-223,-41,235,276,-166,6,-172,-16
"21860",NA,27091,"Martin County, MN","County or equivalent",2002,21198,-223,-41,235,276,-166,6,-172,-16
"21900",NA,NA,"Fairmont, WV","Micropolitan Statistical Area",2002,56158,-5,-143,601,744,186,18,168,-48
"21900",NA,54049,"Marion County, WV","County or equivalent",2002,56158,-5,-143,601,744,186,18,168,-48
"21980",NA,NA,"Fallon, NV","Micropolitan Statistical Area",2002,24079,-231,344,524,180,-569,-20,-549,-6
"21980",NA,32001,"Churchill County, NV","County or equivalent",2002,24079,-231,344,524,180,-569,-20,-549,-6
"22060",NA,NA,"Faribault-Northfield, MN","Micropolitan Statistical Area",2002,58369,668,275,714,439,444,160,284,-51
"22060",NA,27131,"Rice County, MN","County or equivalent",2002,58369,668,275,714,439,444,160,284,-51
"22100",NA,NA,"Farmington, MO","Micropolitan Statistical Area",2002,56544,455,-17,724,741,516,15,501,-44
"22100",NA,29187,"St. Francois County, MO","County or equivalent",2002,56544,455,-17,724,741,516,15,501,-44
"22260",NA,NA,"Fergus Falls, MN","Micropolitan Statistical Area",2002,57195,102,-80,582,662,230,83,147,-48
"22260",NA,27111,"Otter Tail County, MN","County or equivalent",2002,57195,102,-80,582,662,230,83,147,-48
"22280",NA,NA,"Fernley, NV","Micropolitan Statistical Area",2002,37762,1632,47,420,373,1589,49,1540,-4
"22280",NA,32019,"Lyon County, NV","County or equivalent",2002,37762,1632,47,420,373,1589,49,1540,-4
"22300",NA,NA,"Findlay, OH","Micropolitan Statistical Area",2002,72511,582,321,929,608,330,76,254,-69
"22300",NA,39063,"Hancock County, OH","County or equivalent",2002,72511,582,321,929,608,330,76,254,-69
"22340",NA,NA,"Fitzgerald, GA","Micropolitan Statistical Area",2002,27121,-161,93,439,346,-235,51,-286,-19
"22340",NA,13017,"Ben Hill County, GA","County or equivalent",2002,17158,-140,71,289,218,-201,33,-234,-10
"22340",NA,13155,"Irwin County, GA","County or equivalent",2002,9963,-21,22,150,128,-34,18,-52,-9
"22580",NA,NA,"Forest City, NC","Micropolitan Statistical Area",2002,62972,-183,37,788,751,-165,28,-193,-55
"22580",NA,37161,"Rutherford County, NC","County or equivalent",2002,62972,-183,37,788,751,-165,28,-193,-55
"22620",NA,NA,"Forrest City, AR","Micropolitan Statistical Area",2002,28548,-286,145,478,333,-413,1,-414,-18
"22620",NA,5123,"St. Francis County, AR","County or equivalent",2002,28548,-286,145,478,333,-413,1,-414,-18
"22700",NA,NA,"Fort Dodge, IA","Micropolitan Statistical Area",2002,39667,-369,33,483,450,-369,25,-394,-33
"22700",NA,19187,"Webster County, IA","County or equivalent",2002,39667,-369,33,483,450,-369,25,-394,-33
"22780",NA,NA,"Fort Leonard Wood, MO","Micropolitan Statistical Area",2002,43765,912,333,637,304,584,-522,1106,-5
"22780",NA,29169,"Pulaski County, MO","County or equivalent",2002,43765,912,333,637,304,584,-522,1106,-5
"22800",NA,NA,"Fort Madison-Keokuk, IA-MO","Micropolitan Statistical Area",2002,44222,-592,-19,475,494,-548,14,-562,-25
"22800",NA,19111,"Lee County, IA","County or equivalent",2002,36855,-526,-18,399,417,-488,15,-503,-20
"22800",NA,29045,"Clark County, MO","County or equivalent",2002,7367,-66,-1,76,77,-60,-1,-59,-5
"22820",NA,NA,"Fort Morgan, CO","Micropolitan Statistical Area",2002,27513,237,229,482,253,31,188,-157,-23
"22820",NA,8087,"Morgan County, CO","County or equivalent",2002,27513,237,229,482,253,31,188,-157,-23
"22840",NA,NA,"Fort Payne, AL","Micropolitan Statistical Area",2002,65470,-18,302,932,630,-270,172,-442,-50
"22840",NA,1049,"DeKalb County, AL","County or equivalent",2002,65470,-18,302,932,630,-270,172,-442,-50
"22860",NA,NA,"Fort Polk South, LA","Micropolitan Statistical Area",2002,51514,-709,641,980,339,-1330,-381,-949,-20
"22860",NA,22115,"Vernon Parish, LA","County or equivalent",2002,51514,-709,641,980,339,-1330,-381,-949,-20
"22980",NA,NA,"Fort Valley, GA","Micropolitan Statistical Area",2002,24206,237,172,373,201,89,68,21,-24
"22980",NA,13225,"Peach County, GA","County or equivalent",2002,24206,237,172,373,201,89,68,21,-24
"23140",NA,NA,"Frankfort, IN","Micropolitan Statistical Area",2002,33836,-98,188,498,310,-267,163,-430,-19
"23140",NA,18023,"Clinton County, IN","County or equivalent",2002,33836,-98,188,498,310,-267,163,-430,-19
"23180",NA,NA,"Frankfort, KY","Micropolitan Statistical Area",2002,67609,35,181,822,641,-81,68,-149,-65
"23180",NA,21005,"Anderson County, KY","County or equivalent",2002,19429,-29,62,230,168,-73,4,-77,-18
"23180",NA,21073,"Franklin County, KY","County or equivalent",2002,48180,64,119,592,473,-8,64,-72,-47
"23240",NA,NA,"Fredericksburg, TX","Micropolitan Statistical Area",2002,21567,468,-70,204,274,550,42,508,-12
"23240",NA,48171,"Gillespie County, TX","County or equivalent",2002,21567,468,-70,204,274,550,42,508,-12
"23300",NA,NA,"Freeport, IL","Micropolitan Statistical Area",2002,48039,-406,58,582,524,-434,59,-493,-30
"23300",NA,17177,"Stephenson County, IL","County or equivalent",2002,48039,-406,58,582,524,-434,59,-493,-30
"23340",NA,NA,"Fremont, NE","Micropolitan Statistical Area",2002,35822,-197,48,456,408,-219,33,-252,-26
"23340",NA,31053,"Dodge County, NE","County or equivalent",2002,35822,-197,48,456,408,-219,33,-252,-26
"23380",NA,NA,"Fremont, OH","Micropolitan Statistical Area",2002,61684,9,227,842,615,-165,11,-176,-53
"23380",NA,39143,"Sandusky County, OH","County or equivalent",2002,61684,9,227,842,615,-165,11,-176,-53
"23500",NA,NA,"Gaffney, SC","Micropolitan Statistical Area",2002,53324,338,154,742,588,229,34,195,-45
"23500",NA,45021,"Cherokee County, SC","County or equivalent",2002,53324,338,154,742,588,229,34,195,-45
"23620",NA,NA,"Gainesville, TX","Micropolitan Statistical Area",2002,37455,560,120,503,383,473,122,351,-33
"23620",NA,48097,"Cooke County, TX","County or equivalent",2002,37455,560,120,503,383,473,122,351,-33
"23660",NA,NA,"Galesburg, IL","Micropolitan Statistical Area",2002,72981,-631,-81,791,872,-496,17,-513,-54
"23660",NA,17095,"Knox County, IL","County or equivalent",2002,54657,-513,-87,590,677,-386,14,-400,-40
"23660",NA,17187,"Warren County, IL","County or equivalent",2002,18324,-118,6,201,195,-110,3,-113,-14
"23700",NA,NA,"Gallup, NM","Micropolitan Statistical Area",2002,72879,-1533,921,1365,444,-2459,46,-2505,5
"23700",NA,35031,"McKinley County, NM","County or equivalent",2002,72879,-1533,921,1365,444,-2459,46,-2505,5
"23780",NA,NA,"Garden City, KS","Micropolitan Statistical Area",2002,40122,-516,584,795,211,-1504,418,-1922,404
"23780",NA,20055,"Finney County, KS","County or equivalent",2002,40122,-516,584,795,211,-1504,418,-1922,404
"23820",NA,NA,"Gardnerville Ranchos, NV","Micropolitan Statistical Area",2002,43049,916,76,385,309,863,45,818,-23
"23820",NA,32005,"Douglas County, NV","County or equivalent",2002,43049,916,76,385,309,863,45,818,-23
"23860",NA,NA,"Georgetown, SC","Micropolitan Statistical Area",2002,57679,894,203,751,548,738,54,684,-47
"23860",NA,45043,"Georgetown County, SC","County or equivalent",2002,57679,894,203,751,548,738,54,684,-47
"23900",NA,NA,"Gettysburg, PA","Micropolitan Statistical Area",2002,94137,1369,155,1071,916,1281,131,1150,-67
"23900",NA,42001,"Adams County, PA","County or equivalent",2002,94137,1369,155,1071,916,1281,131,1150,-67
"23940",NA,NA,"Gillette, WY","Micropolitan Statistical Area",2002,35854,1335,313,501,188,1023,18,1005,-1
"23940",NA,56005,"Campbell County, WY","County or equivalent",2002,35854,1335,313,501,188,1023,18,1005,-1
"23980",NA,NA,"Glasgow, KY","Micropolitan Statistical Area",2002,48556,10,13,562,549,38,27,11,-41
"23980",NA,21009,"Barren County, KY","County or equivalent",2002,38587,129,30,436,406,134,26,108,-35
"23980",NA,21169,"Metcalfe County, KY","County or equivalent",2002,9969,-119,-17,126,143,-96,1,-97,-6
"24100",NA,NA,"Gloversville, NY","Micropolitan Statistical Area",2002,54870,6,41,631,590,20,31,-11,-55
"24100",NA,36035,"Fulton County, NY","County or equivalent",2002,54870,6,41,631,590,20,31,-11,-55
"24180",NA,NA,"Granbury, TX","Micropolitan Statistical Area",2002,50706,1161,-14,559,573,1195,73,1122,-20
"24180",NA,48221,"Hood County, TX","County or equivalent",2002,43611,967,-19,466,485,1001,59,942,-15
"24180",NA,48425,"Somervell County, TX","County or equivalent",2002,7095,194,5,93,88,194,14,180,-5
"24260",NA,NA,"Grand Island, NE","Micropolitan Statistical Area",2002,68093,175,407,1055,648,-180,260,-440,-52
"24260",NA,31079,"Hall County, NE","County or equivalent",2002,53585,188,408,918,510,-182,255,-437,-38
"24260",NA,31093,"Howard County, NE","County or equivalent",2002,6478,-5,0,54,54,2,2,0,-7
"24260",NA,31121,"Merrick County, NE","County or equivalent",2002,8030,-8,-1,83,84,0,3,-3,-7
"24380",NA,NA,"Grants, NM","Micropolitan Statistical Area",2002,26688,59,158,378,220,-75,13,-88,-24
"24380",NA,35006,"Cibola County, NM","County or equivalent",2002,26688,59,158,378,220,-75,13,-88,-24
"24420",NA,NA,"Grants Pass, OR","Micropolitan Statistical Area",2002,77421,1114,-298,733,1031,1459,20,1439,-47
"24420",NA,41033,"Josephine County, OR","County or equivalent",2002,77421,1114,-298,733,1031,1459,20,1439,-47
"24460",NA,NA,"Great Bend, KS","Micropolitan Statistical Area",2002,27894,-29,56,362,306,-209,72,-281,124
"24460",NA,20009,"Barton County, KS","County or equivalent",2002,27894,-29,56,362,306,-209,72,-281,124
"24620",NA,NA,"Greeneville, TN","Micropolitan Statistical Area",2002,63402,140,-71,704,775,265,45,220,-54
"24620",NA,47059,"Greene County, TN","County or equivalent",2002,63402,140,-71,704,775,265,45,220,-54
"24700",NA,NA,"Greensburg, IN","Micropolitan Statistical Area",2002,24648,138,165,365,200,-4,32,-36,-23
"24700",NA,18031,"Decatur County, IN","County or equivalent",2002,24648,138,165,365,200,-4,32,-36,-23
"24740",NA,NA,"Greenville, MS","Micropolitan Statistical Area",2002,60347,-1304,352,1015,663,-1648,25,-1673,-8
"24740",NA,28151,"Washington County, MS","County or equivalent",2002,60347,-1304,352,1015,663,-1648,25,-1673,-8
"24820",NA,NA,"Greenville, OH","Micropolitan Statistical Area",2002,52832,-197,66,618,552,-220,5,-225,-43
"24820",NA,39037,"Darke County, OH","County or equivalent",2002,52832,-197,66,618,552,-220,5,-225,-43
"24900",NA,NA,"Greenwood, MS","Micropolitan Statistical Area",2002,46921,-779,196,696,500,-961,19,-980,-14
"24900",NA,28015,"Carroll County, MS","County or equivalent",2002,10485,-172,18,105,87,-185,4,-189,-5
"24900",NA,28083,"Leflore County, MS","County or equivalent",2002,36436,-607,178,591,413,-776,15,-791,-9
"24940",NA,NA,"Greenwood, SC","Micropolitan Statistical Area",2002,66967,414,243,920,677,234,153,81,-63
"24940",NA,45047,"Greenwood County, SC","County or equivalent",2002,66967,414,243,920,677,234,153,81,-63
"24980",NA,NA,"Grenada, MS","Micropolitan Statistical Area",2002,22935,-107,-36,265,301,-50,12,-62,-21
"24980",NA,28043,"Grenada County, MS","County or equivalent",2002,22935,-107,-36,265,301,-50,12,-62,-21
"25100",NA,NA,"Guymon, OK","Micropolitan Statistical Area",2002,19944,-125,211,366,155,-330,231,-561,-6
"25100",NA,40139,"Texas County, OK","County or equivalent",2002,19944,-125,211,366,155,-330,231,-561,-6
"25220",NA,NA,"Hammond, LA","Micropolitan Statistical Area",2002,102285,677,671,1588,917,105,22,83,-99
"25220",NA,22105,"Tangipahoa Parish, LA","County or equivalent",2002,102285,677,671,1588,917,105,22,83,-99
"25300",NA,NA,"Hannibal, MO","Micropolitan Statistical Area",2002,37655,-86,29,483,454,-83,13,-96,-32
"25300",NA,29127,"Marion County, MO","County or equivalent",2002,28023,-82,52,406,354,-111,11,-122,-23
"25300",NA,29173,"Ralls County, MO","County or equivalent",2002,9632,-4,-23,77,100,28,2,26,-9
"25340",NA,NA,"Harriman, TN","Micropolitan Statistical Area",2002,52099,51,-50,545,595,149,23,126,-48
"25340",NA,47145,"Roane County, TN","County or equivalent",2002,52099,51,-50,545,595,149,23,126,-48
"25380",NA,NA,"Harrisburg, IL","Micropolitan Statistical Area",2002,26271,-99,-80,317,397,6,6,0,-25
"25380",NA,17165,"Saline County, IL","County or equivalent",2002,26271,-99,-80,317,397,6,6,0,-25
"25460",NA,NA,"Harrison, AR","Micropolitan Statistical Area",2002,42934,159,48,500,452,148,10,138,-37
"25460",NA,5009,"Boone County, AR","County or equivalent",2002,34427,176,56,431,375,148,10,138,-28
"25460",NA,5101,"Newton County, AR","County or equivalent",2002,8507,-17,-8,69,77,0,0,0,-9
"25580",NA,NA,"Hastings, NE","Micropolitan Statistical Area",2002,38520,36,89,482,393,-448,109,-557,395
"25580",NA,31001,"Adams County, NE","County or equivalent",2002,31691,113,87,406,319,-373,105,-478,399
"25580",NA,31035,"Clay County, NE","County or equivalent",2002,6829,-77,2,76,74,-75,4,-79,-4
"25660",NA,NA,"Havre, MT","Micropolitan Statistical Area",2002,16297,-170,116,266,150,-279,1,-280,-7
"25660",NA,30041,"Hill County, MT","County or equivalent",2002,16297,-170,116,266,150,-279,1,-280,-7
"25700",NA,NA,"Hays, KS","Micropolitan Statistical Area",2002,27406,-126,82,341,259,-187,32,-219,-21
"25700",NA,20051,"Ellis County, KS","County or equivalent",2002,27406,-126,82,341,259,-187,32,-219,-21
"25720",NA,NA,"Heber, UT","Micropolitan Statistical Area",2002,16741,650,259,369,110,397,48,349,-6
"25720",NA,49051,"Wasatch County, UT","County or equivalent",2002,16741,650,259,369,110,397,48,349,-6
"25740",NA,NA,"Helena, MT","Micropolitan Statistical Area",2002,66353,42,174,743,569,-77,16,-93,-55
"25740",NA,30043,"Jefferson County, MT","County or equivalent",2002,10226,106,-1,90,91,113,-1,114,-6
"25740",NA,30049,"Lewis and Clark County, MT","County or equivalent",2002,56127,-64,175,653,478,-190,17,-207,-49
"25760",NA,NA,"Helena-West Helena, AR","Micropolitan Statistical Area",2002,24775,-887,103,445,342,-991,6,-997,1
"25760",NA,5107,"Phillips County, AR","County or equivalent",2002,24775,-887,103,445,342,-991,6,-997,1
"25780",NA,NA,"Henderson, NC","Micropolitan Statistical Area",2002,43517,-125,224,713,489,-320,110,-430,-29
"25780",NA,37181,"Vance County, NC","County or equivalent",2002,43517,-125,224,713,489,-320,110,-430,-29
"25820",NA,NA,"Hereford, TX","Micropolitan Statistical Area",2002,18255,-38,215,382,167,-242,60,-302,-11
"25820",NA,48117,"Deaf Smith County, TX","County or equivalent",2002,18255,-38,215,382,167,-242,60,-302,-11
"25900",NA,NA,"Hilo, HI","Micropolitan Statistical Area",2002,153040,2234,653,1915,1262,1687,433,1254,-106
"25900",NA,15001,"Hawaii County, HI","County or equivalent",2002,153040,2234,653,1915,1262,1687,433,1254,-106
"25940",NA,NA,"Hilton Head Island-Beaufort, SC","Micropolitan Statistical Area",2002,149247,3640,1084,2261,1177,2626,43,2583,-70
"25940",NA,45013,"Beaufort County, SC","County or equivalent",2002,128415,3675,984,1978,994,2746,-64,2810,-55
"25940",NA,45053,"Jasper County, SC","County or equivalent",2002,20832,-35,100,283,183,-120,107,-227,-15
"26020",NA,NA,"Hobbs, NM","Micropolitan Statistical Area",2002,55375,534,409,903,494,177,94,83,-52
"26020",NA,35025,"Lea County, NM","County or equivalent",2002,55375,534,409,903,494,177,94,83,-52
"26140",NA,NA,"Homosassa Springs, FL","Micropolitan Statistical Area",2002,123215,2145,-1183,849,2032,3335,64,3271,-7
"26140",NA,12017,"Citrus County, FL","County or equivalent",2002,123215,2145,-1183,849,2032,3335,64,3271,-7
"26220",NA,NA,"Hood River, OR","Micropolitan Statistical Area",2002,20609,215,145,326,181,91,111,-20,-21
"26220",NA,41027,"Hood River County, OR","County or equivalent",2002,20609,215,145,326,181,91,111,-20,-21
"26260",NA,NA,"Hope, AR","Micropolitan Statistical Area",2002,32920,-188,60,457,397,-227,128,-355,-21
"26260",NA,5057,"Hempstead County, AR","County or equivalent",2002,23221,-77,52,327,275,-114,115,-229,-15
"26260",NA,5099,"Nevada County, AR","County or equivalent",2002,9699,-111,8,130,122,-113,13,-126,-6
"26340",NA,NA,"Houghton, MI","Micropolitan Statistical Area",2002,37902,49,12,411,399,71,60,11,-34
"26340",NA,26061,"Houghton County, MI","County or equivalent",2002,35653,94,17,391,374,111,59,52,-34
"26340",NA,26083,"Keweenaw County, MI","County or equivalent",2002,2249,-45,-5,20,25,-40,1,-41,0
"26460",NA,NA,"Hudson, NY","Micropolitan Statistical Area",2002,62859,46,-90,599,689,193,67,126,-57
"26460",NA,36021,"Columbia County, NY","County or equivalent",2002,62859,46,-90,599,689,193,67,126,-57
"26480",NA,NA,"Humboldt, TN","Micropolitan Statistical Area",2002,47908,-92,-56,629,685,9,22,-13,-45
"26480",NA,47053,"Gibson County, TN","County or equivalent",2002,47908,-92,-56,629,685,9,22,-13,-45
"26500",NA,NA,"Huntingdon, PA","Micropolitan Statistical Area",2002,45642,80,79,482,403,44,4,40,-43
"26500",NA,42061,"Huntingdon County, PA","County or equivalent",2002,45642,80,79,482,403,44,4,40,-43
"26540",NA,NA,"Huntington, IN","Micropolitan Statistical Area",2002,38149,176,87,464,377,125,9,116,-36
"26540",NA,18069,"Huntington County, IN","County or equivalent",2002,38149,176,87,464,377,125,9,116,-36
"26660",NA,NA,"Huntsville, TX","Micropolitan Statistical Area",2002,61656,-564,156,587,431,-680,102,-782,-40
"26660",NA,48471,"Walker County, TX","County or equivalent",2002,61656,-564,156,587,431,-680,102,-782,-40
"26700",NA,NA,"Huron, SD","Micropolitan Statistical Area",2002,16518,-287,22,198,176,-300,5,-305,-9
"26700",NA,46005,"Beadle County, SD","County or equivalent",2002,16518,-287,22,198,176,-300,5,-305,-9
"26740",NA,NA,"Hutchinson, KS","Micropolitan Statistical Area",2002,63965,-504,121,832,711,-585,52,-637,-40
"26740",NA,20155,"Reno County, KS","County or equivalent",2002,63965,-504,121,832,711,-585,52,-637,-40
"26780",NA,NA,"Hutchinson, MN","Micropolitan Statistical Area",2002,35450,280,210,485,275,106,30,76,-36
"26780",NA,27085,"McLeod County, MN","County or equivalent",2002,35450,280,210,485,275,106,30,76,-36
"26860",NA,NA,"Indiana, PA","Micropolitan Statistical Area",2002,88882,-288,-68,878,946,-140,50,-190,-80
"26860",NA,42063,"Indiana County, PA","County or equivalent",2002,88882,-288,-68,878,946,-140,50,-190,-80
"26940",NA,NA,"Indianola, MS","Micropolitan Statistical Area",2002,33525,-429,183,497,314,-593,14,-607,-19
"26940",NA,28133,"Sunflower County, MS","County or equivalent",2002,33525,-429,183,497,314,-593,14,-607,-19
"27020",NA,NA,"Iron Mountain, MI-WI","Micropolitan Statistical Area",2002,32199,-37,-55,328,383,47,4,43,-29
"27020",NA,26043,"Dickinson County, MI","County or equivalent",2002,27096,-88,-44,288,332,-19,3,-22,-25
"27020",NA,55037,"Florence County, WI","County or equivalent",2002,5103,51,-11,40,51,66,1,65,-4
"27220",NA,NA,"Jackson, WY-ID","Micropolitan Statistical Area",2002,25420,443,236,338,102,228,142,86,-21
"27220",NA,16081,"Teton County, ID","County or equivalent",2002,6721,322,98,125,27,226,53,173,-2
"27220",NA,56039,"Teton County, WY","County or equivalent",2002,18699,121,138,213,75,2,89,-87,-19
"27300",NA,NA,"Jacksonville, IL","Micropolitan Statistical Area",2002,41524,-287,-7,486,493,-248,12,-260,-32
"27300",NA,17137,"Morgan County, IL","County or equivalent",2002,36071,-229,-1,434,435,-199,12,-211,-29
"27300",NA,17171,"Scott County, IL","County or equivalent",2002,5453,-58,-6,52,58,-49,0,-49,-3
"27380",NA,NA,"Jacksonville, TX","Micropolitan Statistical Area",2002,46678,-43,201,763,562,-206,200,-406,-38
"27380",NA,48073,"Cherokee County, TX","County or equivalent",2002,46678,-43,201,763,562,-206,200,-406,-38
"27420",NA,NA,"Jamestown, ND","Micropolitan Statistical Area",2002,21372,-191,-21,213,234,-153,6,-159,-17
"27420",NA,38093,"Stutsman County, ND","County or equivalent",2002,21372,-191,-21,213,234,-153,6,-159,-17
"27460",NA,NA,"Jamestown-Dunkirk-Fredonia, NY","Micropolitan Statistical Area",2002,138008,-596,14,1547,1533,-482,50,-532,-128
"27460",NA,36013,"Chautauqua County, NY","County or equivalent",2002,138008,-596,14,1547,1533,-482,50,-532,-128
"27540",NA,NA,"Jasper, IN","Micropolitan Statistical Area",2002,52780,54,168,673,505,-68,60,-128,-46
"27540",NA,18037,"Dubois County, IN","County or equivalent",2002,39937,43,179,531,352,-102,58,-160,-34
"27540",NA,18125,"Pike County, IN","County or equivalent",2002,12843,11,-11,142,153,34,2,32,-12
"27660",NA,NA,"Jennings, LA","Micropolitan Statistical Area",2002,30947,-153,143,444,301,-274,3,-277,-22
"27660",NA,22053,"Jefferson Davis Parish, LA","County or equivalent",2002,30947,-153,143,444,301,-274,3,-277,-22
"27700",NA,NA,"Jesup, GA","Micropolitan Statistical Area",2002,27210,363,137,385,248,245,16,229,-19
"27700",NA,13305,"Wayne County, GA","County or equivalent",2002,27210,363,137,385,248,245,16,229,-19
"27940",NA,NA,"Juneau, AK","Micropolitan Statistical Area",2002,30706,231,261,403,142,1,38,-37,-31
"27940",NA,2110,"Juneau City and Borough, AK","County or equivalent",2002,30706,231,261,403,142,1,38,-37,-31
"27980",NA,NA,"Kahului-Wailuku, HI","Micropolitan Statistical Area",2002,132531,1266,928,1819,891,476,559,-83,-138
"27980",NA,15009,"Maui County, HI","County or equivalent",2002,132531,1266,928,1819,891,476,559,-83,-138
"28060",NA,NA,"Kalispell, MT","Micropolitan Statistical Area",2002,77269,1282,316,975,659,1017,31,986,-51
"28060",NA,30029,"Flathead County, MT","County or equivalent",2002,77269,1282,316,975,659,1017,31,986,-51
"28180",NA,NA,"Kapaa, HI","Micropolitan Statistical Area",2002,59409,687,328,779,451,410,138,272,-51
"28180",NA,15007,"Kauai County, HI","County or equivalent",2002,59409,687,328,779,451,410,138,272,-51
"28260",NA,NA,"Kearney, NE","Micropolitan Statistical Area",2002,49712,460,268,666,398,237,43,194,-45
"28260",NA,31019,"Buffalo County, NE","County or equivalent",2002,42945,523,275,592,317,288,44,244,-40
"28260",NA,31099,"Kearney County, NE","County or equivalent",2002,6767,-63,-7,74,81,-51,-1,-50,-5
"28300",NA,NA,"Keene, NH","Micropolitan Statistical Area",2002,75015,631,52,757,705,633,35,598,-54
"28300",NA,33005,"Cheshire County, NH","County or equivalent",2002,75015,631,52,757,705,633,35,598,-54
"28340",NA,NA,"Kendallville, IN","Micropolitan Statistical Area",2002,46770,-195,295,650,355,-464,161,-625,-26
"28340",NA,18113,"Noble County, IN","County or equivalent",2002,46770,-195,295,650,355,-464,161,-625,-26
"28380",NA,NA,"Kennett, MO","Micropolitan Statistical Area",2002,32647,-226,-6,464,470,-191,24,-215,-29
"28380",NA,29069,"Dunklin County, MO","County or equivalent",2002,32647,-226,-6,464,470,-191,24,-215,-29
"28500",NA,NA,"Kerrville, TX","Micropolitan Statistical Area",2002,44648,443,-147,517,664,626,89,537,-36
"28500",NA,48265,"Kerr County, TX","County or equivalent",2002,44648,443,-147,517,664,626,89,537,-36
"28540",NA,NA,"Ketchikan, AK","Micropolitan Statistical Area",2002,13562,-200,97,185,88,-292,6,-298,-5
"28540",NA,2130,"Ketchikan Gateway Borough, AK","County or equivalent",2002,13562,-200,97,185,88,-292,6,-298,-5
"28580",NA,NA,"Key West, FL","Micropolitan Statistical Area",2002,78790,-209,-20,706,726,-90,325,-415,-99
"28580",NA,12087,"Monroe County, FL","County or equivalent",2002,78790,-209,-20,706,726,-90,325,-415,-99
"28620",NA,NA,"Kill Devil Hills, NC","Micropolitan Statistical Area",2002,32051,1127,102,366,264,1026,35,991,-1
"28620",NA,37055,"Dare County, NC","County or equivalent",2002,32051,1127,102,366,264,1026,35,991,-1
"28780",NA,NA,"Kingsville, TX","Micropolitan Statistical Area",2002,31611,66,258,524,266,-166,34,-200,-26
"28780",NA,48261,"Kenedy County, TX","County or equivalent",2002,420,4,1,5,4,4,2,2,-1
"28780",NA,48273,"Kleberg County, TX","County or equivalent",2002,31191,62,257,519,262,-170,32,-202,-25
"28820",NA,NA,"Kinston, NC","Micropolitan Statistical Area",2002,58490,-488,97,823,726,-546,76,-622,-39
"28820",NA,37107,"Lenoir County, NC","County or equivalent",2002,58490,-488,97,823,726,-546,76,-622,-39
"28860",NA,NA,"Kirksville, MO","Micropolitan Statistical Area",2002,29136,78,41,336,295,66,29,37,-29
"28860",NA,29001,"Adair County, MO","County or equivalent",2002,24966,51,52,296,244,24,27,-3,-25
"28860",NA,29197,"Schuyler County, MO","County or equivalent",2002,4170,27,-11,40,51,42,2,40,-4
"28900",NA,NA,"Klamath Falls, OR","Micropolitan Statistical Area",2002,64087,-15,102,803,701,-56,54,-110,-61
"28900",NA,41035,"Klamath County, OR","County or equivalent",2002,64087,-15,102,803,701,-56,54,-110,-61
"28980",NA,NA,"Kodiak, AK","Micropolitan Statistical Area",2002,13597,-96,171,214,43,-261,39,-300,-6
"28980",NA,2150,"Kodiak Island Borough, AK","County or equivalent",2002,13597,-96,171,214,43,-261,39,-300,-6
"29060",NA,NA,"Laconia, NH","Micropolitan Statistical Area",2002,58984,1140,-52,540,592,1221,43,1178,-29
"29060",NA,33001,"Belknap County, NH","County or equivalent",2002,58984,1140,-52,540,592,1221,43,1178,-29
"29220",NA,NA,"La Follette, TN","Micropolitan Statistical Area",2002,39839,32,-53,455,508,121,27,94,-36
"29220",NA,47013,"Campbell County, TN","County or equivalent",2002,39839,32,-53,455,508,121,27,94,-36
"29260",NA,NA,"La Grande, OR","Micropolitan Statistical Area",2002,24467,120,58,319,261,90,30,60,-28
"29260",NA,41061,"Union County, OR","County or equivalent",2002,24467,120,58,319,261,90,30,60,-28
"29300",NA,NA,"LaGrange, GA","Micropolitan Statistical Area",2002,59827,194,280,930,650,-29,73,-102,-57
"29300",NA,13285,"Troup County, GA","County or equivalent",2002,59827,194,280,930,650,-29,73,-102,-57
"29380",NA,NA,"Lake City, FL","Micropolitan Statistical Area",2002,58323,1007,147,791,644,903,35,868,-43
"29380",NA,12023,"Columbia County, FL","County or equivalent",2002,58323,1007,147,791,644,903,35,868,-43
"29500",NA,NA,"Lamesa, TX","Micropolitan Statistical Area",2002,14418,-439,44,187,143,-483,30,-513,0
"29500",NA,48115,"Dawson County, TX","County or equivalent",2002,14418,-439,44,187,143,-483,30,-513,0
"29580",NA,NA,"Lancaster, SC","Micropolitan Statistical Area",2002,64856,1756,189,763,574,264,61,203,1303
"29580",NA,45057,"Lancaster County, SC","County or equivalent",2002,64856,1756,189,763,574,264,61,203,1303
"29660",NA,NA,"Laramie, WY","Micropolitan Statistical Area",2002,32249,48,168,359,191,-90,64,-154,-30
"29660",NA,56001,"Albany County, WY","County or equivalent",2002,32249,48,168,359,191,-90,64,-154,-30
"29780",NA,NA,"Las Vegas, NM","Micropolitan Statistical Area",2002,29484,-215,149,394,245,-347,10,-357,-17
"29780",NA,35047,"San Miguel County, NM","County or equivalent",2002,29484,-215,149,394,245,-347,10,-357,-17
"29860",NA,NA,"Laurel, MS","Micropolitan Statistical Area",2002,83098,-58,355,1229,874,-345,151,-496,-68
"29860",NA,28061,"Jasper County, MS","County or equivalent",2002,18222,-97,63,250,187,-148,5,-153,-12
"29860",NA,28067,"Jones County, MS","County or equivalent",2002,64876,39,292,979,687,-197,146,-343,-56
"29900",NA,NA,"Laurinburg, NC","Micropolitan Statistical Area",2002,35527,-406,159,475,316,-549,20,-569,-16
"29900",NA,37165,"Scotland County, NC","County or equivalent",2002,35527,-406,159,475,316,-549,20,-569,-16
"29980",NA,NA,"Lawrenceburg, TN","Micropolitan Statistical Area",2002,40494,500,156,579,423,371,14,357,-27
"29980",NA,47099,"Lawrence County, TN","County or equivalent",2002,40494,500,156,579,423,371,14,357,-27
"30060",NA,NA,"Lebanon, MO","Micropolitan Statistical Area",2002,32862,-24,80,427,347,-74,6,-80,-30
"30060",NA,29105,"Laclede County, MO","County or equivalent",2002,32862,-24,80,427,347,-74,6,-80,-30
"30100",NA,NA,"Lebanon, NH-VT","Micropolitan Statistical Area",2002,168836,811,183,1625,1442,781,143,638,-153
"30100",NA,33009,"Grafton County, NH","County or equivalent",2002,82502,615,151,816,665,539,101,438,-75
"30100",NA,50017,"Orange County, VT","County or equivalent",2002,28664,39,49,291,242,18,6,12,-28
"30100",NA,50027,"Windsor County, VT","County or equivalent",2002,57670,157,-17,518,535,224,36,188,-50
"30220",NA,NA,"Levelland, TX","Micropolitan Statistical Area",2002,22567,0,133,349,216,-112,29,-141,-21
"30220",NA,48219,"Hockley County, TX","County or equivalent",2002,22567,0,133,349,216,-112,29,-141,-21
"30260",NA,NA,"Lewisburg, PA","Micropolitan Statistical Area",2002,42043,90,53,404,351,75,17,58,-38
"30260",NA,42119,"Union County, PA","County or equivalent",2002,42043,90,53,404,351,75,17,58,-38
"30280",NA,NA,"Lewisburg, TN","Micropolitan Statistical Area",2002,27274,150,123,389,266,55,41,14,-28
"30280",NA,47117,"Marshall County, TN","County or equivalent",2002,27274,150,123,389,266,55,41,14,-28
"30380",NA,NA,"Lewistown, PA","Micropolitan Statistical Area",2002,46420,-56,61,548,487,-74,5,-79,-43
"30380",NA,42087,"Mifflin County, PA","County or equivalent",2002,46420,-56,61,548,487,-74,5,-79,-43
"30420",NA,NA,"Lexington, NE","Micropolitan Statistical Area",2002,26277,-179,195,449,254,-365,196,-561,-9
"30420",NA,31047,"Dawson County, NE","County or equivalent",2002,24221,-162,195,419,224,-351,195,-546,-6
"30420",NA,31073,"Gosper County, NE","County or equivalent",2002,2056,-17,0,30,30,-14,1,-15,-3
"30500",NA,NA,"Lexington Park, MD","Micropolitan Statistical Area",2002,89860,2409,763,1353,590,1682,-102,1784,-36
"30500",NA,24037,"St. Mary's County, MD","County or equivalent",2002,89860,2409,763,1353,590,1682,-102,1784,-36
"30580",NA,NA,"Liberal, KS","Micropolitan Statistical Area",2002,22730,211,343,491,148,-122,347,-469,-10
"30580",NA,20175,"Seward County, KS","County or equivalent",2002,22730,211,343,491,148,-122,347,-469,-10
"30660",NA,NA,"Lincoln, IL","Micropolitan Statistical Area",2002,30711,-169,-22,329,351,-122,7,-129,-25
"30660",NA,17107,"Logan County, IL","County or equivalent",2002,30711,-169,-22,329,351,-122,7,-129,-25
"30740",NA,NA,"Lincolnton, NC","Micropolitan Statistical Area",2002,66022,897,294,881,587,658,270,388,-55
"30740",NA,37109,"Lincoln County, NC","County or equivalent",2002,66022,897,294,881,587,658,270,388,-55
"30820",NA,NA,"Lock Haven, PA","Micropolitan Statistical Area",2002,37530,-182,17,409,392,-166,12,-178,-33
"30820",NA,42035,"Clinton County, PA","County or equivalent",2002,37530,-182,17,409,392,-166,12,-178,-33
"30900",NA,NA,"Logansport, IN","Micropolitan Statistical Area",2002,40360,-547,125,575,450,-648,95,-743,-24
"30900",NA,18017,"Cass County, IN","County or equivalent",2002,40360,-547,125,575,450,-648,95,-743,-24
"30940",NA,NA,"London, KY","Micropolitan Statistical Area",2002,54300,763,268,785,517,533,28,505,-38
"30940",NA,21125,"Laurel County, KY","County or equivalent",2002,54300,763,268,785,517,533,28,505,-38
"31060",NA,NA,"Los Alamos, NM","Micropolitan Statistical Area",2002,18126,476,85,181,96,399,65,334,-8
"31060",NA,35028,"Los Alamos County, NM","County or equivalent",2002,18126,476,85,181,96,399,65,334,-8
"31260",NA,NA,"Lufkin, TX","Micropolitan Statistical Area",2002,80208,258,536,1286,750,-210,168,-378,-68
"31260",NA,48005,"Angelina County, TX","County or equivalent",2002,80208,258,536,1286,750,-210,168,-378,-68
"31300",NA,NA,"Lumberton, NC","Micropolitan Statistical Area",2002,123943,381,866,2041,1175,-379,456,-835,-106
"31300",NA,37155,"Robeson County, NC","County or equivalent",2002,123943,381,866,2041,1175,-379,456,-835,-106
"31380",NA,NA,"Macomb, IL","Micropolitan Statistical Area",2002,32798,7,-31,274,305,71,71,0,-33
"31380",NA,17109,"McDonough County, IL","County or equivalent",2002,32798,7,-31,274,305,71,71,0,-33
"31500",NA,NA,"Madison, IN","Micropolitan Statistical Area",2002,31963,27,52,341,289,7,8,-1,-32
"31500",NA,18077,"Jefferson County, IN","County or equivalent",2002,31963,27,52,341,289,7,8,-1,-32
"31580",NA,NA,"Madisonville, KY","Micropolitan Statistical Area",2002,46222,148,2,579,577,190,12,178,-44
"31580",NA,21107,"Hopkins County, KY","County or equivalent",2002,46222,148,2,579,577,190,12,178,-44
"31620",NA,NA,"Magnolia, AR","Micropolitan Statistical Area",2002,25174,-140,-15,303,318,-103,14,-117,-22
"31620",NA,5027,"Columbia County, AR","County or equivalent",2002,25174,-140,-15,303,318,-103,14,-117,-22
"31660",NA,NA,"Malone, NY","Micropolitan Statistical Area",2002,50562,-227,36,463,427,-222,8,-230,-41
"31660",NA,36033,"Franklin County, NY","County or equivalent",2002,50562,-227,36,463,427,-222,8,-230,-41
"31740",NA,NA,"Manhattan, KS","Micropolitan Statistical Area",2002,110160,574,1056,1763,707,-1574,-220,-1354,1092
"31740",NA,20061,"Geary County, KS","County or equivalent",2002,28146,160,383,592,209,-806,-115,-691,583
"31740",NA,20149,"Pottawatomie County, KS","County or equivalent",2002,18325,52,113,277,164,-45,-3,-42,-16
"31740",NA,20161,"Riley County, KS","County or equivalent",2002,63689,362,560,894,334,-723,-102,-621,525
"31820",NA,NA,"Manitowoc, WI","Micropolitan Statistical Area",2002,82051,-592,9,855,846,-538,96,-634,-63
"31820",NA,55071,"Manitowoc County, WI","County or equivalent",2002,82051,-592,9,855,846,-538,96,-634,-63
"31860",NA,NA,"Mankato-North Mankato, MN","Micropolitan Statistical Area",2002,87371,699,421,1048,627,360,123,237,-82
"31860",NA,27013,"Blue Earth County, MN","County or equivalent",2002,56962,461,222,659,437,289,86,203,-50
"31860",NA,27103,"Nicollet County, MN","County or equivalent",2002,30409,238,199,389,190,71,37,34,-32
"31940",NA,NA,"Marinette, WI-MI","Micropolitan Statistical Area",2002,68186,-186,-198,621,819,74,18,56,-62
"31940",NA,26109,"Menominee County, MI","County or equivalent",2002,24981,-174,-45,252,297,-106,7,-113,-23
"31940",NA,55075,"Marinette County, WI","County or equivalent",2002,43205,-12,-153,369,522,180,11,169,-39
"31980",NA,NA,"Marion, IN","Micropolitan Statistical Area",2002,72099,-640,93,872,779,-676,17,-693,-57
"31980",NA,18053,"Grant County, IN","County or equivalent",2002,72099,-640,93,872,779,-676,17,-693,-57
"32020",NA,NA,"Marion, OH","Micropolitan Statistical Area",2002,65880,-125,151,774,623,-218,17,-235,-58
"32020",NA,39101,"Marion County, OH","County or equivalent",2002,65880,-125,151,774,623,-218,17,-235,-58
"32060",NA,NA,"Marion-Herrin, IL","Micropolitan Statistical Area",2002,62089,352,-3,707,710,395,12,383,-40
"32060",NA,17199,"Williamson County, IL","County or equivalent",2002,62089,352,-3,707,710,395,12,383,-40
"32100",NA,NA,"Marquette, MI","Micropolitan Statistical Area",2002,64762,138,-8,632,640,211,18,193,-65
"32100",NA,26103,"Marquette County, MI","County or equivalent",2002,64762,138,-8,632,640,211,18,193,-65
"32140",NA,NA,"Marshall, MN","Micropolitan Statistical Area",2002,24968,-400,98,327,229,-490,61,-551,-8
"32140",NA,27083,"Lyon County, MN","County or equivalent",2002,24968,-400,98,327,229,-490,61,-551,-8
"32180",NA,NA,"Marshall, MO","Micropolitan Statistical Area",2002,22957,-446,1,275,274,-438,44,-482,-9
"32180",NA,29195,"Saline County, MO","County or equivalent",2002,22957,-446,1,275,274,-438,44,-482,-9
"32220",NA,NA,"Marshall, TX","Micropolitan Statistical Area",2002,61973,-301,193,820,627,-444,92,-536,-50
"32220",NA,48203,"Harrison County, TX","County or equivalent",2002,61973,-301,193,820,627,-444,92,-536,-50
"32260",NA,NA,"Marshalltown, IA","Micropolitan Statistical Area",2002,39026,-237,9,520,511,-219,137,-356,-27
"32260",NA,19127,"Marshall County, IA","County or equivalent",2002,39026,-237,9,520,511,-219,137,-356,-27
"32270",NA,NA,"Marshfield-Wisconsin Rapids, WI","Micropolitan Statistical Area",2002,75098,-250,207,836,629,-397,67,-464,-60
"32270",NA,55141,"Wood County, WI","County or equivalent",2002,75098,-250,207,836,629,-397,67,-464,-60
"32280",NA,NA,"Martin, TN","Micropolitan Statistical Area",2002,34191,-154,0,384,384,-125,43,-168,-29
"32280",NA,47183,"Weakley County, TN","County or equivalent",2002,34191,-154,0,384,384,-125,43,-168,-29
"32300",NA,NA,"Martinsville, VA","Micropolitan Statistical Area",2002,72103,-625,-84,798,882,-489,189,-678,-52
"32300",NA,51089,"Henry County, VA","County or equivalent",2002,57062,-389,-24,606,630,-322,149,-471,-43
"32300",NA,51690,"Martinsville city, VA","County or equivalent",2002,15041,-236,-60,192,252,-167,40,-207,-9
"32340",NA,NA,"Maryville, MO","Micropolitan Statistical Area",2002,21986,48,4,204,200,69,19,50,-25
"32340",NA,29147,"Nodaway County, MO","County or equivalent",2002,21986,48,4,204,200,69,19,50,-25
"32380",NA,NA,"Mason City, IA","Micropolitan Statistical Area",2002,53061,-482,-45,567,612,-398,29,-427,-39
"32380",NA,19033,"Cerro Gordo County, IA","County or equivalent",2002,45264,-477,-28,488,516,-417,25,-442,-32
"32380",NA,19195,"Worth County, IA","County or equivalent",2002,7797,-5,-17,79,96,19,4,15,-7
"32460",NA,NA,"Mayfield, KY","Micropolitan Statistical Area",2002,36945,-36,27,478,451,-27,66,-93,-36
"32460",NA,21083,"Graves County, KY","County or equivalent",2002,36945,-36,27,478,451,-27,66,-93,-36
"32500",NA,NA,"Maysville, KY","Micropolitan Statistical Area",2002,30513,-269,-9,353,362,-236,15,-251,-24
"32500",NA,21135,"Lewis County, KY","County or equivalent",2002,13704,-282,-20,148,168,-255,1,-256,-7
"32500",NA,21161,"Mason County, KY","County or equivalent",2002,16809,13,11,205,194,19,14,5,-17
"32540",NA,NA,"McAlester, OK","Micropolitan Statistical Area",2002,43780,424,-12,508,520,463,17,446,-27
"32540",NA,40121,"Pittsburg County, OK","County or equivalent",2002,43780,424,-12,508,520,463,17,446,-27
"32620",NA,NA,"McComb, MS","Micropolitan Statistical Area",2002,52083,-128,191,772,581,-275,3,-278,-44
"32620",NA,28005,"Amite County, MS","County or equivalent",2002,13421,-90,17,159,142,-96,0,-96,-11
"32620",NA,28113,"Pike County, MS","County or equivalent",2002,38662,-38,174,613,439,-179,3,-182,-33
"32660",NA,NA,"McMinnville, TN","Micropolitan Statistical Area",2002,38632,-19,206,610,404,-193,112,-305,-32
"32660",NA,47177,"Warren County, TN","County or equivalent",2002,38632,-19,206,610,404,-193,112,-305,-32
"32700",NA,NA,"McPherson, KS","Micropolitan Statistical Area",2002,29215,-268,-30,348,378,-217,3,-220,-21
"32700",NA,20113,"McPherson County, KS","County or equivalent",2002,29215,-268,-30,348,378,-217,3,-220,-21
"32740",NA,NA,"Meadville, PA","Micropolitan Statistical Area",2002,89941,-165,91,1066,975,-169,10,-179,-87
"32740",NA,42039,"Crawford County, PA","County or equivalent",2002,89941,-165,91,1066,975,-169,10,-179,-87
"32860",NA,NA,"Menomonie, WI","Micropolitan Statistical Area",2002,40796,260,179,455,276,119,35,84,-38
"32860",NA,55033,"Dunn County, WI","County or equivalent",2002,40796,260,179,455,276,119,35,84,-38
"32940",NA,NA,"Meridian, MS","Micropolitan Statistical Area",2002,105751,-164,251,1512,1261,-313,-65,-248,-102
"32940",NA,28023,"Clarke County, MS","County or equivalent",2002,17705,-107,43,226,183,-136,-1,-135,-14
"32940",NA,28069,"Kemper County, MS","County or equivalent",2002,10435,-157,-6,117,123,-142,2,-144,-9
"32940",NA,28075,"Lauderdale County, MS","County or equivalent",2002,77611,100,214,1169,955,-35,-66,31,-79
"32980",NA,NA,"Merrill, WI","Micropolitan Statistical Area",2002,29789,144,-5,327,332,174,18,156,-25
"32980",NA,55069,"Lincoln County, WI","County or equivalent",2002,29789,144,-5,327,332,174,18,156,-25
"33020",NA,NA,"Mexico, MO","Micropolitan Statistical Area",2002,25805,82,64,348,284,41,1,40,-23
"33020",NA,29007,"Audrain County, MO","County or equivalent",2002,25805,82,64,348,284,41,1,40,-23
"33060",NA,NA,"Miami, OK","Micropolitan Statistical Area",2002,32622,-415,-5,434,439,-393,20,-413,-17
"33060",NA,40115,"Ottawa County, OK","County or equivalent",2002,32622,-415,-5,434,439,-393,20,-413,-17
"33180",NA,NA,"Middlesborough, KY","Micropolitan Statistical Area",2002,29779,158,-14,341,355,194,12,182,-22
"33180",NA,21013,"Bell County, KY","County or equivalent",2002,29779,158,-14,341,355,194,12,182,-22
"33220",NA,NA,"Midland, MI","Micropolitan Statistical Area",2002,83440,-76,403,1016,613,-417,141,-558,-62
"33220",NA,26111,"Midland County, MI","County or equivalent",2002,83440,-76,403,1016,613,-417,141,-558,-62
"33300",NA,NA,"Milledgeville, GA","Micropolitan Statistical Area",2002,54682,39,134,656,522,-52,20,-72,-43
"33300",NA,13009,"Baldwin County, GA","County or equivalent",2002,44960,295,155,543,388,179,21,158,-39
"33300",NA,13141,"Hancock County, GA","County or equivalent",2002,9722,-256,-21,113,134,-231,-1,-230,-4
"33380",NA,NA,"Minden, LA","Micropolitan Statistical Area",2002,41246,-68,-15,515,530,-13,7,-20,-40
"33380",NA,22119,"Webster Parish, LA","County or equivalent",2002,41246,-68,-15,515,530,-13,7,-20,-40
"33420",NA,NA,"Mineral Wells, TX","Micropolitan Statistical Area",2002,27046,-36,-5,353,358,-5,44,-49,-26
"33420",NA,48363,"Palo Pinto County, TX","County or equivalent",2002,27046,-36,-5,353,358,-5,44,-49,-26
"33500",NA,NA,"Minot, ND","Micropolitan Statistical Area",2002,65371,-722,368,974,606,-1050,-225,-825,-40
"33500",NA,38049,"McHenry County, ND","County or equivalent",2002,5719,-99,-20,41,61,-74,-2,-72,-5
"33500",NA,38075,"Renville County, ND","County or equivalent",2002,2514,-7,-7,29,36,3,-2,5,-3
"33500",NA,38101,"Ward County, ND","County or equivalent",2002,57138,-616,395,904,509,-979,-221,-758,-32
"33580",NA,NA,"Mitchell, SD","Micropolitan Statistical Area",2002,22074,0,60,271,211,-41,13,-54,-19
"33580",NA,46035,"Davison County, SD","County or equivalent",2002,18736,-48,43,225,182,-75,11,-86,-16
"33580",NA,46061,"Hanson County, SD","County or equivalent",2002,3338,48,17,46,29,34,2,32,-3
"33620",NA,NA,"Moberly, MO","Micropolitan Statistical Area",2002,24706,13,67,353,286,-31,19,-50,-23
"33620",NA,29175,"Randolph County, MO","County or equivalent",2002,24706,13,67,353,286,-31,19,-50,-23
"33820",NA,NA,"Monroe, WI","Micropolitan Statistical Area",2002,34029,193,86,394,308,139,12,127,-32
"33820",NA,55045,"Green County, WI","County or equivalent",2002,34029,193,86,394,308,139,12,127,-32
"33940",NA,NA,"Montrose, CO","Micropolitan Statistical Area",2002,35104,766,150,503,353,636,53,583,-20
"33940",NA,8085,"Montrose County, CO","County or equivalent",2002,35104,766,150,503,353,636,53,583,-20
"33980",NA,NA,"Morehead City, NC","Micropolitan Statistical Area",2002,60247,510,-112,576,688,589,-5,594,33
"33980",NA,37031,"Carteret County, NC","County or equivalent",2002,60247,510,-112,576,688,589,-5,594,33
"34020",NA,NA,"Morgan City, LA","Micropolitan Statistical Area",2002,52179,-347,325,795,470,-639,31,-670,-33
"34020",NA,22101,"St. Mary Parish, LA","County or equivalent",2002,52179,-347,325,795,470,-639,31,-670,-33
"34140",NA,NA,"Moscow, ID","Micropolitan Statistical Area",2002,35173,-145,223,445,222,-346,68,-414,-22
"34140",NA,16057,"Latah County, ID","County or equivalent",2002,35173,-145,223,445,222,-346,68,-414,-22
"34180",NA,NA,"Moses Lake, WA","Micropolitan Statistical Area",2002,77046,905,812,1331,519,152,681,-529,-59
"34180",NA,53025,"Grant County, WA","County or equivalent",2002,77046,905,812,1331,519,152,681,-529,-59
"34220",NA,NA,"Moultrie, GA","Micropolitan Statistical Area",2002,42686,415,301,714,413,159,192,-33,-45
"34220",NA,13071,"Colquitt County, GA","County or equivalent",2002,42686,415,301,714,413,159,192,-33,-45
"34260",NA,NA,"Mountain Home, AR","Micropolitan Statistical Area",2002,38645,227,-272,344,616,519,4,515,-20
"34260",NA,5005,"Baxter County, AR","County or equivalent",2002,38645,227,-272,344,616,519,4,515,-20
"34300",NA,NA,"Mountain Home, ID","Micropolitan Statistical Area",2002,29306,117,373,518,145,-230,-112,-118,-26
"34300",NA,16039,"Elmore County, ID","County or equivalent",2002,29306,117,373,518,145,-230,-112,-118,-26
"34340",NA,NA,"Mount Airy, NC","Micropolitan Statistical Area",2002,71900,248,151,954,803,164,209,-45,-67
"34340",NA,37171,"Surry County, NC","County or equivalent",2002,71900,248,151,954,803,164,209,-45,-67
"34380",NA,NA,"Mount Pleasant, MI","Micropolitan Statistical Area",2002,64227,352,340,734,394,76,103,-27,-64
"34380",NA,26073,"Isabella County, MI","County or equivalent",2002,64227,352,340,734,394,76,103,-27,-64
"34420",NA,NA,"Mount Pleasant, TX","Micropolitan Statistical Area",2002,28083,151,235,505,270,-63,230,-293,-21
"34420",NA,48449,"Titus County, TX","County or equivalent",2002,28083,151,235,505,270,-63,230,-293,-21
"34460",NA,NA,"Mount Sterling, KY","Micropolitan Statistical Area",2002,41317,523,157,559,402,398,2,396,-32
"34460",NA,21011,"Bath County, KY","County or equivalent",2002,11418,131,32,158,126,107,-2,109,-8
"34460",NA,21165,"Menifee County, KY","County or equivalent",2002,6737,45,7,74,67,45,0,45,-7
"34460",NA,21173,"Montgomery County, KY","County or equivalent",2002,23162,347,118,327,209,246,4,242,-17
"34500",NA,NA,"Mount Vernon, IL","Micropolitan Statistical Area",2002,48411,-95,61,551,490,-112,10,-122,-44
"34500",NA,17065,"Hamilton County, IL","County or equivalent",2002,8371,-121,-15,77,92,-100,1,-101,-6
"34500",NA,17081,"Jefferson County, IL","County or equivalent",2002,40040,26,76,474,398,-12,9,-21,-38
"34540",NA,NA,"Mount Vernon, OH","Micropolitan Statistical Area",2002,56133,763,221,735,514,581,11,570,-39
"34540",NA,39083,"Knox County, OH","County or equivalent",2002,56133,763,221,735,514,581,11,570,-39
"34660",NA,NA,"Murray, KY","Micropolitan Statistical Area",2002,34393,0,-27,341,368,61,67,-6,-34
"34660",NA,21035,"Calloway County, KY","County or equivalent",2002,34393,0,-27,341,368,61,67,-6,-34
"34700",NA,NA,"Muscatine, IA","Micropolitan Statistical Area",2002,53991,38,259,779,520,-174,112,-286,-47
"34700",NA,19115,"Louisa County, IA","County or equivalent",2002,12195,28,62,164,102,-22,35,-57,-12
"34700",NA,19139,"Muscatine County, IA","County or equivalent",2002,41796,10,197,615,418,-152,77,-229,-35
"34780",NA,NA,"Muskogee, OK","Micropolitan Statistical Area",2002,69492,-2,174,1024,850,-115,70,-185,-61
"34780",NA,40101,"Muskogee County, OK","County or equivalent",2002,69492,-2,174,1024,850,-115,70,-185,-61
"34860",NA,NA,"Nacogdoches, TX","Micropolitan Statistical Area",2002,59536,-105,310,805,495,-375,193,-568,-40
"34860",NA,48347,"Nacogdoches County, TX","County or equivalent",2002,59536,-105,310,805,495,-375,193,-568,-40
"35020",NA,NA,"Natchez, MS-LA","Micropolitan Statistical Area",2002,53099,-578,128,737,609,-678,7,-685,-28
"35020",NA,22029,"Concordia Parish, LA","County or equivalent",2002,19738,-193,73,286,213,-255,0,-255,-11
"35020",NA,28001,"Adams County, MS","County or equivalent",2002,33361,-385,55,451,396,-423,7,-430,-17
"35060",NA,NA,"Natchitoches, LA","Micropolitan Statistical Area",2002,39027,245,223,574,351,61,30,31,-39
"35060",NA,22069,"Natchitoches Parish, LA","County or equivalent",2002,39027,245,223,574,351,61,30,31,-39
"35100",NA,NA,"New Bern, NC","Micropolitan Statistical Area",2002,115548,-591,595,1731,1136,-1674,-327,-1347,488
"35100",NA,37049,"Craven County, NC","County or equivalent",2002,92604,-466,679,1529,850,-1653,-339,-1314,508
"35100",NA,37103,"Jones County, NC","County or equivalent",2002,10167,-117,-32,93,125,-76,6,-82,-9
"35100",NA,37137,"Pamlico County, NC","County or equivalent",2002,12777,-8,-52,109,161,55,6,49,-11
"35140",NA,NA,"Newberry, SC","Micropolitan Statistical Area",2002,36542,289,16,454,438,303,119,184,-30
"35140",NA,45071,"Newberry County, SC","County or equivalent",2002,36542,289,16,454,438,303,119,184,-30
"35220",NA,NA,"New Castle, IN","Micropolitan Statistical Area",2002,47962,-274,-41,524,565,-190,2,-192,-43
"35220",NA,18065,"Henry County, IN","County or equivalent",2002,47962,-274,-41,524,565,-190,2,-192,-43
"35260",NA,NA,"New Castle, PA","Micropolitan Statistical Area",2002,93722,-302,-195,994,1189,-20,16,-36,-87
"35260",NA,42073,"Lawrence County, PA","County or equivalent",2002,93722,-302,-195,994,1189,-20,16,-36,-87
"35340",NA,NA,"New Iberia, LA","Micropolitan Statistical Area",2002,73334,64,540,1170,630,-418,34,-452,-58
"35340",NA,22045,"Iberia Parish, LA","County or equivalent",2002,73334,64,540,1170,630,-418,34,-452,-58
"35420",NA,NA,"New Philadelphia-Dover, OH","Micropolitan Statistical Area",2002,91374,236,195,1159,964,136,31,105,-95
"35420",NA,39157,"Tuscarawas County, OH","County or equivalent",2002,91374,236,195,1159,964,136,31,105,-95
"35460",NA,NA,"Newport, TN","Micropolitan Statistical Area",2002,33981,314,18,419,401,319,7,312,-23
"35460",NA,47029,"Cocke County, TN","County or equivalent",2002,33981,314,18,419,401,319,7,312,-23
"35500",NA,NA,"Newton, IA","Micropolitan Statistical Area",2002,37369,100,114,451,337,23,24,-1,-37
"35500",NA,19099,"Jasper County, IA","County or equivalent",2002,37369,100,114,451,337,23,24,-1,-37
"35580",NA,NA,"New Ulm, MN","Micropolitan Statistical Area",2002,26837,-59,6,268,262,-41,5,-46,-24
"35580",NA,27015,"Brown County, MN","County or equivalent",2002,26837,-59,6,268,262,-41,5,-46,-24
"35700",NA,NA,"Nogales, AZ","Micropolitan Statistical Area",2002,39221,347,577,796,219,-200,265,-465,-30
"35700",NA,4023,"Santa Cruz County, AZ","County or equivalent",2002,39221,347,577,796,219,-200,265,-465,-30
"35740",NA,NA,"Norfolk, NE","Micropolitan Statistical Area",2002,49859,199,207,731,524,38,87,-49,-46
"35740",NA,31119,"Madison County, NE","County or equivalent",2002,35756,227,178,549,371,85,77,8,-36
"35740",NA,31139,"Pierce County, NE","County or equivalent",2002,7619,-116,-18,80,98,-93,2,-95,-5
"35740",NA,31167,"Stanton County, NE","County or equivalent",2002,6484,88,47,102,55,46,8,38,-5
"35820",NA,NA,"North Platte, NE","Micropolitan Statistical Area",2002,35659,-225,93,475,382,-291,21,-312,-27
"35820",NA,31111,"Lincoln County, NE","County or equivalent",2002,34362,-215,91,457,366,-281,19,-300,-25
"35820",NA,31113,"Logan County, NE","County or equivalent",2002,761,-18,-3,11,14,-15,1,-16,0
"35820",NA,31117,"McPherson County, NE","County or equivalent",2002,536,8,5,7,2,5,1,4,-2
"35860",NA,NA,"North Vernon, IN","Micropolitan Statistical Area",2002,28028,155,136,390,254,45,6,39,-26
"35860",NA,18079,"Jennings County, IN","County or equivalent",2002,28028,155,136,390,254,45,6,39,-26
"35900",NA,NA,"North Wilkesboro, NC","Micropolitan Statistical Area",2002,66524,195,212,876,664,43,168,-125,-60
"35900",NA,37193,"Wilkes County, NC","County or equivalent",2002,66524,195,212,876,664,43,168,-125,-60
"35940",NA,NA,"Norwalk, OH","Micropolitan Statistical Area",2002,59825,263,348,877,529,-27,52,-79,-58
"35940",NA,39077,"Huron County, OH","County or equivalent",2002,59825,263,348,877,529,-27,52,-79,-58
"36020",NA,NA,"Oak Harbor, WA","Micropolitan Statistical Area",2002,75566,1423,339,915,576,1125,-298,1423,-41
"36020",NA,53029,"Island County, WA","County or equivalent",2002,75566,1423,339,915,576,1125,-298,1423,-41
"36060",NA,NA,"Oak Hill, WV","Micropolitan Statistical Area",2002,46991,-107,-74,558,632,11,18,-7,-44
"36060",NA,54019,"Fayette County, WV","County or equivalent",2002,46991,-107,-74,558,632,11,18,-7,-44
"36180",NA,NA,"Ocean Pines, MD","Micropolitan Statistical Area",2002,48191,601,-97,465,562,731,56,675,-33
"36180",NA,24047,"Worcester County, MD","County or equivalent",2002,48191,601,-97,465,562,731,56,675,-33
"36300",NA,NA,"Ogdensburg-Massena, NY","Micropolitan Statistical Area",2002,110669,-523,107,1239,1132,-541,75,-616,-89
"36300",NA,36089,"St. Lawrence County, NY","County or equivalent",2002,110669,-523,107,1239,1132,-541,75,-616,-89
"36340",NA,NA,"Oil City, PA","Micropolitan Statistical Area",2002,56637,-415,-61,593,654,-307,2,-309,-47
"36340",NA,42121,"Venango County, PA","County or equivalent",2002,56637,-415,-61,593,654,-307,2,-309,-47
"36380",NA,NA,"Okeechobee, FL","Micropolitan Statistical Area",2002,36777,483,193,549,356,323,197,126,-33
"36380",NA,12093,"Okeechobee County, FL","County or equivalent",2002,36777,483,193,549,356,323,197,126,-33
"36460",NA,NA,"Olean, NY","Micropolitan Statistical Area",2002,83134,-166,111,957,846,-200,14,-214,-77
"36460",NA,36009,"Cattaraugus County, NY","County or equivalent",2002,83134,-166,111,957,846,-200,14,-214,-77
"36580",NA,NA,"Oneonta, NY","Micropolitan Statistical Area",2002,61781,98,-36,560,596,189,18,171,-55
"36580",NA,36077,"Otsego County, NY","County or equivalent",2002,61781,98,-36,560,596,189,18,171,-55
"36620",NA,NA,"Ontario, OR-ID","Micropolitan Statistical Area",2002,52384,61,339,782,443,-244,133,-377,-34
"36620",NA,16075,"Payette County, ID","County or equivalent",2002,21062,213,117,301,184,115,21,94,-19
"36620",NA,41045,"Malheur County, OR","County or equivalent",2002,31322,-152,222,481,259,-359,112,-471,-15
"36660",NA,NA,"Opelousas-Eunice, LA","Micropolitan Statistical Area",2002,87797,187,523,1394,871,-257,11,-268,-79
"36660",NA,22097,"St. Landry Parish, LA","County or equivalent",2002,87797,187,523,1394,871,-257,11,-268,-79
"36700",NA,NA,"Orangeburg, SC","Micropolitan Statistical Area",2002,91128,-132,291,1231,940,-338,35,-373,-85
"36700",NA,45075,"Orangeburg County, SC","County or equivalent",2002,91128,-132,291,1231,940,-338,35,-373,-85
"36820",NA,NA,"Oskaloosa, IA","Micropolitan Statistical Area",2002,22311,-66,75,276,201,-125,23,-148,-16
"36820",NA,19123,"Mahaska County, IA","County or equivalent",2002,22311,-66,75,276,201,-125,23,-148,-16
"36860",NA,NA,"Ottawa-Streator, IL","Micropolitan Statistical Area",2002,152393,-709,122,1821,1699,-707,114,-821,-124
"36860",NA,17011,"Bureau County, IL","County or equivalent",2002,35008,-162,-10,394,404,-117,19,-136,-35
"36860",NA,17099,"LaSalle County, IL","County or equivalent",2002,111312,-557,123,1364,1241,-596,92,-688,-84
"36860",NA,17155,"Putnam County, IL","County or equivalent",2002,6073,10,9,63,54,6,3,3,-5
"36900",NA,NA,"Ottumwa, IA","Micropolitan Statistical Area",2002,35802,-150,57,455,398,-174,32,-206,-33
"36900",NA,19179,"Wapello County, IA","County or equivalent",2002,35802,-150,57,455,398,-174,32,-206,-33
"36940",NA,NA,"Owatonna, MN","Micropolitan Statistical Area",2002,34336,167,159,445,286,39,95,-56,-31
"36940",NA,27147,"Steele County, MN","County or equivalent",2002,34336,167,159,445,286,39,95,-56,-31
"37020",NA,NA,"Owosso, MI","Micropolitan Statistical Area",2002,71989,56,278,922,644,-158,8,-166,-64
"37020",NA,26155,"Shiawassee County, MI","County or equivalent",2002,71989,56,278,922,644,-158,8,-166,-64
"37060",NA,NA,"Oxford, MS","Micropolitan Statistical Area",2002,39529,412,125,453,328,326,56,270,-39
"37060",NA,28071,"Lafayette County, MS","County or equivalent",2002,39529,412,125,453,328,326,56,270,-39
"37140",NA,NA,"Paducah, KY-IL","Micropolitan Statistical Area",2002,97640,-262,4,1197,1193,-178,18,-196,-88
"37140",NA,17127,"Massac County, IL","County or equivalent",2002,15106,81,-2,191,193,101,2,99,-18
"37140",NA,21007,"Ballard County, KY","County or equivalent",2002,8155,-64,-37,85,122,-19,4,-23,-8
"37140",NA,21139,"Livingston County, KY","County or equivalent",2002,9765,-45,-37,91,128,2,-1,3,-10
"37140",NA,21145,"McCracken County, KY","County or equivalent",2002,64614,-234,80,830,750,-262,13,-275,-52
"37220",NA,NA,"Pahrump, NV","Micropolitan Statistical Area",2002,34583,715,-151,315,466,885,52,833,-19
"37220",NA,32023,"Nye County, NV","County or equivalent",2002,34583,715,-151,315,466,885,52,833,-19
"37260",NA,NA,"Palatka, FL","Micropolitan Statistical Area",2002,70939,586,21,923,902,614,82,532,-49
"37260",NA,12107,"Putnam County, FL","County or equivalent",2002,70939,586,21,923,902,614,82,532,-49
"37300",NA,NA,"Palestine, TX","Micropolitan Statistical Area",2002,54357,255,109,700,591,200,63,137,-54
"37300",NA,48001,"Anderson County, TX","County or equivalent",2002,54357,255,109,700,591,200,63,137,-54
"37420",NA,NA,"Pampa, TX","Micropolitan Statistical Area",2002,22605,-357,-9,280,289,-327,52,-379,-21
"37420",NA,48179,"Gray County, TX","County or equivalent",2002,21758,-332,-6,272,278,-306,51,-357,-20
"37420",NA,48393,"Roberts County, TX","County or equivalent",2002,847,-25,-3,8,11,-21,1,-22,-1
"37500",NA,NA,"Paragould, AR","Micropolitan Statistical Area",2002,38028,221,162,553,391,93,9,84,-34
"37500",NA,5055,"Greene County, AR","County or equivalent",2002,38028,221,162,553,391,93,9,84,-34
"37540",NA,NA,"Paris, TN","Micropolitan Statistical Area",2002,31262,91,-47,381,428,163,12,151,-25
"37540",NA,47079,"Henry County, TN","County or equivalent",2002,31262,91,-47,381,428,163,12,151,-25
"37580",NA,NA,"Paris, TX","Micropolitan Statistical Area",2002,48825,254,101,681,580,202,69,133,-49
"37580",NA,48277,"Lamar County, TX","County or equivalent",2002,48825,254,101,681,580,202,69,133,-49
"37660",NA,NA,"Parsons, KS","Micropolitan Statistical Area",2002,22248,-210,-41,274,315,-153,2,-155,-16
"37660",NA,20099,"Labette County, KS","County or equivalent",2002,22248,-210,-41,274,315,-153,2,-155,-16
"37740",NA,NA,"Payson, AZ","Micropolitan Statistical Area",2002,51226,58,8,637,629,98,55,43,-48
"37740",NA,4007,"Gila County, AZ","County or equivalent",2002,51226,58,8,637,629,98,55,43,-48
"37780",NA,NA,"Pecos, TX","Micropolitan Statistical Area",2002,12404,-274,101,216,115,-373,26,-399,-2
"37780",NA,48389,"Reeves County, TX","County or equivalent",2002,12404,-274,101,216,115,-373,26,-399,-2
"37800",NA,NA,"Pella, IA","Micropolitan Statistical Area",2002,32411,-95,41,399,358,-103,7,-110,-33
"37800",NA,19125,"Marion County, IA","County or equivalent",2002,32411,-95,41,399,358,-103,7,-110,-33
"37820",NA,NA,"Pendleton-Hermiston, OR","Micropolitan Statistical Area",2002,83210,1619,510,1224,714,1165,273,892,-56
"37820",NA,41049,"Morrow County, OR","County or equivalent",2002,11390,300,99,176,77,208,67,141,-7
"37820",NA,41059,"Umatilla County, OR","County or equivalent",2002,71820,1319,411,1048,637,957,206,751,-49
"37940",NA,NA,"Peru, IN","Micropolitan Statistical Area",2002,36764,426,128,456,328,324,3,321,-26
"37940",NA,18103,"Miami County, IN","County or equivalent",2002,36764,426,128,456,328,324,3,321,-26
"38020",NA,NA,"Phoenix Lake-Cedar Ridge, CA","Micropolitan Statistical Area",2002,55671,513,-186,427,613,726,19,707,-27
"38020",NA,6109,"Tuolumne County, CA","County or equivalent",2002,55671,513,-186,427,613,726,19,707,-27
"38100",NA,NA,"Picayune, MS","Micropolitan Statistical Area",2002,50050,700,187,674,487,546,2,544,-33
"38100",NA,28109,"Pearl River County, MS","County or equivalent",2002,50050,700,187,674,487,546,2,544,-33
"38180",NA,NA,"Pierre, SD","Micropolitan Statistical Area",2002,19238,121,76,248,172,61,15,46,-16
"38180",NA,46065,"Hughes County, SD","County or equivalent",2002,16538,152,50,211,161,117,13,104,-15
"38180",NA,46117,"Stanley County, SD","County or equivalent",2002,2700,-31,26,37,11,-56,2,-58,-1
"38200",NA,NA,"Pierre Part, LA","Micropolitan Statistical Area",2002,23111,-63,98,293,195,-142,8,-150,-19
"38200",NA,22007,"Assumption Parish, LA","County or equivalent",2002,23111,-63,98,293,195,-142,8,-150,-19
"38260",NA,NA,"Pittsburg, KS","Micropolitan Statistical Area",2002,38274,-119,56,495,439,-141,93,-234,-34
"38260",NA,20037,"Crawford County, KS","County or equivalent",2002,38274,-119,56,495,439,-141,93,-234,-34
"38380",NA,NA,"Plainview, TX","Micropolitan Statistical Area",2002,35452,-342,317,610,293,-643,87,-730,-16
"38380",NA,48189,"Hale County, TX","County or equivalent",2002,35452,-342,317,610,293,-643,87,-730,-16
"38420",NA,NA,"Platteville, WI","Micropolitan Statistical Area",2002,49213,-294,27,541,514,-282,15,-297,-39
"38420",NA,55043,"Grant County, WI","County or equivalent",2002,49213,-294,27,541,514,-282,15,-297,-39
"38460",NA,NA,"Plattsburgh, NY","Micropolitan Statistical Area",2002,80525,281,102,725,623,249,55,194,-70
"38460",NA,36019,"Clinton County, NY","County or equivalent",2002,80525,281,102,725,623,249,55,194,-70
"38500",NA,NA,"Plymouth, IN","Micropolitan Statistical Area",2002,45444,-56,259,639,380,-283,137,-420,-32
"38500",NA,18099,"Marshall County, IN","County or equivalent",2002,45444,-56,259,639,380,-283,137,-420,-32
"38580",NA,NA,"Point Pleasant, WV-OH","Micropolitan Statistical Area",2002,57011,-61,54,646,592,-61,1,-62,-54
"38580",NA,39053,"Gallia County, OH","County or equivalent",2002,31077,41,31,354,323,42,2,40,-32
"38580",NA,54053,"Mason County, WV","County or equivalent",2002,25934,-102,23,292,269,-103,-1,-102,-22
"38620",NA,NA,"Ponca City, OK","Micropolitan Statistical Area",2002,47515,88,74,687,613,59,52,7,-45
"38620",NA,40071,"Kay County, OK","County or equivalent",2002,47515,88,74,687,613,59,52,7,-45
"38700",NA,NA,"Pontiac, IL","Micropolitan Statistical Area",2002,39113,-519,79,511,432,-577,15,-592,-21
"38700",NA,17105,"Livingston County, IL","County or equivalent",2002,39113,-519,79,511,432,-577,15,-592,-21
"38740",NA,NA,"Poplar Bluff, MO","Micropolitan Statistical Area",2002,40778,100,17,559,542,120,18,102,-37
"38740",NA,29023,"Butler County, MO","County or equivalent",2002,40778,100,17,559,542,120,18,102,-37
"38780",NA,NA,"Portales, NM","Micropolitan Statistical Area",2002,18521,229,174,329,155,73,14,59,-18
"38780",NA,35041,"Roosevelt County, NM","County or equivalent",2002,18521,229,174,329,155,73,14,59,-18
"38820",NA,NA,"Port Angeles, WA","Micropolitan Statistical Area",2002,65811,1020,-221,589,810,1280,59,1221,-39
"38820",NA,53009,"Clallam County, WA","County or equivalent",2002,65811,1020,-221,589,810,1280,59,1221,-39
"39020",NA,NA,"Portsmouth, OH","Micropolitan Statistical Area",2002,77919,-472,-50,942,992,-360,15,-375,-62
"39020",NA,39145,"Scioto County, OH","County or equivalent",2002,77919,-472,-50,942,992,-360,15,-375,-62
"39060",NA,NA,"Pottsville, PA","Micropolitan Statistical Area",2002,148471,-643,-666,1388,2054,160,15,145,-137
"39060",NA,42107,"Schuylkill County, PA","County or equivalent",2002,148471,-643,-666,1388,2054,160,15,145,-137
"39220",NA,NA,"Price, UT","Micropolitan Statistical Area",2002,19745,54,113,305,192,-41,13,-54,-18
"39220",NA,49007,"Carbon County, UT","County or equivalent",2002,19745,54,113,305,192,-41,13,-54,-18
"39260",NA,NA,"Prineville, OR","Micropolitan Statistical Area",2002,20065,189,36,232,196,172,30,142,-19
"39260",NA,41013,"Crook County, OR","County or equivalent",2002,20065,189,36,232,196,172,30,142,-19
"39420",NA,NA,"Pullman, WA","Micropolitan Statistical Area",2002,40993,442,161,375,214,319,225,94,-38
"39420",NA,53075,"Whitman County, WA","County or equivalent",2002,40993,442,161,375,214,319,225,94,-38
"39500",NA,NA,"Quincy, IL-MO","Micropolitan Statistical Area",2002,78099,-324,-8,952,960,-247,17,-264,-69
"39500",NA,17001,"Adams County, IL","County or equivalent",2002,67774,-270,-19,840,859,-192,15,-207,-59
"39500",NA,29111,"Lewis County, MO","County or equivalent",2002,10325,-54,11,112,101,-55,2,-57,-10
"39700",NA,NA,"Raymondville, TX","Micropolitan Statistical Area",2002,19818,3,271,386,115,-252,55,-307,-16
"39700",NA,48489,"Willacy County, TX","County or equivalent",2002,19818,3,271,386,115,-252,55,-307,-16
"39780",NA,NA,"Red Bluff, CA","Micropolitan Statistical Area",2002,57007,531,93,700,607,480,89,391,-42
"39780",NA,6103,"Tehama County, CA","County or equivalent",2002,57007,531,93,700,607,480,89,391,-42
"39860",NA,NA,"Red Wing, MN","Micropolitan Statistical Area",2002,44899,339,94,533,439,286,21,265,-41
"39860",NA,27049,"Goodhue County, MN","County or equivalent",2002,44899,339,94,533,439,286,21,265,-41
"39940",NA,NA,"Rexburg, ID","Micropolitan Statistical Area",2002,41541,1592,533,745,212,163,74,89,896
"39940",NA,16043,"Fremont County, ID","County or equivalent",2002,11909,68,120,211,91,-41,40,-81,-11
"39940",NA,16065,"Madison County, ID","County or equivalent",2002,29632,1524,413,534,121,204,34,170,907
"39980",NA,NA,"Richmond, IN","Micropolitan Statistical Area",2002,70154,-367,68,845,777,-369,49,-418,-66
"39980",NA,18177,"Wayne County, IN","County or equivalent",2002,70154,-367,68,845,777,-369,49,-418,-66
"40080",NA,NA,"Richmond-Berea, KY","Micropolitan Statistical Area",2002,90338,1176,423,1190,767,819,45,774,-66
"40080",NA,21151,"Madison County, KY","County or equivalent",2002,73778,1138,368,958,590,819,47,772,-49
"40080",NA,21203,"Rockcastle County, KY","County or equivalent",2002,16560,38,55,232,177,0,-2,2,-17
"40100",NA,NA,"Rio Grande City-Roma, TX","Micropolitan Statistical Area",2002,55897,1327,1208,1488,280,168,487,-319,-49
"40100",NA,48427,"Starr County, TX","County or equivalent",2002,55897,1327,1208,1488,280,168,487,-319,-49
"40180",NA,NA,"Riverton, WY","Micropolitan Statistical Area",2002,35800,193,91,480,389,133,7,126,-31
"40180",NA,56013,"Fremont County, WY","County or equivalent",2002,35800,193,91,480,389,133,7,126,-31
"40260",NA,NA,"Roanoke Rapids, NC","Micropolitan Statistical Area",2002,77985,-570,9,997,988,-518,36,-554,-61
"40260",NA,37083,"Halifax County, NC","County or equivalent",2002,56345,-355,48,758,710,-357,29,-386,-46
"40260",NA,37131,"Northampton County, NC","County or equivalent",2002,21640,-215,-39,239,278,-161,7,-168,-15
"40300",NA,NA,"Rochelle, IL","Micropolitan Statistical Area",2002,52122,518,78,550,472,365,113,252,75
"40300",NA,17141,"Ogle County, IL","County or equivalent",2002,52122,518,78,550,472,365,113,252,75
"40460",NA,NA,"Rockingham, NC","Micropolitan Statistical Area",2002,46498,175,108,651,543,110,42,68,-43
"40460",NA,37153,"Richmond County, NC","County or equivalent",2002,46498,175,108,651,543,110,42,68,-43
"40500",NA,NA,"Rockland, ME","Micropolitan Statistical Area",2002,40432,468,-88,377,465,576,8,568,-20
"40500",NA,23013,"Knox County, ME","County or equivalent",2002,40432,468,-88,377,465,576,8,568,-20
"40540",NA,NA,"Rock Springs, WY","Micropolitan Statistical Area",2002,36838,270,320,569,249,-12,16,-28,-38
"40540",NA,56037,"Sweetwater County, WY","County or equivalent",2002,36838,270,320,569,249,-12,16,-28,-38
"40620",NA,NA,"Rolla, MO","Micropolitan Statistical Area",2002,40629,718,46,503,457,695,93,602,-23
"40620",NA,29161,"Phelps County, MO","County or equivalent",2002,40629,718,46,503,457,695,93,602,-23
"40700",NA,NA,"Roseburg, OR","Micropolitan Statistical Area",2002,100595,518,-99,1080,1179,715,36,679,-98
"40700",NA,41019,"Douglas County, OR","County or equivalent",2002,100595,518,-99,1080,1179,715,36,679,-98
"40740",NA,NA,"Roswell, NM","Micropolitan Statistical Area",2002,60433,-359,293,889,596,-613,152,-765,-39
"40740",NA,35005,"Chaves County, NM","County or equivalent",2002,60433,-359,293,889,596,-613,152,-765,-39
"40760",NA,NA,"Ruidoso, NM","Micropolitan Statistical Area",2002,19591,166,41,206,165,141,36,105,-16
"40760",NA,35027,"Lincoln County, NM","County or equivalent",2002,19591,166,41,206,165,141,36,105,-16
"40780",NA,NA,"Russellville, AR","Micropolitan Statistical Area",2002,76492,383,274,1046,772,105,162,-57,4
"40780",NA,5115,"Pope County, AR","County or equivalent",2002,55302,366,166,691,525,182,30,152,18
"40780",NA,5149,"Yell County, AR","County or equivalent",2002,21190,17,108,355,247,-77,132,-209,-14
"40820",NA,NA,"Ruston, LA","Micropolitan Statistical Area",2002,57197,-359,270,772,502,-588,46,-634,-41
"40820",NA,22049,"Jackson Parish, LA","County or equivalent",2002,15207,-162,-8,216,224,-144,-1,-143,-10
"40820",NA,22061,"Lincoln Parish, LA","County or equivalent",2002,41990,-197,278,556,278,-444,47,-491,-31
"40860",NA,NA,"Rutland, VT","Micropolitan Statistical Area",2002,63237,-53,-39,577,616,49,10,39,-63
"40860",NA,50021,"Rutland County, VT","County or equivalent",2002,63237,-53,-39,577,616,49,10,39,-63
"40940",NA,NA,"Safford, AZ","Micropolitan Statistical Area",2002,40818,-765,210,538,328,-963,27,-990,-12
"40940",NA,4009,"Graham County, AZ","County or equivalent",2002,33112,-190,181,453,272,-349,16,-365,-22
"40940",NA,4011,"Greenlee County, AZ","County or equivalent",2002,7706,-575,29,85,56,-614,11,-625,10
"41220",NA,NA,"St. Marys, GA","Micropolitan Statistical Area",2002,45587,1083,605,805,200,508,-271,779,-30
"41220",NA,13039,"Camden County, GA","County or equivalent",2002,45587,1083,605,805,200,508,-271,779,-30
"41260",NA,NA,"St. Marys, PA","Micropolitan Statistical Area",2002,34367,-393,-8,348,356,-364,8,-372,-21
"41260",NA,42047,"Elk County, PA","County or equivalent",2002,34367,-393,-8,348,356,-364,8,-372,-21
"41460",NA,NA,"Salina, KS","Micropolitan Statistical Area",2002,60141,151,248,830,582,-46,90,-136,-51
"41460",NA,20143,"Ottawa County, KS","County or equivalent",2002,6152,30,-14,70,84,49,1,48,-5
"41460",NA,20169,"Saline County, KS","County or equivalent",2002,53989,121,262,760,498,-95,89,-184,-46
"41580",NA,NA,"Salisbury, NC","Micropolitan Statistical Area",2002,133318,1160,333,1666,1333,943,361,582,-116
"41580",NA,37159,"Rowan County, NC","County or equivalent",2002,133318,1160,333,1666,1333,943,361,582,-116
"41820",NA,NA,"Sanford, NC","Micropolitan Statistical Area",2002,51684,518,371,830,459,-1206,297,-1503,1353
"41820",NA,37105,"Lee County, NC","County or equivalent",2002,51684,518,371,830,459,-1206,297,-1503,1353
"42300",NA,NA,"Sault Ste. Marie, MI","Micropolitan Statistical Area",2002,38611,158,78,392,314,115,6,109,-35
"42300",NA,26033,"Chippewa County, MI","County or equivalent",2002,38611,158,78,392,314,115,6,109,-35
"42380",NA,NA,"Sayre, PA","Micropolitan Statistical Area",2002,62335,-166,99,744,645,-214,6,-220,-51
"42380",NA,42015,"Bradford County, PA","County or equivalent",2002,62335,-166,99,744,645,-214,6,-220,-51
"42420",NA,NA,"Scottsbluff, NE","Micropolitan Statistical Area",2002,37336,-1,80,546,466,-46,61,-107,-35
"42420",NA,31007,"Banner County, NE","County or equivalent",2002,771,-39,-2,3,5,-37,1,-38,0
"42420",NA,31157,"Scotts Bluff County, NE","County or equivalent",2002,36565,38,82,543,461,-9,60,-69,-35
"42460",NA,NA,"Scottsboro, AL","Micropolitan Statistical Area",2002,53653,-322,72,673,601,-351,12,-363,-43
"42460",NA,1071,"Jackson County, AL","County or equivalent",2002,53653,-322,72,673,601,-351,12,-363,-43
"42500",NA,NA,"Scottsburg, IN","Micropolitan Statistical Area",2002,23259,-11,59,305,246,-47,2,-49,-23
"42500",NA,18143,"Scott County, IN","County or equivalent",2002,23259,-11,59,305,246,-47,2,-49,-23
"42580",NA,NA,"Seaford, DE","Micropolitan Statistical Area",2002,163727,3456,311,2027,1716,3235,341,2894,-90
"42580",NA,10005,"Sussex County, DE","County or equivalent",2002,163727,3456,311,2027,1716,3235,341,2894,-90
"42620",NA,NA,"Searcy, AR","Micropolitan Statistical Area",2002,68843,518,171,882,711,413,47,366,-66
"42620",NA,5145,"White County, AR","County or equivalent",2002,68843,518,171,882,711,413,47,366,-66
"42700",NA,NA,"Sebring, FL","Micropolitan Statistical Area",2002,89785,1338,-393,896,1289,1761,358,1403,-30
"42700",NA,12055,"Highlands County, FL","County or equivalent",2002,89785,1338,-393,896,1289,1761,358,1403,-30
"42740",NA,NA,"Sedalia, MO","Micropolitan Statistical Area",2002,39378,-91,129,571,442,-186,70,-256,-34
"42740",NA,29159,"Pettis County, MO","County or equivalent",2002,39378,-91,129,571,442,-186,70,-256,-34
"42780",NA,NA,"Selinsgrove, PA","Micropolitan Statistical Area",2002,37796,52,117,441,324,-30,2,-32,-35
"42780",NA,42109,"Snyder County, PA","County or equivalent",2002,37796,52,117,441,324,-30,2,-32,-35
"42820",NA,NA,"Selma, AL","Micropolitan Statistical Area",2002,44955,-967,134,705,571,-1086,1,-1087,-15
"42820",NA,1047,"Dallas County, AL","County or equivalent",2002,44955,-967,134,705,571,-1086,1,-1087,-15
"42860",NA,NA,"Seneca, SC","Micropolitan Statistical Area",2002,67687,772,177,770,593,641,74,567,-46
"42860",NA,45073,"Oconee County, SC","County or equivalent",2002,67687,772,177,770,593,641,74,567,-46
"42900",NA,NA,"Seneca Falls, NY","Micropolitan Statistical Area",2002,34730,96,47,362,315,81,24,57,-32
"42900",NA,36099,"Seneca County, NY","County or equivalent",2002,34730,96,47,362,315,81,24,57,-32
"42940",NA,NA,"Sevierville, TN","Micropolitan Statistical Area",2002,74365,1165,211,902,691,999,49,950,-45
"42940",NA,47155,"Sevier County, TN","County or equivalent",2002,74365,1165,211,902,691,999,49,950,-45
"42980",NA,NA,"Seymour, IN","Micropolitan Statistical Area",2002,41406,34,194,623,429,-128,94,-222,-32
"42980",NA,18071,"Jackson County, IN","County or equivalent",2002,41406,34,194,623,429,-128,94,-222,-32
"43060",NA,NA,"Shawnee, OK","Micropolitan Statistical Area",2002,66605,341,207,919,712,194,17,177,-60
"43060",NA,40125,"Pottawatomie County, OK","County or equivalent",2002,66605,341,207,919,712,194,17,177,-60
"43140",NA,NA,"Shelby, NC","Micropolitan Statistical Area",2002,97395,338,273,1249,976,161,74,87,-96
"43140",NA,37045,"Cleveland County, NC","County or equivalent",2002,97395,338,273,1249,976,161,74,87,-96
"43180",NA,NA,"Shelbyville, TN","Micropolitan Statistical Area",2002,39098,596,222,599,377,406,224,182,-32
"43180",NA,47003,"Bedford County, TN","County or equivalent",2002,39098,596,222,599,377,406,224,182,-32
"43220",NA,NA,"Shelton, WA","Micropolitan Statistical Area",2002,50689,700,19,535,516,713,57,656,-32
"43220",NA,53045,"Mason County, WA","County or equivalent",2002,50689,700,19,535,516,713,57,656,-32
"43260",NA,NA,"Sheridan, WY","Micropolitan Statistical Area",2002,26872,225,-36,275,311,280,10,270,-19
"43260",NA,56033,"Sheridan County, WY","County or equivalent",2002,26872,225,-36,275,311,280,10,270,-19
"43320",NA,NA,"Show Low, AZ","Micropolitan Statistical Area",2002,101364,2813,979,1636,657,1881,71,1810,-47
"43320",NA,4017,"Navajo County, AZ","County or equivalent",2002,101364,2813,979,1636,657,1881,71,1810,-47
"43380",NA,NA,"Sidney, OH","Micropolitan Statistical Area",2002,48235,-28,275,683,408,-267,48,-315,-36
"43380",NA,39149,"Shelby County, OH","County or equivalent",2002,48235,-28,275,683,408,-267,48,-315,-36
"43420",NA,NA,"Sierra Vista-Douglas, AZ","Micropolitan Statistical Area",2002,119687,1152,582,1704,1122,672,2,670,-102
"43420",NA,4003,"Cochise County, AZ","County or equivalent",2002,119687,1152,582,1704,1122,672,2,670,-102
"43460",NA,NA,"Sikeston, MO","Micropolitan Statistical Area",2002,40277,-141,178,576,398,-289,12,-301,-30
"43460",NA,29201,"Scott County, MO","County or equivalent",2002,40277,-141,178,576,398,-289,12,-301,-30
"43500",NA,NA,"Silver City, NM","Micropolitan Statistical Area",2002,30182,-522,83,397,314,-595,8,-603,-10
"43500",NA,35017,"Grant County, NM","County or equivalent",2002,30182,-522,83,397,314,-595,8,-603,-10
"43540",NA,NA,"Silverthorne, CO","Micropolitan Statistical Area",2002,24969,264,323,365,42,-39,264,-303,-20
"43540",NA,8117,"Summit County, CO","County or equivalent",2002,24969,264,323,365,42,-39,264,-303,-20
"43660",NA,NA,"Snyder, TX","Micropolitan Statistical Area",2002,15855,115,61,227,166,68,14,54,-14
"43660",NA,48415,"Scurry County, TX","County or equivalent",2002,15855,115,61,227,166,68,14,54,-14
"43700",NA,NA,"Somerset, KY","Micropolitan Statistical Area",2002,57119,459,189,799,610,319,23,296,-49
"43700",NA,21199,"Pulaski County, KY","County or equivalent",2002,57119,459,189,799,610,319,23,296,-49
"43740",NA,NA,"Somerset, PA","Micropolitan Statistical Area",2002,79442,-2,-167,746,913,234,11,223,-69
"43740",NA,42111,"Somerset County, PA","County or equivalent",2002,79442,-2,-167,746,913,234,11,223,-69
"43860",NA,NA,"Southern Pines-Pinehurst, NC","Micropolitan Statistical Area",2002,77578,1274,12,884,872,1305,153,1152,-43
"43860",NA,37125,"Moore County, NC","County or equivalent",2002,77578,1274,12,884,872,1305,153,1152,-43
"43940",NA,NA,"Spearfish, SD","Micropolitan Statistical Area",2002,21696,-9,38,249,211,-27,1,-28,-20
"43940",NA,46081,"Lawrence County, SD","County or equivalent",2002,21696,-9,38,249,211,-27,1,-28,-20
"43980",NA,NA,"Spencer, IA","Micropolitan Statistical Area",2002,17062,-187,11,192,181,-188,15,-203,-10
"43980",NA,19041,"Clay County, IA","County or equivalent",2002,17062,-187,11,192,181,-188,15,-203,-10
"44020",NA,NA,"Spirit Lake, IA","Micropolitan Statistical Area",2002,16348,-128,-29,150,179,-86,5,-91,-13
"44020",NA,19059,"Dickinson County, IA","County or equivalent",2002,16348,-128,-29,150,179,-86,5,-91,-13
"44260",NA,NA,"Starkville, MS","Micropolitan Statistical Area",2002,42367,-450,280,535,255,-711,116,-827,-19
"44260",NA,28105,"Oktibbeha County, MS","County or equivalent",2002,42367,-450,280,535,255,-711,116,-827,-19
"44340",NA,NA,"Statesboro, GA","Micropolitan Statistical Area",2002,57652,651,350,735,385,355,83,272,-54
"44340",NA,13031,"Bulloch County, GA","County or equivalent",2002,57652,651,350,735,385,355,83,272,-54
"44380",NA,NA,"Statesville-Mooresville, NC","Micropolitan Statistical Area",2002,130241,3137,753,1838,1085,2463,322,2141,-79
"44380",NA,37097,"Iredell County, NC","County or equivalent",2002,130241,3137,753,1838,1085,2463,322,2141,-79
"44420",NA,NA,"Staunton-Waynesboro, VA","Micropolitan Statistical Area",2002,110556,1051,70,1172,1102,1068,54,1014,-87
"44420",NA,51015,"Augusta County, VA","County or equivalent",2002,66478,415,128,687,559,343,31,312,-56
"44420",NA,51790,"Staunton city, VA","County or equivalent",2002,23876,242,-71,227,298,331,4,327,-18
"44420",NA,51820,"Waynesboro city, VA","County or equivalent",2002,20202,394,13,258,245,394,19,375,-13
"44500",NA,NA,"Stephenville, TX","Micropolitan Statistical Area",2002,33303,432,110,437,327,355,93,262,-33
"44500",NA,48143,"Erath County, TX","County or equivalent",2002,33303,432,110,437,327,355,93,262,-33
"44540",NA,NA,"Sterling, CO","Micropolitan Statistical Area",2002,21228,-41,47,252,205,-70,43,-113,-18
"44540",NA,8075,"Logan County, CO","County or equivalent",2002,21228,-41,47,252,205,-70,43,-113,-18
"44580",NA,NA,"Sterling, IL","Micropolitan Statistical Area",2002,60101,-459,135,736,601,-556,45,-601,-38
"44580",NA,17195,"Whiteside County, IL","County or equivalent",2002,60101,-459,135,736,601,-556,45,-601,-38
"44620",NA,NA,"Stevens Point, WI","Micropolitan Statistical Area",2002,67487,147,269,705,436,-60,52,-112,-62
"44620",NA,55097,"Portage County, WI","County or equivalent",2002,67487,147,269,705,436,-60,52,-112,-62
"44660",NA,NA,"Stillwater, OK","Micropolitan Statistical Area",2002,71833,1368,327,880,553,73,266,-193,968
"44660",NA,40119,"Payne County, OK","County or equivalent",2002,71833,1368,327,880,553,73,266,-193,968
"44740",NA,NA,"Storm Lake, IA","Micropolitan Statistical Area",2002,20144,-49,46,244,198,-79,147,-226,-16
"44740",NA,19021,"Buena Vista County, IA","County or equivalent",2002,20144,-49,46,244,198,-79,147,-226,-16
"44780",NA,NA,"Sturgis, MI","Micropolitan Statistical Area",2002,62217,-244,328,863,535,-533,123,-656,-39
"44780",NA,26149,"St. Joseph County, MI","County or equivalent",2002,62217,-244,328,863,535,-533,123,-656,-39
"44860",NA,NA,"Sulphur Springs, TX","Micropolitan Statistical Area",2002,32260,87,79,452,373,40,73,-33,-32
"44860",NA,48223,"Hopkins County, TX","County or equivalent",2002,32260,87,79,452,373,40,73,-33,-32
"44900",NA,NA,"Summerville, GA","Micropolitan Statistical Area",2002,25901,93,33,320,287,84,25,59,-24
"44900",NA,13055,"Chattooga County, GA","County or equivalent",2002,25901,93,33,320,287,84,25,59,-24
"44980",NA,NA,"Sunbury, PA","Micropolitan Statistical Area",2002,93055,-476,-232,986,1218,-164,16,-180,-80
"44980",NA,42097,"Northumberland County, PA","County or equivalent",2002,93055,-476,-232,986,1218,-164,16,-180,-80
"45000",NA,NA,"Susanville, CA","Micropolitan Statistical Area",2002,33308,-197,52,267,215,-214,5,-219,-35
"45000",NA,6035,"Lassen County, CA","County or equivalent",2002,33308,-197,52,267,215,-214,5,-219,-35
"45020",NA,NA,"Sweetwater, TX","Micropolitan Statistical Area",2002,15046,-291,40,224,184,-327,16,-343,-4
"45020",NA,48353,"Nolan County, TX","County or equivalent",2002,15046,-291,40,224,184,-327,16,-343,-4
"45140",NA,NA,"Tahlequah, OK","Micropolitan Statistical Area",2002,43510,484,219,612,393,301,89,212,-36
"45140",NA,40021,"Cherokee County, OK","County or equivalent",2002,43510,484,219,612,393,301,89,212,-36
"45180",NA,NA,"Talladega-Sylacauga, AL","Micropolitan Statistical Area",2002,80240,-47,171,1109,938,-138,23,-161,-80
"45180",NA,1121,"Talladega County, AL","County or equivalent",2002,80240,-47,171,1109,938,-138,23,-161,-80
"45260",NA,NA,"Tallulah, LA","Micropolitan Statistical Area",2002,13028,-366,45,190,145,-411,1,-412,0
"45260",NA,22065,"Madison Parish, LA","County or equivalent",2002,13028,-366,45,190,145,-411,1,-412,0
"45340",NA,NA,"Taos, NM","Micropolitan Statistical Area",2002,30572,478,152,384,232,352,63,289,-26
"45340",NA,35055,"Taos County, NM","County or equivalent",2002,30572,478,152,384,232,352,63,289,-26
"45380",NA,NA,"Taylorville, IL","Micropolitan Statistical Area",2002,35024,-129,-43,393,436,-51,12,-63,-35
"45380",NA,17021,"Christian County, IL","County or equivalent",2002,35024,-129,-43,393,436,-51,12,-63,-35
"45540",NA,NA,"The Villages, FL","Micropolitan Statistical Area",2002,57497,2772,-322,432,754,3060,66,2994,34
"45540",NA,12119,"Sumter County, FL","County or equivalent",2002,57497,2772,-322,432,754,3060,66,2994,34
"45580",NA,NA,"Thomaston, GA","Micropolitan Statistical Area",2002,27558,-143,14,369,355,-134,40,-174,-23
"45580",NA,13293,"Upson County, GA","County or equivalent",2002,27558,-143,14,369,355,-134,40,-174,-23
"45620",NA,NA,"Thomasville, GA","Micropolitan Statistical Area",2002,42894,26,111,595,484,-43,26,-69,-42
"45620",NA,13275,"Thomas County, GA","County or equivalent",2002,42894,26,111,595,484,-43,26,-69,-42
"45640",NA,NA,"Thomasville-Lexington, NC","Micropolitan Statistical Area",2002,150377,1178,522,1891,1369,790,389,401,-134
"45640",NA,37057,"Davidson County, NC","County or equivalent",2002,150377,1178,522,1891,1369,790,389,401,-134
"45660",NA,NA,"Tiffin, OH","Micropolitan Statistical Area",2002,57943,-371,187,745,558,-515,20,-535,-43
"45660",NA,39147,"Seneca County, OH","County or equivalent",2002,57943,-371,187,745,558,-515,20,-535,-43
"45700",NA,NA,"Tifton, GA","Micropolitan Statistical Area",2002,38894,377,280,606,326,135,157,-22,-38
"45700",NA,13277,"Tift County, GA","County or equivalent",2002,38894,377,280,606,326,135,157,-22,-38
"45740",NA,NA,"Toccoa, GA","Micropolitan Statistical Area",2002,25577,18,-37,302,339,79,8,71,-24
"45740",NA,13257,"Stephens County, GA","County or equivalent",2002,25577,18,-37,302,339,79,8,71,-24
"45860",NA,NA,"Torrington, CT","Micropolitan Statistical Area",2002,185552,1627,225,1926,1701,1546,190,1356,-144
"45860",NA,9005,"Litchfield County, CT","County or equivalent",2002,185552,1627,225,1926,1701,1546,190,1356,-144
"45900",NA,NA,"Traverse City, MI","Micropolitan Statistical Area",2002,136144,1425,339,1467,1128,1190,73,1117,-104
"45900",NA,26019,"Benzie County, MI","County or equivalent",2002,16722,257,8,180,172,257,6,251,-8
"45900",NA,26055,"Grand Traverse County, MI","County or equivalent",2002,80988,1057,312,925,613,807,51,756,-62
"45900",NA,26079,"Kalkaska County, MI","County or equivalent",2002,16883,70,50,193,143,36,0,36,-16
"45900",NA,26089,"Leelanau County, MI","County or equivalent",2002,21551,41,-31,169,200,90,16,74,-18
"45980",NA,NA,"Troy, AL","Micropolitan Statistical Area",2002,29272,-357,55,398,343,-396,22,-418,-16
"45980",NA,1109,"Pike County, AL","County or equivalent",2002,29272,-357,55,398,343,-396,22,-418,-16
"46020",NA,NA,"Truckee-Grass Valley, CA","Micropolitan Statistical Area",2002,94416,821,-127,790,917,1006,91,915,-58
"46020",NA,6057,"Nevada County, CA","County or equivalent",2002,94416,821,-127,790,917,1006,91,915,-58
"46100",NA,NA,"Tullahoma, TN","Micropolitan Statistical Area",2002,94898,914,142,1143,1001,841,74,767,-69
"46100",NA,47031,"Coffee County, TN","County or equivalent",2002,49011,454,86,627,541,405,55,350,-37
"46100",NA,47051,"Franklin County, TN","County or equivalent",2002,39975,337,39,449,410,328,21,307,-30
"46100",NA,47127,"Moore County, TN","County or equivalent",2002,5912,123,17,67,50,108,-2,110,-2
"46180",NA,NA,"Tupelo, MS","Micropolitan Statistical Area",2002,126714,242,508,1799,1291,-144,62,-206,-122
"46180",NA,28057,"Itawamba County, MS","County or equivalent",2002,22767,-58,-17,267,284,-18,1,-19,-23
"46180",NA,28081,"Lee County, MS","County or equivalent",2002,76761,188,417,1164,747,-158,40,-198,-71
"46180",NA,28115,"Pontotoc County, MS","County or equivalent",2002,27186,112,108,368,260,32,21,11,-28
"46260",NA,NA,"Tuskegee, AL","Micropolitan Statistical Area",2002,23654,-327,-5,258,263,-309,16,-325,-13
"46260",NA,1087,"Macon County, AL","County or equivalent",2002,23654,-327,-5,258,263,-309,16,-325,-13
"46300",NA,NA,"Twin Falls, ID","Micropolitan Statistical Area",2002,83765,894,512,1298,786,464,266,198,-82
"46300",NA,16053,"Jerome County, ID","County or equivalent",2002,18533,85,156,313,157,-57,79,-136,-14
"46300",NA,16083,"Twin Falls County, ID","County or equivalent",2002,65232,809,356,985,629,521,187,334,-68
"46380",NA,NA,"Ukiah, CA","Micropolitan Statistical Area",2002,86940,320,191,1035,844,211,323,-112,-82
"46380",NA,6045,"Mendocino County, CA","County or equivalent",2002,86940,320,191,1035,844,211,323,-112,-82
"46420",NA,NA,"Union, SC","Micropolitan Statistical Area",2002,29250,-292,30,372,342,-299,1,-300,-23
"46420",NA,45087,"Union County, SC","County or equivalent",2002,29250,-292,30,372,342,-299,1,-300,-23
"46460",NA,NA,"Union City, TN-KY","Micropolitan Statistical Area",2002,39783,-267,24,527,503,-258,27,-285,-33
"46460",NA,21075,"Fulton County, KY","County or equivalent",2002,7570,-189,-24,95,119,-162,-1,-161,-3
"46460",NA,47131,"Obion County, TN","County or equivalent",2002,32213,-78,48,432,384,-96,28,-124,-30
"46500",NA,NA,"Urbana, OH","Micropolitan Statistical Area",2002,39132,166,129,485,356,76,1,75,-39
"46500",NA,39021,"Champaign County, OH","County or equivalent",2002,39132,166,129,485,356,76,1,75,-39
"46620",NA,NA,"Uvalde, TX","Micropolitan Statistical Area",2002,26404,415,234,459,225,209,48,161,-28
"46620",NA,48463,"Uvalde County, TX","County or equivalent",2002,26404,415,234,459,225,209,48,161,-28
"46740",NA,NA,"Valley, AL","Micropolitan Statistical Area",2002,35922,-329,-38,429,467,-263,16,-279,-28
"46740",NA,1017,"Chambers County, AL","County or equivalent",2002,35922,-329,-38,429,467,-263,16,-279,-28
"46780",NA,NA,"Van Wert, OH","Micropolitan Statistical Area",2002,29249,-144,37,338,301,-157,5,-162,-24
"46780",NA,39161,"Van Wert County, OH","County or equivalent",2002,29249,-144,37,338,301,-157,5,-162,-24
"46820",NA,NA,"Vermillion, SD","Micropolitan Statistical Area",2002,13413,-155,43,141,98,-191,14,-205,-7
"46820",NA,46027,"Clay County, SD","County or equivalent",2002,13413,-155,43,141,98,-191,14,-205,-7
"46860",NA,NA,"Vernal, UT","Micropolitan Statistical Area",2002,26174,477,314,501,187,183,9,174,-20
"46860",NA,49047,"Uintah County, UT","County or equivalent",2002,26174,477,314,501,187,183,9,174,-20
"46900",NA,NA,"Vernon, TX","Micropolitan Statistical Area",2002,14277,-87,41,222,181,-116,15,-131,-12
"46900",NA,48487,"Wilbarger County, TX","County or equivalent",2002,14277,-87,41,222,181,-116,15,-131,-12
"46980",NA,NA,"Vicksburg, MS","Micropolitan Statistical Area",2002,49017,-227,205,720,515,-397,15,-412,-35
"46980",NA,28149,"Warren County, MS","County or equivalent",2002,49017,-227,205,720,515,-397,15,-412,-35
"47080",NA,NA,"Vidalia, GA","Micropolitan Statistical Area",2002,34620,54,161,504,343,-79,116,-195,-28
"47080",NA,13209,"Montgomery County, GA","County or equivalent",2002,8505,-5,37,107,70,-35,15,-50,-7
"47080",NA,13279,"Toombs County, GA","County or equivalent",2002,26115,59,124,397,273,-44,101,-145,-21
"47180",NA,NA,"Vincennes, IN","Micropolitan Statistical Area",2002,38764,-77,23,451,428,-67,34,-101,-33
"47180",NA,18083,"Knox County, IN","County or equivalent",2002,38764,-77,23,451,428,-67,34,-101,-33
"47340",NA,NA,"Wabash, IN","Micropolitan Statistical Area",2002,34358,-269,-20,384,404,-222,-1,-221,-27
"47340",NA,18169,"Wabash County, IN","County or equivalent",2002,34358,-269,-20,384,404,-222,-1,-221,-27
"47420",NA,NA,"Wahpeton, ND-MN","Micropolitan Statistical Area",2002,24302,-257,47,266,219,-288,3,-291,-16
"47420",NA,27167,"Wilkin County, MN","County or equivalent",2002,6922,-39,-5,64,69,-26,0,-26,-8
"47420",NA,38077,"Richland County, ND","County or equivalent",2002,17380,-218,52,202,150,-262,3,-265,-8
"47460",NA,NA,"Walla Walla, WA","Micropolitan Statistical Area",2002,55866,668,189,691,502,527,172,355,-48
"47460",NA,53071,"Walla Walla County, WA","County or equivalent",2002,55866,668,189,691,502,527,172,355,-48
"47500",NA,NA,"Walterboro, SC","Micropolitan Statistical Area",2002,38591,167,168,554,386,37,18,19,-38
"47500",NA,45029,"Colleton County, SC","County or equivalent",2002,38591,167,168,554,386,37,18,19,-38
"47540",NA,NA,"Wapakoneta, OH","Micropolitan Statistical Area",2002,46389,-179,93,558,465,-235,21,-256,-37
"47540",NA,39011,"Auglaize County, OH","County or equivalent",2002,46389,-179,93,558,465,-235,21,-256,-37
"47620",NA,NA,"Warren, PA","Micropolitan Statistical Area",2002,42969,-559,-70,422,492,-463,1,-464,-26
"47620",NA,42123,"Warren County, PA","County or equivalent",2002,42969,-559,-70,422,492,-463,1,-464,-26
"47660",NA,NA,"Warrensburg, MO","Micropolitan Statistical Area",2002,49858,564,340,685,345,268,-61,329,-44
"47660",NA,29101,"Johnson County, MO","County or equivalent",2002,49858,564,340,685,345,268,-61,329,-44
"47700",NA,NA,"Warsaw, IN","Micropolitan Statistical Area",2002,74701,-24,456,1054,598,-422,125,-547,-58
"47700",NA,18085,"Kosciusko County, IN","County or equivalent",2002,74701,-24,456,1054,598,-422,125,-547,-58
"47780",NA,NA,"Washington, IN","Micropolitan Statistical Area",2002,29646,19,171,452,281,-125,47,-172,-27
"47780",NA,18027,"Daviess County, IN","County or equivalent",2002,29646,19,171,452,281,-125,47,-172,-27
"47820",NA,NA,"Washington, NC","Micropolitan Statistical Area",2002,44963,1,99,631,532,-59,70,-129,-39
"47820",NA,37013,"Beaufort County, NC","County or equivalent",2002,44963,1,99,631,532,-59,70,-129,-39
"47920",NA,NA,"Washington Court House, OH","Micropolitan Statistical Area",2002,28153,-17,79,396,317,-72,9,-81,-24
"47920",NA,39047,"Fayette County, OH","County or equivalent",2002,28153,-17,79,396,317,-72,9,-81,-24
"47980",NA,NA,"Watertown, SD","Micropolitan Statistical Area",2002,31423,-22,124,429,305,-120,15,-135,-26
"47980",NA,46029,"Codington County, SD","County or equivalent",2002,25880,-22,109,343,234,-111,15,-126,-20
"47980",NA,46057,"Hamlin County, SD","County or equivalent",2002,5543,0,15,86,71,-9,0,-9,-6
"48020",NA,NA,"Watertown-Fort Atkinson, WI","Micropolitan Statistical Area",2002,76680,333,371,917,546,42,108,-66,-80
"48020",NA,55055,"Jefferson County, WI","County or equivalent",2002,76680,333,371,917,546,42,108,-66,-80
"48060",NA,NA,"Watertown-Fort Drum, NY","Micropolitan Statistical Area",2002,113936,2097,791,1687,896,-1218,-477,-741,2524
"48060",NA,36045,"Jefferson County, NY","County or equivalent",2002,113936,2097,791,1687,896,-1218,-477,-741,2524
"48100",NA,NA,"Wauchula, FL","Micropolitan Statistical Area",2002,27266,595,222,438,216,397,245,152,-24
"48100",NA,12049,"Hardee County, FL","County or equivalent",2002,27266,595,222,438,216,397,245,152,-24
"48180",NA,NA,"Waycross, GA","Micropolitan Statistical Area",2002,51133,-110,114,729,615,-183,74,-257,-41
"48180",NA,13229,"Pierce County, GA","County or equivalent",2002,15996,182,39,224,185,160,20,140,-17
"48180",NA,13299,"Ware County, GA","County or equivalent",2002,35137,-292,75,505,430,-343,54,-397,-24
"48460",NA,NA,"West Plains, MO","Micropolitan Statistical Area",2002,37164,64,11,477,466,91,18,73,-38
"48460",NA,29091,"Howell County, MO","County or equivalent",2002,37164,64,11,477,466,91,18,73,-38
"48500",NA,NA,"West Point, MS","Micropolitan Statistical Area",2002,21838,42,97,325,228,-34,2,-36,-21
"48500",NA,28025,"Clay County, MS","County or equivalent",2002,21838,42,97,325,228,-34,2,-36,-21
"48580",NA,NA,"Whitewater, WI","Micropolitan Statistical Area",2002,95130,1727,365,1121,756,1431,201,1230,-69
"48580",NA,55127,"Walworth County, WI","County or equivalent",2002,95130,1727,365,1121,756,1431,201,1230,-69
"48740",NA,NA,"Willimantic, CT","Micropolitan Statistical Area",2002,110896,1110,226,1250,1024,968,184,784,-84
"48740",NA,9015,"Windham County, CT","County or equivalent",2002,110896,1110,226,1250,1024,968,184,784,-84
"48780",NA,NA,"Williston, ND","Micropolitan Statistical Area",2002,19415,-15,-16,196,212,19,6,13,-18
"48780",NA,38105,"Williams County, ND","County or equivalent",2002,19415,-15,-16,196,212,19,6,13,-18
"48820",NA,NA,"Willmar, MN","Micropolitan Statistical Area",2002,40893,-288,198,537,339,-463,76,-539,-23
"48820",NA,27067,"Kandiyohi County, MN","County or equivalent",2002,40893,-288,198,537,339,-463,76,-539,-23
"48940",NA,NA,"Wilmington, OH","Micropolitan Statistical Area",2002,41221,308,250,609,359,97,37,60,-39
"48940",NA,39027,"Clinton County, OH","County or equivalent",2002,41221,308,250,609,359,97,37,60,-39
"48980",NA,NA,"Wilson, NC","Micropolitan Statistical Area",2002,74654,737,357,1096,739,450,257,193,-70
"48980",NA,37195,"Wilson County, NC","County or equivalent",2002,74654,737,357,1096,739,450,257,193,-70
"49060",NA,NA,"Winfield, KS","Micropolitan Statistical Area",2002,36061,304,62,504,442,270,27,243,-28
"49060",NA,20035,"Cowley County, KS","County or equivalent",2002,36061,304,62,504,442,270,27,243,-28
"49100",NA,NA,"Winona, MN","Micropolitan Statistical Area",2002,49503,-319,71,510,439,-354,62,-416,-36
"49100",NA,27169,"Winona County, MN","County or equivalent",2002,49503,-319,71,510,439,-354,62,-416,-36
"49260",NA,NA,"Woodward, OK","Micropolitan Statistical Area",2002,18388,69,104,266,162,-18,12,-30,-17
"49260",NA,40153,"Woodward County, OK","County or equivalent",2002,18388,69,104,266,162,-18,12,-30,-17
"49300",NA,NA,"Wooster, OH","Micropolitan Statistical Area",2002,112542,452,706,1614,908,-150,86,-236,-104
"49300",NA,39169,"Wayne County, OH","County or equivalent",2002,112542,452,706,1614,908,-150,86,-236,-104
"49380",NA,NA,"Worthington, MN","Micropolitan Statistical Area",2002,20469,-272,124,299,175,-392,79,-471,-4
"49380",NA,27105,"Nobles County, MN","County or equivalent",2002,20469,-272,124,299,175,-392,79,-471,-4
"49460",NA,NA,"Yankton, SD","Micropolitan Statistical Area",2002,21476,9,41,236,195,-10,5,-15,-22
"49460",NA,46135,"Yankton County, SD","County or equivalent",2002,21476,9,41,236,195,-10,5,-15,-22
"49540",NA,NA,"Yazoo City, MS","Micropolitan Statistical Area",2002,27672,-95,135,417,282,-208,11,-219,-22
"49540",NA,28163,"Yazoo County, MS","County or equivalent",2002,27672,-95,135,417,282,-208,11,-219,-22
"49780",NA,NA,"Zanesville, OH","Micropolitan Statistical Area",2002,85074,379,229,1075,846,234,11,223,-84
"49780",NA,39119,"Muskingum County, OH","County or equivalent",2002,85074,379,229,1075,846,234,11,223,-84
"10180",NA,48059,"Callahan County, TX","County or equivalent",2003,12889,87,-26,116,142,120,-2,122,-7
"10180",NA,48253,"Jones County, TX","County or equivalent",2003,19911,-71,-26,173,199,-20,-2,-18,-25
"10180",NA,48441,"Taylor County, TX","County or equivalent",2003,125229,-86,825,1955,1130,-731,-613,-118,-180
"10420",NA,NA,"Akron, OH","Metropolitan Statistical Area",2003,700110,647,1772,8352,6580,-660,539,-1199,-465
"10420",NA,39133,"Portage County, OH","County or equivalent",2003,154473,781,457,1609,1152,524,89,435,-200
"10420",NA,39153,"Summit County, OH","County or equivalent",2003,545637,-134,1315,6743,5428,-1184,450,-1634,-265
"10500",NA,NA,"Albany, GA","Metropolitan Statistical Area",2003,161128,1115,822,2223,1401,-223,-127,-96,516
"10500",NA,13007,"Baker County, GA","County or equivalent",2003,4151,199,-3,38,41,191,2,189,11
"10500",NA,13095,"Dougherty County, GA","County or equivalent",2003,95518,-224,593,1466,873,-712,-138,-574,-105
"10500",NA,13177,"Lee County, GA","County or equivalent",2003,28837,1110,158,296,138,304,6,298,648
"10500",NA,13273,"Terrell County, GA","County or equivalent",2003,10903,76,10,159,149,76,1,75,-10
"10500",NA,13321,"Worth County, GA","County or equivalent",2003,21719,-46,64,264,200,-82,2,-84,-28
"10580",NA,NA,"Albany-Schenectady-Troy, NY","Metropolitan Statistical Area",2003,839545,6020,1982,9582,7600,4979,893,4086,-941
"10580",NA,36001,"Albany County, NY","County or equivalent",2003,298388,1863,406,3238,2832,1794,536,1258,-337
"10580",NA,36083,"Rensselaer County, NY","County or equivalent",2003,152903,699,259,1731,1472,629,214,415,-189
"10580",NA,36091,"Saratoga County, NY","County or equivalent",2003,209678,3043,1085,2511,1426,2131,-41,2172,-173
"10580",NA,36093,"Schenectady County, NY","County or equivalent",2003,146872,338,225,1807,1582,318,185,133,-205
"10580",NA,36095,"Schoharie County, NY","County or equivalent",2003,31704,77,7,295,288,107,-1,108,-37
"10740",NA,NA,"Albuquerque, NM","Metropolitan Statistical Area",2003,765381,12171,5696,11310,5614,7153,1129,6024,-678
"10740",NA,35001,"Bernalillo County, NM","County or equivalent",2003,582378,8991,4477,8870,4393,5106,988,4118,-592
"10740",NA,35043,"Sandoval County, NM","County or equivalent",2003,98335,2703,711,1325,614,1997,42,1955,-5
"10740",NA,35057,"Torrance County, NM","County or equivalent",2003,16883,349,42,175,133,307,8,299,0
"10740",NA,35061,"Valencia County, NM","County or equivalent",2003,67785,128,466,940,474,-257,91,-348,-81
"10780",NA,NA,"Alexandria, LA","Metropolitan Statistical Area",2003,145518,395,488,2092,1604,14,13,1,-107
"10780",NA,22043,"Grant Parish, LA","County or equivalent",2003,18740,70,39,234,195,57,-6,63,-26
"10780",NA,22079,"Rapides Parish, LA","County or equivalent",2003,126778,325,449,1858,1409,-43,19,-62,-81
"10900",NA,NA,"Allentown-Bethlehem-Easton, PA-NJ","Metropolitan Statistical Area",2003,765277,9371,1561,8845,7284,8152,1299,6853,-342
"10900",NA,34041,"Warren County, NJ","County or equivalent",2003,108232,1361,521,1400,879,943,180,763,-103
"10900",NA,42025,"Carbon County, PA","County or equivalent",2003,59998,442,-134,583,717,612,8,604,-36
"10900",NA,42077,"Lehigh County, PA","County or equivalent",2003,320142,3593,793,3871,3078,3093,698,2395,-293
"10900",NA,42095,"Northampton County, PA","County or equivalent",2003,276905,3975,381,2991,2610,3504,413,3091,90
"11020",NA,NA,"Altoona, PA","Metropolitan Statistical Area",2003,126837,-504,-120,1483,1603,-223,13,-236,-161
"11020",NA,42013,"Blair County, PA","County or equivalent",2003,126837,-504,-120,1483,1603,-223,13,-236,-161
"11100",NA,NA,"Amarillo, TX","Metropolitan Statistical Area",2003,232707,2546,1586,3694,2108,1227,444,783,-267
"11100",NA,48011,"Armstrong County, TX","County or equivalent",2003,2053,-19,-9,19,28,-8,1,-9,-2
"11100",NA,48065,"Carson County, TX","County or equivalent",2003,6367,-132,10,75,65,-143,1,-144,1
"11100",NA,48375,"Potter County, TX","County or equivalent",2003,117458,1722,930,2160,1230,941,349,592,-149
"11100",NA,48381,"Randall County, TX","County or equivalent",2003,106829,975,655,1440,785,437,93,344,-117
"11180",NA,NA,"Ames, IA","Metropolitan Statistical Area",2003,81481,-126,469,953,484,-546,436,-982,-49
"11180",NA,19169,"Story County, IA","County or equivalent",2003,81481,-126,469,953,484,-546,436,-982,-49
"11260",NA,NA,"Anchorage, AK","Metropolitan Statistical Area",2003,338665,6308,3474,5009,1535,3033,-1008,4041,-199
"11260",NA,2020,"Anchorage Municipality, AK","County or equivalent",2003,271175,3341,2968,4186,1218,644,-978,1622,-271
"11260",NA,2170,"Matanuska-Susitna Borough, AK","County or equivalent",2003,67490,2967,506,823,317,2389,-30,2419,72
"11300",NA,NA,"Anderson, IN","Metropolitan Statistical Area",2003,131627,-831,171,1566,1395,-863,68,-931,-139
"11300",NA,18095,"Madison County, IN","County or equivalent",2003,131627,-831,171,1566,1395,-863,68,-931,-139
"11340",NA,NA,"Anderson, SC","Metropolitan Statistical Area",2003,171132,1258,386,2207,1821,1064,96,968,-192
"11340",NA,45007,"Anderson County, SC","County or equivalent",2003,171132,1258,386,2207,1821,1064,96,968,-192
"11460",NA,NA,"Ann Arbor, MI","Metropolitan Statistical Area",2003,337093,3457,2334,4213,1879,1621,1827,-206,-498
"11460",NA,26161,"Washtenaw County, MI","County or equivalent",2003,337093,3457,2334,4213,1879,1621,1827,-206,-498
"11500",NA,NA,"Anniston-Oxford, AL","Metropolitan Statistical Area",2003,111308,494,200,1413,1213,427,27,400,-133
"11500",NA,1015,"Calhoun County, AL","County or equivalent",2003,111308,494,200,1413,1213,427,27,400,-133
"11540",NA,NA,"Appleton, WI","Metropolitan Statistical Area",2003,210226,2114,1533,2930,1397,851,193,658,-270
"11540",NA,55015,"Calumet County, WI","County or equivalent",2003,43337,814,361,603,242,474,29,445,-21
"11540",NA,55087,"Outagamie County, WI","County or equivalent",2003,166889,1300,1172,2327,1155,377,164,213,-249
"11700",NA,NA,"Asheville, NC","Metropolitan Statistical Area",2003,381769,4125,159,4381,4222,4255,703,3552,-289
"11700",NA,37021,"Buncombe County, NC","County or equivalent",2003,213114,2491,233,2457,2224,2411,390,2021,-153
"11700",NA,37087,"Haywood County, NC","County or equivalent",2003,55347,430,-37,575,612,513,21,492,-46
"11700",NA,37089,"Henderson County, NC","County or equivalent",2003,93514,1256,-25,1137,1162,1344,286,1058,-63
"11700",NA,37115,"Madison County, NC","County or equivalent",2003,19794,-52,-12,212,224,-13,6,-19,-27
"12020",NA,NA,"Athens-Clarke County, GA","Metropolitan Statistical Area",2003,173823,2909,1145,2288,1143,1933,593,1340,-169
"12020",NA,13059,"Clarke County, GA","County or equivalent",2003,105740,1582,762,1390,628,954,544,410,-134
"12020",NA,13195,"Madison County, GA","County or equivalent",2003,26928,340,140,379,239,224,20,204,-24
"12020",NA,13219,"Oconee County, GA","County or equivalent",2003,27933,849,183,347,164,666,25,641,0
"12020",NA,13221,"Oglethorpe County, GA","County or equivalent",2003,13222,138,60,172,112,89,4,85,-11
"12060",NA,NA,"Atlanta-Sandy Springs-Marietta, GA","Metropolitan Statistical Area",2003,4672334,117565,46734,74391,27657,44952,22445,22507,25879
"12060",NA,13013,"Barrow County, GA","County or equivalent",2003,53047,2077,470,877,407,1567,45,1522,40
"12060",NA,13015,"Bartow County, GA","County or equivalent",2003,84439,2197,784,1468,684,1447,103,1344,-34
"12060",NA,13035,"Butts County, GA","County or equivalent",2003,21812,585,122,321,199,463,1,462,0
"12060",NA,13045,"Carroll County, GA","County or equivalent",2003,98476,3621,704,1551,847,2849,161,2688,68
"12060",NA,13057,"Cherokee County, GA","County or equivalent",2003,165854,6930,1973,2809,836,4892,420,4472,65
"12060",NA,13063,"Clayton County, GA","County or equivalent",2003,257820,5395,3139,4468,1329,2589,1106,1483,-333
"12060",NA,13067,"Cobb County, GA","County or equivalent",2003,643633,6016,7133,10397,3264,-452,3660,-4112,-665
"12060",NA,13077,"Coweta County, GA","County or equivalent",2003,100614,3228,852,1534,682,2380,201,2179,-4
"12060",NA,13085,"Dawson County, GA","County or equivalent",2003,18389,856,106,239,133,726,11,715,24
"12060",NA,13089,"DeKalb County, GA","County or equivalent",2003,696814,6987,6907,10994,4087,-6874,6181,-13055,6954
"12060",NA,13097,"Douglas County, GA","County or equivalent",2003,101414,3227,803,1469,666,2412,140,2272,12
"12060",NA,13113,"Fayette County, GA","County or equivalent",2003,97976,2026,318,927,609,1751,110,1641,-43
"12060",NA,13117,"Forsyth County, GA","County or equivalent",2003,123118,6977,1569,2186,617,5236,322,4914,172
"12060",NA,13121,"Fulton County, GA","County or equivalent",2003,881928,19021,7114,12973,5859,-7592,4586,-12178,19499
"12060",NA,13135,"Gwinnett County, GA","County or equivalent",2003,666978,22106,9335,11973,2638,13201,4799,8402,-430
"12060",NA,13143,"Haralson County, GA","County or equivalent",2003,27309,551,91,389,298,470,9,461,-10
"12060",NA,13149,"Heard County, GA","County or equivalent",2003,11105,-89,40,143,103,-122,1,-123,-7
"12060",NA,13151,"Henry County, GA","County or equivalent",2003,149455,9659,1490,2328,838,7795,32,7763,374
"12060",NA,13159,"Jasper County, GA","County or equivalent",2003,12433,411,82,184,102,321,10,311,8
"12060",NA,13171,"Lamar County, GA","County or equivalent",2003,16247,108,33,186,153,93,4,89,-18
"12060",NA,13199,"Meriwether County, GA","County or equivalent",2003,22740,-124,52,313,261,-149,0,-149,-27
"12060",NA,13217,"Newton County, GA","County or equivalent",2003,75713,4471,782,1326,544,3527,58,3469,162
"12060",NA,13223,"Paulding County, GA","County or equivalent",2003,99170,5307,1333,1806,473,3828,15,3813,146
"12060",NA,13227,"Pickens County, GA","County or equivalent",2003,26691,1116,119,367,248,963,18,945,34
"12060",NA,13231,"Pike County, GA","County or equivalent",2003,15019,409,61,181,120,343,0,343,5
"12060",NA,13247,"Rockdale County, GA","County or equivalent",2003,74620,1667,502,1021,519,1208,328,880,-43
"12060",NA,13255,"Spalding County, GA","County or equivalent",2003,60332,494,291,901,610,278,85,193,-75
"12060",NA,13297,"Walton County, GA","County or equivalent",2003,69188,2336,529,1060,531,1802,39,1763,5
"12100",NA,NA,"Atlantic City-Hammonton, NJ","Metropolitan Statistical Area",2003,261621,3612,701,3551,2850,3174,1093,2081,-263
"12100",NA,34001,"Atlantic County, NJ","County or equivalent",2003,261621,3612,701,3551,2850,3174,1093,2081,-263
"12220",NA,NA,"Auburn-Opelika, AL","Metropolitan Statistical Area",2003,119520,1393,620,1393,773,901,111,790,-128
"12220",NA,1081,"Lee County, AL","County or equivalent",2003,119520,1393,620,1393,773,901,111,790,-128
"12260",NA,NA,"Augusta-Richmond County, GA-SC","Metropolitan Statistical Area",2003,509285,3010,2473,7113,4640,1080,-1015,2095,-543
"12260",NA,13033,"Burke County, GA","County or equivalent",2003,22690,13,156,393,237,-115,-3,-112,-28
"12260",NA,13073,"Columbia County, GA","County or equivalent",2003,96374,2257,760,1295,535,1519,-73,1592,-22
"12260",NA,13189,"McDuffie County, GA","County or equivalent",2003,21181,9,10,287,277,28,-3,31,-29
"12260",NA,13245,"Richmond County, GA","County or equivalent",2003,198258,-765,1132,3089,1957,-1618,-1062,-556,-279
"12260",NA,45003,"Aiken County, SC","County or equivalent",2003,145866,1213,348,1780,1432,1031,115,916,-166
"12260",NA,45037,"Edgefield County, SC","County or equivalent",2003,24916,283,67,269,202,235,11,224,-19
"12420",NA,NA,"Austin-Round Rock, TX","Metropolitan Statistical Area",2003,1382675,29553,15951,22560,6609,14293,7377,6916,-691
"12420",NA,48021,"Bastrop County, TX","County or equivalent",2003,66128,2377,431,931,500,1908,135,1773,38
"12420",NA,48055,"Caldwell County, TX","County or equivalent",2003,35231,539,277,536,259,300,33,267,-38
"12420",NA,48209,"Hays County, TX","County or equivalent",2003,116283,4421,1104,1625,521,3255,144,3111,62
"12420",NA,48453,"Travis County, TX","County or equivalent",2003,862641,9571,10429,14406,3977,23,6499,-6476,-881
"12420",NA,48491,"Williamson County, TX","County or equivalent",2003,302392,12645,3710,5062,1352,8807,566,8241,128
"12540",NA,NA,"Bakersfield, CA","Metropolitan Statistical Area",2003,707673,18056,7284,12537,5253,11148,2085,9063,-376
"12540",NA,6029,"Kern County, CA","County or equivalent",2003,707673,18056,7284,12537,5253,11148,2085,9063,-376
"12580",NA,NA,"Baltimore-Towson, MD","Metropolitan Statistical Area",2003,2620419,21113,10138,33881,23743,5433,1877,3556,5542
"12580",NA,24003,"Anne Arundel County, MD","County or equivalent",2003,505000,2733,3241,6855,3614,145,-1281,1426,-653
"12580",NA,24005,"Baltimore County, MD","County or equivalent",2003,773921,5874,1597,9316,7719,5190,1552,3638,-913
"12580",NA,24013,"Carroll County, MD","County or equivalent",2003,162229,3632,682,1917,1235,2982,35,2947,-32
"12580",NA,24025,"Harford County, MD","County or equivalent",2003,230654,3922,1289,2889,1600,2761,-120,2881,-128
"12580",NA,24027,"Howard County, MD","County or equivalent",2003,262517,3388,2213,3549,1336,1552,778,774,-377
"12580",NA,24035,"Queen Anne's County, MD","County or equivalent",2003,43774,1190,134,500,366,1045,28,1017,11
"12580",NA,24510,"Baltimore city, MD","County or equivalent",2003,642324,374,982,8855,7873,-8242,885,-9127,7634
"12620",NA,NA,"Bangor, ME","Metropolitan Statistical Area",2003,147061,854,163,1557,1394,853,55,798,-162
"12620",NA,23019,"Penobscot County, ME","County or equivalent",2003,147061,854,163,1557,1394,853,55,798,-162
"12700",NA,NA,"Barnstable Town, MA","Metropolitan Statistical Area",2003,228135,1133,-786,2000,2786,2095,188,1907,-176
"12700",NA,25001,"Barnstable County, MA","County or equivalent",2003,228135,1133,-786,2000,2786,2095,188,1907,-176
"12940",NA,NA,"Baton Rouge, LA","Metropolitan Statistical Area",2003,718850,5494,4440,10198,5758,1705,738,967,-651
"12940",NA,22005,"Ascension Parish, LA","County or equivalent",2003,83609,2445,828,1386,558,1629,65,1564,-12
"12940",NA,22033,"East Baton Rouge Parish, LA","County or equivalent",2003,411344,1004,2400,5723,3323,-886,658,-1544,-510
"12940",NA,22037,"East Feliciana Parish, LA","County or equivalent",2003,20915,-113,23,251,228,-110,1,-111,-26
"12940",NA,22047,"Iberville Parish, LA","County or equivalent",2003,32746,-292,133,448,315,-403,1,-404,-22
"12940",NA,22063,"Livingston Parish, LA","County or equivalent",2003,101051,2755,857,1573,716,1901,12,1889,-3
"12940",NA,22077,"Pointe Coupee Parish, LA","County or equivalent",2003,22206,-146,48,295,247,-174,-4,-170,-20
"12940",NA,22091,"St. Helena Parish, LA","County or equivalent",2003,10322,-108,9,102,93,-107,-1,-106,-10
"12940",NA,22121,"West Baton Rouge Parish, LA","County or equivalent",2003,21573,-71,124,299,175,-169,4,-173,-26
"12940",NA,22125,"West Feliciana Parish, LA","County or equivalent",2003,15084,20,18,121,103,24,2,22,-22
"12980",NA,NA,"Battle Creek, MI","Metropolitan Statistical Area",2003,138418,153,456,1915,1459,-112,139,-251,-191
"12980",NA,26025,"Calhoun County, MI","County or equivalent",2003,138418,153,456,1915,1459,-112,139,-251,-191
"13020",NA,NA,"Bay City, MI","Metropolitan Statistical Area",2003,109122,-454,116,1230,1114,-443,8,-451,-127
"13020",NA,26017,"Bay County, MI","County or equivalent",2003,109122,-454,116,1230,1114,-443,8,-451,-127
"13140",NA,NA,"Beaumont-Port Arthur, TX","Metropolitan Statistical Area",2003,379987,-961,1294,5139,3845,-1843,478,-2321,-412
"13140",NA,48199,"Hardin County, TX","County or equivalent",2003,49167,298,138,579,441,224,8,216,-64
"13140",NA,48245,"Jefferson County, TX","County or equivalent",2003,247237,-984,913,3423,2510,-1641,431,-2072,-256
"13140",NA,48361,"Orange County, TX","County or equivalent",2003,83583,-275,243,1137,894,-426,39,-465,-92
"13380",NA,NA,"Bellingham, WA","Metropolitan Statistical Area",2003,177699,2811,687,2043,1356,2295,524,1771,-171
"13380",NA,53073,"Whatcom County, WA","County or equivalent",2003,177699,2811,687,2043,1356,2295,524,1771,-171
"13460",NA,NA,"Bend, OR","Metropolitan Statistical Area",2003,129292,3852,566,1564,998,3246,68,3178,40
"13460",NA,41017,"Deschutes County, OR","County or equivalent",2003,129292,3852,566,1564,998,3246,68,3178,40
"13740",NA,NA,"Billings, MT","Metropolitan Statistical Area",2003,142674,1273,555,1850,1295,868,18,850,-150
"13740",NA,30009,"Carbon County, MT","County or equivalent",2003,9646,-5,-31,68,99,36,5,31,-10
"13740",NA,30111,"Yellowstone County, MT","County or equivalent",2003,133028,1278,586,1782,1196,832,13,819,-140
"13780",NA,NA,"Binghamton, NY","Metropolitan Statistical Area",2003,249622,-1633,85,2637,2552,-1460,326,-1786,-258
"13780",NA,36007,"Broome County, NY","County or equivalent",2003,198326,-1344,-71,2048,2119,-1072,309,-1381,-201
"13780",NA,36107,"Tioga County, NY","County or equivalent",2003,51296,-289,156,589,433,-388,17,-405,-57
"13820",NA,NA,"Birmingham-Hoover, AL","Metropolitan Statistical Area",2003,1072415,7935,3289,14451,11162,4690,1022,3668,-44
"13820",NA,1007,"Bibb County, AL","County or equivalent",2003,21038,55,26,247,221,56,2,54,-27
"13820",NA,1009,"Blount County, AL","County or equivalent",2003,53660,923,105,661,556,842,75,767,-24
"13820",NA,1021,"Chilton County, AL","County or equivalent",2003,40743,294,117,554,437,223,28,195,-46
"13820",NA,1073,"Jefferson County, AL","County or equivalent",2003,659741,424,1646,8937,7291,-1112,769,-1881,-110
"13820",NA,1115,"St. Clair County, AL","County or equivalent",2003,68274,1192,56,799,743,1152,5,1147,-16
"13820",NA,1117,"Shelby County, AL","County or equivalent",2003,159443,5634,1419,2380,961,3955,120,3835,260
"13820",NA,1127,"Walker County, AL","County or equivalent",2003,69516,-587,-80,873,953,-426,23,-449,-81
"13900",NA,NA,"Bismarck, ND","Metropolitan Statistical Area",2003,96851,761,438,1205,767,424,1,423,-101
"13900",NA,38015,"Burleigh County, ND","County or equivalent",2003,71851,828,373,902,529,526,-1,527,-71
"13900",NA,38059,"Morton County, ND","County or equivalent",2003,25000,-67,65,303,238,-102,2,-104,-30
"13980",NA,NA,"Blacksburg-Christiansburg-Radford, VA","Metropolitan Statistical Area",2003,152818,246,252,1478,1226,188,321,-133,-194
"13980",NA,51071,"Giles County, VA","County or equivalent",2003,16827,20,-26,204,230,65,-1,66,-19
"13980",NA,51121,"Montgomery County, VA","County or equivalent",2003,85654,596,297,805,508,425,307,118,-126
"13980",NA,51155,"Pulaski County, VA","County or equivalent",2003,34748,-72,-38,344,382,17,3,14,-51
"13980",NA,51750,"Radford city, VA","County or equivalent",2003,15589,-298,19,125,106,-319,12,-331,2
"14020",NA,NA,"Bloomington, IN","Metropolitan Statistical Area",2003,178098,1626,536,1890,1354,1289,400,889,-199
"14020",NA,18055,"Greene County, IN","County or equivalent",2003,33130,162,71,445,374,126,1,125,-35
"14020",NA,18105,"Monroe County, IN","County or equivalent",2003,122395,1158,446,1206,760,861,399,462,-149
"14020",NA,18119,"Owen County, IN","County or equivalent",2003,22573,306,19,239,220,302,0,302,-15
"14060",NA,NA,"Bloomington-Normal, IL","Metropolitan Statistical Area",2003,157227,1632,1100,2128,1028,746,227,519,-214
"14060",NA,17113,"McLean County, IL","County or equivalent",2003,157227,1632,1100,2128,1028,746,227,519,-214
"14260",NA,NA,"Boise City-Nampa, ID","Metropolitan Statistical Area",2003,510729,11766,5246,8390,3144,6900,885,6015,-380
"14260",NA,16001,"Ada County, ID","County or equivalent",2003,326196,5329,3166,5038,1872,2557,514,2043,-394
"14260",NA,16015,"Boise County, ID","County or equivalent",2003,7151,163,21,58,37,141,0,141,1
"14260",NA,16027,"Canyon County, ID","County or equivalent",2003,150995,6046,1941,2915,974,4058,313,3745,47
"14260",NA,16045,"Gem County, ID","County or equivalent",2003,15524,145,20,191,171,141,17,124,-16
"14260",NA,16073,"Owyhee County, ID","County or equivalent",2003,10863,83,98,188,90,3,41,-38,-18
"14460",NA,NA,"Boston-Cambridge-Quincy, MA-NH","Metropolitan Statistical Area",2003,4456379,5,21050,57014,35964,-26627,20409,-47036,5582
"14460",14484,NA,"Boston-Quincy, MA","Metropolitan Division",2003,1849638,2152,8767,24111,15344,-12717,9677,-22394,6102
"14460",14484,25021,"Norfolk County, MA","County or equivalent",2003,653262,-814,2525,8322,5797,-2658,2060,-4718,-681
"14460",14484,25023,"Plymouth County, MA","County or equivalent",2003,485029,2279,2345,6424,4079,658,669,-11,-724
"14460",14484,25025,"Suffolk County, MA","County or equivalent",2003,711347,687,3897,9365,5468,-10717,6948,-17665,7507
"14460",15764,NA,"Cambridge-Newton-Framingham, MA","Metropolitan Division",2003,1468316,-4372,7112,18536,11424,-12222,8113,-20335,738
"14460",15764,25017,"Middlesex County, MA","County or equivalent",2003,1468316,-4372,7112,18536,11424,-12222,8113,-20335,738
"14460",37764,NA,"Peabody, MA","Metropolitan Division",2003,732496,-720,3049,9599,6550,-3046,2393,-5439,-723
"14460",37764,25009,"Essex County, MA","County or equivalent",2003,732496,-720,3049,9599,6550,-3046,2393,-5439,-723
"14460",40484,NA,"Rockingham County-Strafford County, NH","Metropolitan Division",2003,405929,2945,2122,4768,2646,1358,226,1132,-535
"14460",40484,33015,"Rockingham County, NH","County or equivalent",2003,288891,1886,1563,3379,1816,720,157,563,-397
"14460",40484,33017,"Strafford County, NH","County or equivalent",2003,117038,1059,559,1389,830,638,69,569,-138
"14500",NA,NA,"Boulder, CO /1","Metropolitan Statistical Area",2003,279318,-514,2075,3525,1450,-2438,1355,-3793,-151
"14500",NA,8013,"Boulder County, CO /1","County or equivalent",2003,279318,-514,2075,3525,1450,-2438,1355,-3793,-151
"14540",NA,NA,"Bowling Green, KY","Metropolitan Statistical Area",2003,107735,1563,489,1388,899,1173,308,865,-99
"14540",NA,21061,"Edmonson County, KY","County or equivalent",2003,11772,26,13,121,108,28,4,24,-15
"14540",NA,21227,"Warren County, KY","County or equivalent",2003,95963,1537,476,1267,791,1145,304,841,-84
"14600",NA,NA,"Bradenton-Sarasota-Venice, FL","Metropolitan Statistical Area",2003,631047,12860,-1735,6259,7994,14441,1539,12902,154
"14600",NA,12081,"Manatee County, FL","County or equivalent",2003,285799,6610,-26,3321,3347,6566,614,5952,70
"14600",NA,12115,"Sarasota County, FL","County or equivalent",2003,345248,6250,-1709,2938,4647,7875,925,6950,84
"14740",NA,NA,"Bremerton-Silverdale, WA","Metropolitan Statistical Area",2003,238884,2261,1274,3024,1750,1151,-1482,2633,-164
"14740",NA,53035,"Kitsap County, WA","County or equivalent",2003,238884,2261,1274,3024,1750,1151,-1482,2633,-164
"14860",NA,NA,"Bridgeport-Stamford-Norwalk, CT","Metropolitan Statistical Area",2003,892776,1863,5074,12171,7097,-2358,5723,-8081,-853
"14860",NA,9001,"Fairfield County, CT","County or equivalent",2003,892776,1863,5074,12171,7097,-2358,5723,-8081,-853
"15180",NA,NA,"Brownsville-Harlingen, TX","Metropolitan Statistical Area",2003,357595,7727,6688,8692,2004,1574,1790,-216,-535
"15180",NA,48061,"Cameron County, TX","County or equivalent",2003,357595,7727,6688,8692,2004,1574,1790,-216,-535
"15260",NA,NA,"Brunswick, GA","Metropolitan Statistical Area",2003,95942,965,341,1336,995,727,88,639,-103
"15260",NA,13025,"Brantley County, GA","County or equivalent",2003,15163,107,18,157,139,105,-7,112,-16
"15260",NA,13127,"Glynn County, GA","County or equivalent",2003,69845,842,281,1032,751,632,96,536,-71
"15260",NA,13191,"McIntosh County, GA","County or equivalent",2003,10934,16,42,147,105,-10,-1,-9,-16
"15380",NA,NA,"Buffalo-Niagara Falls, NY","Metropolitan Statistical Area",2003,1154569,-3929,686,13092,12406,-3106,1142,-4248,-1509
"15380",NA,36029,"Erie County, NY","County or equivalent",2003,937298,-3502,654,10672,10018,-2945,1030,-3975,-1211
"15380",NA,36063,"Niagara County, NY","County or equivalent",2003,217271,-427,32,2420,2388,-161,112,-273,-298
"15500",NA,NA,"Burlington, NC","Metropolitan Statistical Area",2003,136050,742,469,1827,1358,469,574,-105,-196
"15500",NA,37001,"Alamance County, NC","County or equivalent",2003,136050,742,469,1827,1358,469,574,-105,-196
"15540",NA,NA,"Burlington-South Burlington, VT","Metropolitan Statistical Area",2003,203351,823,884,2322,1438,196,370,-174,-257
"15540",NA,50007,"Chittenden County, VT","County or equivalent",2003,149183,368,639,1645,1006,-77,354,-431,-194
"15540",NA,50011,"Franklin County, VT","County or equivalent",2003,46783,314,216,597,381,159,17,142,-61
"15540",NA,50013,"Grand Isle County, VT","County or equivalent",2003,7385,141,29,80,51,114,-1,115,-2
"15940",NA,NA,"Canton-Massillon, OH","Metropolitan Statistical Area",2003,408317,510,631,4835,4204,-614,72,-686,493
"15940",NA,39019,"Carroll County, OH","County or equivalent",2003,29185,87,63,343,280,63,3,60,-39
"15940",NA,39151,"Stark County, OH","County or equivalent",2003,379132,423,568,4492,3924,-677,69,-746,532
"15980",NA,NA,"Cape Coral-Fort Myers, FL","Metropolitan Statistical Area",2003,490023,15983,140,5483,5343,15373,1610,13763,470
"15980",NA,12071,"Lee County, FL","County or equivalent",2003,490023,15983,140,5483,5343,15373,1610,13763,470
"16180",NA,NA,"Carson City, NV","Metropolitan Statistical Area",2003,54993,626,46,703,657,639,169,470,-59
"16180",NA,32510,"Carson City, NV","County or equivalent",2003,54993,626,46,703,657,639,169,470,-59
"16220",NA,NA,"Casper, WY","Metropolitan Statistical Area",2003,67939,586,317,903,586,346,26,320,-77
"16220",NA,56025,"Natrona County, WY","County or equivalent",2003,67939,586,317,903,586,346,26,320,-77
"16300",NA,NA,"Cedar Rapids, IA","Metropolitan Statistical Area",2003,243098,1065,1342,3284,1942,-156,237,-393,-121
"16300",NA,19011,"Benton County, IA","County or equivalent",2003,26174,186,58,310,252,135,3,132,-7
"16300",NA,19105,"Jones County, IA","County or equivalent",2003,20217,65,51,227,176,44,0,44,-30
"16300",NA,19113,"Linn County, IA","County or equivalent",2003,196707,814,1233,2747,1514,-335,234,-569,-84
"16580",NA,NA,"Champaign-Urbana, IL","Metropolitan Statistical Area",2003,215649,2296,1049,2576,1527,1527,856,671,-280
"16580",NA,17019,"Champaign County, IL","County or equivalent",2003,185323,2222,1074,2241,1167,1398,851,547,-250
"16580",NA,17053,"Ford County, IL","County or equivalent",2003,14041,-51,-46,155,201,12,4,8,-17
"16580",NA,17147,"Piatt County, IL","County or equivalent",2003,16285,125,21,180,159,117,1,116,-13
"16620",NA,NA,"Charleston, WV","Metropolitan Statistical Area",2003,306162,39,250,3804,3554,190,25,165,-401
"16620",NA,54005,"Boone County, WV","County or equivalent",2003,25551,28,46,342,296,19,5,14,-37
"16620",NA,54015,"Clay County, WV","County or equivalent",2003,10237,-56,46,149,103,-92,1,-93,-10
"16620",NA,54039,"Kanawha County, WV","County or equivalent",2003,195293,-732,-85,2354,2439,-370,25,-395,-277
"16620",NA,54043,"Lincoln County, WV","County or equivalent",2003,22318,124,61,311,250,94,1,93,-31
"16620",NA,54079,"Putnam County, WV","County or equivalent",2003,52763,675,182,648,466,539,-7,546,-46
"16700",NA,NA,"Charleston-North Charleston-Summerville, SC","Metropolitan Statistical Area",2003,576651,9916,3470,8051,4581,6200,-1094,7294,246
"16700",NA,45015,"Berkeley County, SC","County or equivalent",2003,148392,1920,1136,2099,963,870,-886,1756,-86
"16700",NA,45019,"Charleston County, SC","County or equivalent",2003,324900,5177,1792,4617,2825,3081,-135,3216,304
"16700",NA,45035,"Dorchester County, SC","County or equivalent",2003,103359,2819,542,1335,793,2249,-73,2322,28
"16740",NA,NA,"Charlotte-Gastonia-Concord, NC-SC","Metropolitan Statistical Area",2003,1435910,30039,11902,22350,10448,19108,5359,13749,-971
"16740",NA,37007,"Anson County, NC","County or equivalent",2003,25078,-197,63,355,292,-238,7,-245,-22
"16740",NA,37025,"Cabarrus County, NC","County or equivalent",2003,142525,3100,1021,2225,1204,2169,350,1819,-90
"16740",NA,37071,"Gaston County, NC","County or equivalent",2003,192206,-256,624,2548,1924,-660,462,-1122,-220
"16740",NA,37119,"Mecklenburg County, NC","County or equivalent",2003,754337,17373,7769,12474,4705,10278,3885,6393,-674
"16740",NA,37179,"Union County, NC","County or equivalent",2003,143935,5806,1475,2389,914,4257,479,3778,74
"16740",NA,45091,"York County, SC","County or equivalent",2003,177829,4213,950,2359,1409,3302,176,3126,-39
"16820",NA,NA,"Charlottesville, VA","Metropolitan Statistical Area",2003,182440,1913,859,2208,1349,470,440,30,584
"16820",NA,51003,"Albemarle County, VA","County or equivalent",2003,87277,957,412,986,574,654,288,366,-109
"16820",NA,51065,"Fluvanna County, VA","County or equivalent",2003,22956,887,142,308,166,719,0,719,26
"16820",NA,51079,"Greene County, VA","County or equivalent",2003,16673,384,151,265,114,241,5,236,-8
"16820",NA,51125,"Nelson County, VA","County or equivalent",2003,14804,124,-8,164,172,140,-5,145,-8
"16820",NA,51540,"Charlottesville city, VA","County or equivalent",2003,40730,-439,162,485,323,-1284,152,-1436,683
"16860",NA,NA,"Chattanooga, TN-GA","Metropolitan Statistical Area",2003,492059,4524,1202,6024,4822,1524,450,1074,1798
"16860",NA,13047,"Catoosa County, GA","County or equivalent",2003,57608,1539,267,736,469,1255,21,1234,17
"16860",NA,13083,"Dade County, GA","County or equivalent",2003,15720,130,25,171,146,119,6,113,-14
"16860",NA,13295,"Walker County, GA","County or equivalent",2003,62196,222,67,762,695,229,22,207,-74
"16860",NA,47065,"Hamilton County, TN","County or equivalent",2003,316559,2240,779,3878,3099,-440,390,-830,1901
"16860",NA,47115,"Marion County, TN","County or equivalent",2003,27944,123,0,320,320,149,3,146,-26
"16860",NA,47153,"Sequatchie County, TN","County or equivalent",2003,12032,270,64,157,93,212,8,204,-6
"16940",NA,NA,"Cheyenne, WY","Metropolitan Statistical Area",2003,84289,1154,554,1192,638,638,-450,1088,-38
"16940",NA,56021,"Laramie County, WY","County or equivalent",2003,84289,1154,554,1192,638,638,-450,1088,-38
"16980",NA,NA,"Chicago-Naperville-Joliet, IL-IN-WI","Metropolitan Statistical Area",2003,9299001,46868,70874,140929,70055,-26229,46195,-72424,2223
"16980",16974,NA,"Chicago-Naperville-Joliet, IL","Metropolitan Division",2003,7784730,37227,60512,119058,58546,-26625,44816,-71441,3340
"16980",16974,17031,"Cook County, IL","County or equivalent",2003,5339646,-20979,37727,81852,44125,-61552,35509,-97061,2846
"16980",16974,17037,"DeKalb County, IL","County or equivalent",2003,94741,2346,569,1140,571,1775,263,1512,2
"16980",16974,17043,"DuPage County, IL","County or equivalent",2003,921657,2110,7248,13002,5754,-4761,4737,-9498,-377
"16980",16974,17063,"Grundy County, IL","County or equivalent",2003,39417,795,193,527,334,619,36,583,-17
"16980",16974,17089,"Kane County, IL","County or equivalent",2003,454661,14077,5602,8214,2612,7899,2594,5305,576
"16980",16974,17093,"Kendall County, IL","County or equivalent",2003,66836,5111,806,1122,316,3661,65,3596,644
"16980",16974,17111,"McHenry County, IL","County or equivalent",2003,287058,8776,2489,4116,1627,5669,660,5009,618
"16980",16974,17197,"Will County, IL","County or equivalent",2003,580714,24991,5878,9085,3207,20065,952,19113,-952
"16980",23844,NA,"Gary, IN","Metropolitan Division",2003,680987,2490,2893,9252,6359,461,651,-190,-864
"16980",23844,18073,"Jasper County, IN","County or equivalent",2003,30783,394,171,413,242,259,12,247,-36
"16980",23844,18089,"Lake County, IN","County or equivalent",2003,484405,469,2093,6903,4810,-977,511,-1488,-647
"16980",23844,18111,"Newton County, IN","County or equivalent",2003,14278,33,7,154,147,45,12,33,-19
"16980",23844,18127,"Porter County, IN","County or equivalent",2003,151521,1594,622,1782,1160,1134,116,1018,-162
"16980",29404,NA,"Lake County-Kenosha County, IL-WI","Metropolitan Division",2003,833284,7151,7469,12619,5150,-65,728,-793,-253
"16980",29404,17097,"Lake County, IL","County or equivalent",2003,677561,5258,6602,10438,3836,-1258,561,-1819,-86
"16980",29404,55059,"Kenosha County, WI","County or equivalent",2003,155723,1893,867,2181,1314,1193,167,1026,-167
"17020",NA,NA,"Chico, CA","Metropolitan Statistical Area",2003,211584,2285,144,2322,2178,2319,361,1958,-178
"17020",NA,6007,"Butte County, CA","County or equivalent",2003,211584,2285,144,2322,2178,2319,361,1958,-178
"17140",NA,NA,"Cincinnati-Middletown, OH-KY-IN","Metropolitan Statistical Area",2003,2065531,15902,11268,28808,17540,-1532,2125,-3657,6166
"17140",NA,18029,"Dearborn County, IN","County or equivalent",2003,47747,601,180,556,376,462,3,459,-41
"17140",NA,18047,"Franklin County, IN","County or equivalent",2003,22618,195,38,239,201,176,1,175,-19
"17140",NA,18115,"Ohio County, IN","County or equivalent",2003,5750,11,17,68,51,0,-1,1,-6
"17140",NA,21015,"Boone County, KY","County or equivalent",2003,96607,3318,904,1451,547,2407,161,2246,7
"17140",NA,21023,"Bracken County, KY","County or equivalent",2003,8440,-11,37,105,68,-36,1,-37,-12
"17140",NA,21037,"Campbell County, KY","County or equivalent",2003,87653,-658,234,1124,890,-824,48,-872,-68
"17140",NA,21077,"Gallatin County, KY","County or equivalent",2003,7992,158,31,111,80,130,-1,131,-3
"17140",NA,21081,"Grant County, KY","County or equivalent",2003,23895,376,178,364,186,218,8,210,-20
"17140",NA,21117,"Kenton County, KY","County or equivalent",2003,152345,652,1027,2320,1293,-157,98,-255,-218
"17140",NA,21191,"Pendleton County, KY","County or equivalent",2003,14846,124,74,174,100,68,6,62,-18
"17140",NA,39015,"Brown County, OH","County or equivalent",2003,43511,303,173,586,413,189,5,184,-59
"17140",NA,39017,"Butler County, OH","County or equivalent",2003,341667,2776,1925,4621,2696,1300,284,1016,-449
"17140",NA,39025,"Clermont County, OH","County or equivalent",2003,184590,2040,1398,2741,1343,878,97,781,-236
"17140",NA,39061,"Hamilton County, OH","County or equivalent",2003,847161,-959,3553,11722,8169,-11699,1293,-12992,7187
"17140",NA,39165,"Warren County, OH","County or equivalent",2003,180709,6976,1499,2626,1127,5356,122,5234,121
"17300",NA,NA,"Clarksville, TN-KY","Metropolitan Statistical Area",2003,241366,3293,2413,4125,1712,-315,-3337,3022,1195
"17300",NA,21047,"Christian County, KY","County or equivalent",2003,77160,1161,961,1539,578,-1031,-1549,518,1231
"17300",NA,21221,"Trigg County, KY","County or equivalent",2003,12734,39,-34,128,162,85,-19,104,-12
"17300",NA,47125,"Montgomery County, TN","County or equivalent",2003,138752,2053,1474,2300,826,592,-1742,2334,-13
"17300",NA,47161,"Stewart County, TN","County or equivalent",2003,12720,40,12,158,146,39,-27,66,-11
"17420",NA,NA,"Cleveland, TN","Metropolitan Statistical Area",2003,106017,478,347,1371,1024,277,100,177,-146
"17420",NA,47011,"Bradley County, TN","County or equivalent",2003,90044,519,359,1164,805,282,100,182,-122
"17420",NA,47139,"Polk County, TN","County or equivalent",2003,15973,-41,-12,207,219,-5,0,-5,-24
"17460",NA,NA,"Cleveland-Elyria-Mentor, OH","Metropolitan Statistical Area",2003,2134689,-4861,5428,26724,21296,-10647,3037,-13684,358
"17460",NA,39035,"Cuyahoga County, OH","County or equivalent",2003,1356396,-13242,2573,17337,14764,-14910,2392,-17302,-905
"17460",NA,39055,"Geauga County, OH","County or equivalent",2003,93454,1170,408,1085,677,854,22,832,-92
"17460",NA,39085,"Lake County, OH","County or equivalent",2003,231094,553,435,2596,2161,-727,362,-1089,845
"17460",NA,39093,"Lorain County, OH","County or equivalent",2003,292991,3793,1063,3639,2576,2107,175,1932,623
"17460",NA,39103,"Medina County, OH","County or equivalent",2003,160754,2865,949,2067,1118,2029,86,1943,-113
"17660",NA,NA,"Coeur d'Alene, ID","Metropolitan Statistical Area",2003,116952,2927,642,1515,873,2316,29,2287,-31
"17660",NA,16055,"Kootenai County, ID","County or equivalent",2003,116952,2927,642,1515,873,2316,29,2287,-31
"17780",NA,NA,"College Station-Bryan, TX","Metropolitan Statistical Area",2003,191970,2693,1601,2737,1136,1356,975,381,-264
"17780",NA,48041,"Brazos County, TX","County or equivalent",2003,159550,2633,1522,2310,788,1346,947,399,-235
"17780",NA,48051,"Burleson County, TX","County or equivalent",2003,16690,134,42,211,169,109,10,99,-17
"17780",NA,48395,"Robertson County, TX","County or equivalent",2003,15730,-74,37,216,179,-99,18,-117,-12
"17820",NA,NA,"Colorado Springs, CO","Metropolitan Statistical Area",2003,572531,6388,5362,8675,3313,469,-2332,2801,557
"17820",NA,8041,"El Paso County, CO","County or equivalent",2003,551252,6390,5223,8441,3218,580,-2327,2907,587
"17820",NA,8119,"Teller County, CO","County or equivalent",2003,21279,-2,139,234,95,-111,-5,-106,-30
"17860",NA,NA,"Columbia, MO","Metropolitan Statistical Area",2003,151413,1705,954,1930,976,933,356,577,-182
"17860",NA,29019,"Boone County, MO","County or equivalent",2003,141466,1761,975,1818,843,956,354,602,-170
"17860",NA,29089,"Howard County, MO","County or equivalent",2003,9947,-56,-21,112,133,-23,2,-25,-12
"17900",NA,NA,"Columbia, SC","Metropolitan Statistical Area",2003,672623,9519,3426,8913,5487,6496,-749,7245,-403
"17900",NA,45017,"Calhoun County, SC","County or equivalent",2003,15117,-22,15,183,168,-16,0,-16,-21
"17900",NA,45039,"Fairfield County, SC","County or equivalent",2003,23658,-96,15,295,280,-84,-1,-83,-27
"17900",NA,45055,"Kershaw County, SC","County or equivalent",2003,54191,740,252,708,456,524,-3,527,-36
"17900",NA,45063,"Lexington County, SC","County or equivalent",2003,225765,3649,1343,3131,1788,2514,249,2265,-208
"17900",NA,45079,"Richland County, SC","County or equivalent",2003,335055,5429,1775,4360,2585,3755,-1093,4848,-101
"17900",NA,45081,"Saluda County, SC","County or equivalent",2003,18837,-181,26,236,210,-197,99,-296,-10
"17980",NA,NA,"Columbus, GA-AL","Metropolitan Statistical Area",2003,281549,-4674,1474,4151,2677,-6102,-2174,-3928,-46
"17980",NA,1113,"Russell County, AL","County or equivalent",2003,48628,-513,71,601,530,-544,-16,-528,-40
"17980",NA,13053,"Chattahoochee County, GA","County or equivalent",2003,17439,-1748,198,240,42,-1995,-1005,-990,49
"17980",NA,13145,"Harris County, GA","County or equivalent",2003,25740,774,92,289,197,667,-10,677,15
"17980",NA,13197,"Marion County, GA","County or equivalent",2003,7021,-55,-11,82,93,-36,16,-52,-8
"17980",NA,13215,"Muscogee County, GA","County or equivalent",2003,182721,-3132,1124,2939,1815,-4194,-1159,-3035,-62
"18020",NA,NA,"Columbus, IN","Metropolitan Statistical Area",2003,71926,273,389,992,603,-27,188,-215,-89
"18020",NA,18005,"Bartholomew County, IN","County or equivalent",2003,71926,273,389,992,603,-27,188,-215,-89
"18140",NA,NA,"Columbus, OH","Metropolitan Statistical Area",2003,1677791,19124,12402,25067,12665,7065,3732,3333,-343
"18140",NA,39041,"Delaware County, OH","County or equivalent",2003,134874,7886,1504,2181,677,5210,51,5159,1172
"18140",NA,39045,"Fairfield County, OH","County or equivalent",2003,132006,3134,572,1603,1031,2555,2,2553,7
"18140",NA,39049,"Franklin County, OH","County or equivalent",2003,1091389,4707,8819,17125,8306,-2900,3619,-6519,-1212
"18140",NA,39089,"Licking County, OH","County or equivalent",2003,150194,1755,777,2075,1298,1113,29,1084,-135
"18140",NA,39097,"Madison County, OH","County or equivalent",2003,40592,231,164,516,352,126,24,102,-59
"18140",NA,39117,"Morrow County, OH","County or equivalent",2003,33373,506,156,414,258,371,2,369,-21
"18140",NA,39129,"Pickaway County, OH","County or equivalent",2003,51644,87,81,539,458,78,-3,81,-72
"18140",NA,39159,"Union County, OH","County or equivalent",2003,43719,818,329,614,285,512,8,504,-23
"18580",NA,NA,"Corpus Christi, TX","Metropolitan Statistical Area",2003,403579,653,2934,6224,3290,-1843,-458,-1385,-438
"18580",NA,48007,"Aransas County, TX","County or equivalent",2003,23371,371,-1,243,244,378,18,360,-6
"18580",NA,48355,"Nueces County, TX","County or equivalent",2003,313182,110,2418,4915,2497,-1962,-44,-1918,-346
"18580",NA,48409,"San Patricio County, TX","County or equivalent",2003,67026,172,517,1066,549,-259,-432,173,-86
"18700",NA,NA,"Corvallis, OR","Metropolitan Statistical Area",2003,79398,-187,252,771,519,-375,294,-669,-64
"18700",NA,41003,"Benton County, OR","County or equivalent",2003,79398,-187,252,771,519,-375,294,-669,-64
"19060",NA,NA,"Cumberland, MD-WV","Metropolitan Statistical Area",2003,100483,-369,-147,1008,1155,-96,8,-104,-126
"19060",NA,24001,"Allegany County, MD","County or equivalent",2003,73327,-410,-145,707,852,-173,4,-177,-92
"19060",NA,54057,"Mineral County, WV","County or equivalent",2003,27156,41,-2,301,303,77,4,73,-34
"19100",NA,NA,"Dallas-Fort Worth-Arlington, TX","Metropolitan Statistical Area",2003,5582699,105720,65177,97379,32202,35481,36784,-1303,5062
"19100",19124,NA,"Dallas-Plano-Irving, TX","Metropolitan Division",2003,3741534,69243,45613,66186,20573,16523,28821,-12298,7107
"19100",19124,48085,"Collin County, TX","County or equivalent",2003,596839,27849,7700,9801,2101,19206,2929,16277,943
"19100",19124,48113,"Dallas County, TX","County or equivalent",2003,2287406,6756,28913,42673,13760,-27296,23516,-50812,5139
"19100",19124,48119,"Delta County, TX","County or equivalent",2003,5390,-43,-11,66,77,-23,-1,-22,-9
"19100",19124,48121,"Denton County, TX","County or equivalent",2003,512081,22687,6533,8524,1991,15369,1624,13745,785
"19100",19124,48139,"Ellis County, TX","County or equivalent",2003,123704,4204,1134,1950,816,3059,330,2729,11
"19100",19124,48231,"Hunt County, TX","County or equivalent",2003,80190,405,383,1140,757,140,169,-29,-118
"19100",19124,48257,"Kaufman County, TX","County or equivalent",2003,81490,3746,465,1210,745,3106,166,2940,175
"19100",19124,48397,"Rockwall County, TX","County or equivalent",2003,54434,3639,496,822,326,2962,88,2874,181
"19100",23104,NA,"Fort Worth-Arlington, TX","Metropolitan Division",2003,1841165,36477,19564,31193,11629,18958,7963,10995,-2045
"19100",23104,48251,"Johnson County, TX","County or equivalent",2003,138218,3365,948,1996,1048,2462,213,2249,-45
"19100",23104,48367,"Parker County, TX","County or equivalent",2003,96713,2772,495,1234,739,2257,59,2198,20
"19100",23104,48439,"Tarrant County, TX","County or equivalent",2003,1552481,29036,17878,27277,9399,13170,7604,5566,-2012
"19100",23104,48497,"Wise County, TX","County or equivalent",2003,53753,1304,243,686,443,1069,87,982,-8
"19140",NA,NA,"Dalton, GA","Metropolitan Statistical Area",2003,126257,1469,1335,2356,1021,222,870,-648,-88
"19140",NA,13213,"Murray County, GA","County or equivalent",2003,39248,885,400,649,249,512,54,458,-27
"19140",NA,13313,"Whitfield County, GA","County or equivalent",2003,87009,584,935,1707,772,-290,816,-1106,-61
"19180",NA,NA,"Danville, IL","Metropolitan Statistical Area",2003,82386,-537,115,1081,966,-573,39,-612,-79
"19180",NA,17183,"Vermilion County, IL","County or equivalent",2003,82386,-537,115,1081,966,-573,39,-612,-79
"19260",NA,NA,"Danville, VA","Metropolitan Statistical Area",2003,108094,-524,-106,1239,1345,-277,67,-344,-141
"19260",NA,51143,"Pittsylvania County, VA","County or equivalent",2003,61172,-176,49,642,593,-133,34,-167,-92
"19260",NA,51590,"Danville city, VA","County or equivalent",2003,46922,-348,-155,597,752,-144,33,-177,-49
"19340",NA,NA,"Davenport-Moline-Rock Island, IA-IL","Metropolitan Statistical Area",2003,372847,-957,1340,4952,3612,-1965,438,-2403,-332
"19340",NA,17073,"Henry County, IL","County or equivalent",2003,50273,104,-1,547,548,166,17,149,-61
"19340",NA,17131,"Mercer County, IL","County or equivalent",2003,16760,-120,-9,195,204,-94,1,-95,-17
"19340",NA,17161,"Rock Island County, IL","County or equivalent",2003,147056,-1077,440,1951,1511,-1420,232,-1652,-97
"19340",NA,19163,"Scott County, IA","County or equivalent",2003,158758,136,910,2259,1349,-617,188,-805,-157
"19380",NA,NA,"Dayton, OH","Metropolitan Statistical Area",2003,845320,50,2809,10788,7979,-2409,-113,-2296,-350
"19380",NA,39057,"Greene County, OH","County or equivalent",2003,153182,1735,579,1793,1214,692,-154,846,464
"19380",NA,39109,"Miami County, OH","County or equivalent",2003,99519,317,318,1220,902,148,45,103,-149
"19380",NA,39113,"Montgomery County, OH","County or equivalent",2003,550411,-1899,1782,7272,5490,-3067,-11,-3056,-614
"19380",NA,39135,"Preble County, OH","County or equivalent",2003,42208,-103,130,503,373,-182,7,-189,-51
"19460",NA,NA,"Decatur, AL","Metropolitan Statistical Area",2003,146516,584,554,1899,1345,208,155,53,-178
"19460",NA,1079,"Lawrence County, AL","County or equivalent",2003,34391,-254,53,391,338,-273,8,-281,-34
"19460",NA,1103,"Morgan County, AL","County or equivalent",2003,112125,838,501,1508,1007,481,147,334,-144
"19500",NA,NA,"Decatur, IL","Metropolitan Statistical Area",2003,110683,-1315,268,1465,1197,-1531,28,-1559,-52
"19500",NA,17115,"Macon County, IL","County or equivalent",2003,110683,-1315,268,1465,1197,-1531,28,-1559,-52
"19660",NA,NA,"Deltona-Daytona Beach-Ormond Beach, FL","Metropolitan Statistical Area",2003,465818,7576,-1353,4671,6024,8935,672,8263,-6
"19660",NA,12127,"Volusia County, FL","County or equivalent",2003,465818,7576,-1353,4671,6024,8935,672,8263,-6
"19740",NA,NA,"Denver-Aurora, CO /1","Metropolitan Statistical Area",2003,2299309,22236,23488,37333,13845,-988,11551,-12539,-264
"19740",NA,8001,"Adams County, CO /1","County or equivalent",2003,379220,7234,4805,7096,2291,2961,2239,722,-532
"19740",NA,8005,"Arapahoe County, CO /1","County or equivalent",2003,514808,5039,5134,8028,2894,572,2159,-1587,-667
"19740",NA,8014,"Broomfield County, CO /1","County or equivalent",2003,45127,2582,453,639,186,1209,102,1107,920
"19740",NA,8019,"Clear Creek County, CO /1","County or equivalent",2003,9339,-156,44,91,47,-193,1,-194,-7
"19740",NA,8031,"Denver County, CO /1","County or equivalent",2003,559192,-2285,6169,10445,4276,-8590,5702,-14292,136
"19740",NA,8035,"Douglas County, CO /1","County or equivalent",2003,221921,11944,3462,3993,531,8228,313,7915,254
"19740",NA,8039,"Elbert County, CO /1","County or equivalent",2003,21961,175,128,217,89,78,3,75,-31
"19740",NA,8047,"Gilpin County, CO /1","County or equivalent",2003,4864,6,22,51,29,-8,0,-8,-8
"19740",NA,8059,"Jefferson County, CO /1","County or equivalent",2003,526633,-2628,3165,6601,3436,-5469,1024,-6493,-324
"19740",NA,8093,"Park County, CO /1","County or equivalent",2003,16244,325,106,172,66,224,8,216,-5
"19780",NA,NA,"Des Moines-West Des Moines, IA","Metropolitan Statistical Area",2003,504364,7320,3970,7694,3724,3228,1227,2001,122
"19780",NA,19049,"Dallas County, IA","County or equivalent",2003,46317,1986,290,594,304,1544,56,1488,152
"19780",NA,19077,"Guthrie County, IA","County or equivalent",2003,11319,98,-1,146,147,105,1,104,-6
"19780",NA,19121,"Madison County, IA","County or equivalent",2003,14457,140,58,196,138,98,-4,102,-16
"19780",NA,19153,"Polk County, IA","County or equivalent",2003,390308,4429,3470,6265,2795,941,1169,-228,18
"19780",NA,19181,"Warren County, IA","County or equivalent",2003,41963,667,153,493,340,540,5,535,-26
"19820",NA,NA,"Detroit-Warren-Livonia, MI","Metropolitan Statistical Area",2003,4492463,7510,20372,59672,39300,-19083,11449,-30532,6221
"19820",19804,NA,"Detroit-Livonia-Dearborn, MI","Metropolitan Division",2003,2044832,-7564,9215,29001,19786,-24951,5279,-30230,8172
"19820",19804,26163,"Wayne County, MI","County or equivalent",2003,2044832,-7564,9215,29001,19786,-24951,5279,-30230,8172
"19820",47644,NA,"Warren-Troy-Farmington Hills, MI","Metropolitan Division",2003,2447631,15074,11157,30671,19514,5868,6170,-302,-1951
"19820",47644,26087,"Lapeer County, MI","County or equivalent",2003,90859,582,355,1020,665,354,32,322,-127
"19820",47644,26093,"Livingston County, MI","County or equivalent",2003,171644,3542,1006,1952,946,2637,133,2504,-101
"19820",47644,26099,"Macomb County, MI","County or equivalent",2003,813733,6560,2759,10153,7394,4007,1640,2367,-206
"19820",47644,26125,"Oakland County, MI","County or equivalent",2003,1203036,2752,6420,15441,9021,-2338,4304,-6642,-1330
"19820",47644,26147,"St. Clair County, MI","County or equivalent",2003,168359,1638,617,2105,1488,1208,61,1147,-187
"20020",NA,NA,"Dothan, AL","Metropolitan Statistical Area",2003,132958,1348,446,1791,1345,1025,34,991,-123
"20020",NA,1061,"Geneva County, AL","County or equivalent",2003,25478,23,2,284,282,53,0,53,-32
"20020",NA,1067,"Henry County, AL","County or equivalent",2003,16370,42,-3,211,214,66,8,58,-21
"20020",NA,1069,"Houston County, AL","County or equivalent",2003,91110,1283,447,1296,849,906,26,880,-70
"20100",NA,NA,"Dover, DE","Metropolitan Statistical Area",2003,134173,2899,837,1989,1152,2085,-386,2471,-23
"20100",NA,10001,"Kent County, DE","County or equivalent",2003,134173,2899,837,1989,1152,2085,-386,2471,-23
"20220",NA,NA,"Dubuque, IA","Metropolitan Statistical Area",2003,90109,904,446,1240,794,490,85,405,-32
"20220",NA,19061,"Dubuque County, IA","County or equivalent",2003,90109,904,446,1240,794,490,85,405,-32
"20260",NA,NA,"Duluth, MN-WI","Metropolitan Statistical Area",2003,275578,-198,-125,2911,3036,271,49,222,-344
"20260",NA,27017,"Carlton County, MN","County or equivalent",2003,32905,448,72,397,325,394,1,393,-18
"20260",NA,27137,"St. Louis County, MN","County or equivalent",2003,198858,-833,-228,2022,2250,-328,31,-359,-277
"20260",NA,55031,"Douglas County, WI","County or equivalent",2003,43815,187,31,492,461,205,17,188,-49
"20500",NA,NA,"Durham, NC","Metropolitan Statistical Area",2003,446209,4426,3048,6314,3266,1840,2741,-901,-462
"20500",NA,37037,"Chatham County, NC","County or equivalent",2003,55561,1360,225,712,487,1157,321,836,-22
"20500",NA,37063,"Durham County, NC","County or equivalent",2003,236632,2301,2144,3847,1703,420,1769,-1349,-263
"20500",NA,37135,"Orange County, NC","County or equivalent",2003,117492,619,643,1332,689,113,640,-527,-137
"20500",NA,37145,"Person County, NC","County or equivalent",2003,36524,146,36,423,387,150,11,139,-40
"20740",NA,NA,"Eau Claire, WI","Metropolitan Statistical Area",2003,151713,860,518,1780,1262,514,61,453,-172
"20740",NA,55017,"Chippewa County, WI","County or equivalent",2003,56761,667,117,688,571,587,9,578,-37
"20740",NA,55035,"Eau Claire County, WI","County or equivalent",2003,94952,193,401,1092,691,-73,52,-125,-135
"20940",NA,NA,"El Centro, CA","Metropolitan Statistical Area",2003,147359,2730,1888,2814,926,1057,940,117,-215
"20940",NA,6025,"Imperial County, CA","County or equivalent",2003,147359,2730,1888,2814,926,1057,940,117,-215
"21060",NA,NA,"Elizabethtown, KY","Metropolitan Statistical Area",2003,108545,104,867,1680,813,-632,-855,223,-131
"21060",NA,21093,"Hardin County, KY","County or equivalent",2003,95271,251,865,1524,659,-495,-856,361,-119
"21060",NA,21123,"Larue County, KY","County or equivalent",2003,13274,-147,2,156,154,-137,1,-138,-12
"21140",NA,NA,"Elkhart-Goshen, IN","Metropolitan Statistical Area",2003,187655,2642,1727,3088,1361,1181,769,412,-266
"21140",NA,18039,"Elkhart County, IN","County or equivalent",2003,187655,2642,1727,3088,1361,1181,769,412,-266
"21300",NA,NA,"Elmira, NY","Metropolitan Statistical Area",2003,89822,-586,112,1058,946,-612,34,-646,-86
"21300",NA,36015,"Chemung County, NY","County or equivalent",2003,89822,-586,112,1058,946,-612,34,-646,-86
"21340",NA,NA,"El Paso, TX","Metropolitan Statistical Area",2003,695376,6163,9959,14119,4160,-3077,2513,-5590,-719
"21340",NA,48141,"El Paso County, TX","County or equivalent",2003,695376,6163,9959,14119,4160,-3077,2513,-5590,-719
"21500",NA,NA,"Erie, PA","Metropolitan Statistical Area",2003,282098,251,665,3359,2694,-1119,330,-1449,705
"21500",NA,42049,"Erie County, PA","County or equivalent",2003,282098,251,665,3359,2694,-1119,330,-1449,705
"21660",NA,NA,"Eugene-Springfield, OR","Metropolitan Statistical Area",2003,330504,3102,761,3576,2815,2712,610,2102,-371
"21660",NA,41039,"Lane County, OR","County or equivalent",2003,330504,3102,761,3576,2815,2712,610,2102,-371
"21780",NA,NA,"Evansville, IN-KY","Metropolitan Statistical Area",2003,345324,1578,997,4409,3412,994,174,820,-413
"21780",NA,18051,"Gibson County, IN","County or equivalent",2003,32739,155,92,414,322,101,11,90,-38
"21780",NA,18129,"Posey County, IN","County or equivalent",2003,26735,-183,39,248,209,-197,7,-204,-25
"21780",NA,18163,"Vanderburgh County, IN","County or equivalent",2003,172839,666,498,2330,1832,413,106,307,-245
"21780",NA,18173,"Warrick County, IN","County or equivalent",2003,54157,1009,166,633,467,874,10,864,-31
"21780",NA,21101,"Henderson County, KY","County or equivalent",2003,44952,15,192,594,402,-115,18,-133,-62
"21780",NA,21233,"Webster County, KY","County or equivalent",2003,13902,-84,10,190,180,-82,22,-104,-12
"21820",NA,NA,"Fairbanks, AK","Metropolitan Statistical Area",2003,89294,1882,1249,1578,329,-396,-1002,606,1029
"21820",NA,2090,"Fairbanks North Star Borough, AK","County or equivalent",2003,89294,1882,1249,1578,329,-396,-1002,606,1029
"22020",NA,NA,"Fargo, ND-MN","Metropolitan Statistical Area",2003,179341,1896,1081,2328,1247,1024,276,748,-209
"22020",NA,27027,"Clay County, MN","County or equivalent",2003,51715,230,218,619,401,85,24,61,-73
"22020",NA,38017,"Cass County, ND","County or equivalent",2003,127626,1666,863,1709,846,939,252,687,-136
"22140",NA,NA,"Farmington, NM","Metropolitan Statistical Area",2003,119742,1486,1124,1948,824,511,108,403,-149
"22140",NA,35045,"San Juan County, NM","County or equivalent",2003,119742,1486,1124,1948,824,511,108,403,-149
"22180",NA,NA,"Fayetteville, NC","Metropolitan Statistical Area",2003,346821,4512,3773,6046,2273,683,-6168,6851,56
"22180",NA,37051,"Cumberland County, NC","County or equivalent",2003,310223,3622,3359,5378,2019,202,-6033,6235,61
"22180",NA,37093,"Hoke County, NC","County or equivalent",2003,36598,890,414,668,254,481,-135,616,-5
"22220",NA,NA,"Fayetteville-Springdale-Rogers, AR-MO","Metropolitan Statistical Area",2003,379008,11482,3191,6024,2833,8056,1273,6783,235
"22220",NA,5007,"Benton County, AR","County or equivalent",2003,171429,6608,1326,2644,1318,5104,430,4674,178
"22220",NA,5087,"Madison County, AR","County or equivalent",2003,14273,62,9,164,155,73,9,64,-20
"22220",NA,5143,"Washington County, AR","County or equivalent",2003,171292,4465,1686,2857,1171,2683,769,1914,96
"22220",NA,29119,"McDonald County, MO","County or equivalent",2003,22014,347,170,359,189,196,65,131,-19
"22380",NA,NA,"Flagstaff, AZ","Metropolitan Statistical Area",2003,121460,1127,1324,1903,579,-5,174,-179,-192
"22380",NA,4005,"Coconino County, AZ","County or equivalent",2003,121460,1127,1324,1903,579,-5,174,-179,-192
"22420",NA,NA,"Flint, MI","Metropolitan Statistical Area",2003,439448,763,2367,6260,3893,-970,147,-1117,-634
"22420",NA,26049,"Genesee County, MI","County or equivalent",2003,439448,763,2367,6260,3893,-970,147,-1117,-634
"22500",NA,NA,"Florence, SC","Metropolitan Statistical Area",2003,195539,856,776,2772,1996,333,70,263,-253
"22500",NA,45031,"Darlington County, SC","County or equivalent",2003,67555,-142,136,881,745,-179,21,-200,-99
"22500",NA,45041,"Florence County, SC","County or equivalent",2003,127984,998,640,1891,1251,512,49,463,-154
"22520",NA,NA,"Florence-Muscle Shoals, AL","Metropolitan Statistical Area",2003,141236,-207,28,1557,1529,-37,40,-77,-198
"22520",NA,1033,"Colbert County, AL","County or equivalent",2003,54306,-280,-41,605,646,-165,5,-170,-74
"22520",NA,1077,"Lauderdale County, AL","County or equivalent",2003,86930,73,69,952,883,128,35,93,-124
"22540",NA,NA,"Fond du Lac, WI","Metropolitan Statistical Area",2003,97956,175,286,1140,854,29,87,-58,-140
"22540",NA,55039,"Fond du Lac County, WI","County or equivalent",2003,97956,175,286,1140,854,29,87,-58,-140
"22660",NA,NA,"Fort Collins-Loveland, CO","Metropolitan Statistical Area",2003,268667,3035,1829,3363,1534,1567,535,1032,-361
"22660",NA,8069,"Larimer County, CO","County or equivalent",2003,268667,3035,1829,3363,1534,1567,535,1032,-361
"22900",NA,NA,"Fort Smith, AR-OK","Metropolitan Statistical Area",2003,278306,1261,1287,4078,2791,297,427,-130,-323
"22900",NA,5033,"Crawford County, AR","County or equivalent",2003,55314,616,249,746,497,423,17,406,-56
"22900",NA,5047,"Franklin County, AR","County or equivalent",2003,17859,28,13,222,209,37,7,30,-22
"22900",NA,5131,"Sebastian County, AR","County or equivalent",2003,117076,301,740,1832,1092,-306,325,-631,-133
"22900",NA,40079,"Le Flore County, OK","County or equivalent",2003,48402,78,153,727,574,-10,74,-84,-65
"22900",NA,40135,"Sequoyah County, OK","County or equivalent",2003,39655,238,132,551,419,153,4,149,-47
"23020",NA,NA,"Fort Walton Beach-Crestview-Destin, FL","Metropolitan Statistical Area",2003,178518,2686,1150,2503,1353,1514,-1824,3338,22
"23020",NA,12091,"Okaloosa County, FL","County or equivalent",2003,178518,2686,1150,2503,1353,1514,-1824,3338,22
"23060",NA,NA,"Fort Wayne, IN","Metropolitan Statistical Area",2003,398274,2428,2822,5954,3132,148,666,-518,-542
"23060",NA,18003,"Allen County, IN","County or equivalent",2003,338973,2117,2597,5190,2593,-15,657,-672,-465
"23060",NA,18179,"Wells County, IN","County or equivalent",2003,27760,38,115,356,241,-38,-1,-37,-39
"23060",NA,18183,"Whitley County, IN","County or equivalent",2003,31541,273,110,408,298,201,10,191,-38
"23420",NA,NA,"Fresno, CA","Metropolitan Statistical Area",2003,846210,16481,9512,15176,5664,7985,4228,3757,-1016
"23420",NA,6019,"Fresno County, CA","County or equivalent",2003,846210,16481,9512,15176,5664,7985,4228,3757,-1016
"23460",NA,NA,"Gadsden, AL","Metropolitan Statistical Area",2003,102597,-152,-115,1215,1330,109,68,41,-146
"23460",NA,1055,"Etowah County, AL","County or equivalent",2003,102597,-152,-115,1215,1330,109,68,41,-146
"23540",NA,NA,"Gainesville, FL","Metropolitan Statistical Area",2003,241054,2329,902,2620,1718,1736,706,1030,-309
"23540",NA,12001,"Alachua County, FL","County or equivalent",2003,225601,1755,869,2436,1567,1211,702,509,-325
"23540",NA,12041,"Gilchrist County, FL","County or equivalent",2003,15453,574,33,184,151,525,4,521,16
"23580",NA,NA,"Gainesville, GA","Metropolitan Statistical Area",2003,155687,4063,1865,2933,1068,2229,1478,751,-31
"23580",NA,13139,"Hall County, GA","County or equivalent",2003,155687,4063,1865,2933,1068,2229,1478,751,-31
"24020",NA,NA,"Glens Falls, NY","Metropolitan Statistical Area",2003,125872,872,63,1256,1193,927,25,902,-118
"24020",NA,36113,"Warren County, NY","County or equivalent",2003,64494,518,32,657,625,539,25,514,-53
"24020",NA,36115,"Washington County, NY","County or equivalent",2003,61378,354,31,599,568,388,0,388,-65
"24140",NA,NA,"Goldsboro, NC","Metropolitan Statistical Area",2003,112716,-24,621,1663,1042,-473,-387,-86,-172
"24140",NA,37191,"Wayne County, NC","County or equivalent",2003,112716,-24,621,1663,1042,-473,-387,-86,-172
"24220",NA,NA,"Grand Forks, ND-MN","Metropolitan Statistical Area",2003,96078,27,445,1240,795,-273,-270,-3,-145
"24220",NA,27119,"Polk County, MN","County or equivalent",2003,30751,-62,-33,363,396,16,0,16,-45
"24220",NA,38035,"Grand Forks County, ND","County or equivalent",2003,65327,89,478,877,399,-289,-270,-19,-100
"24300",NA,NA,"Grand Junction, CO","Metropolitan Statistical Area",2003,124523,2389,321,1555,1234,2117,106,2011,-49
"24300",NA,8077,"Mesa County, CO","County or equivalent",2003,124523,2389,321,1555,1234,2117,106,2011,-49
"24340",NA,NA,"Grand Rapids-Wyoming, MI","Metropolitan Statistical Area",2003,760249,4278,6010,11327,5317,-851,1932,-2783,-881
"24340",NA,26015,"Barry County, MI","County or equivalent",2003,58298,439,222,694,472,284,4,280,-67
"24340",NA,26067,"Ionia County, MI","County or equivalent",2003,63230,310,361,825,464,44,11,33,-95
"24340",NA,26081,"Kent County, MI","County or equivalent",2003,589695,3207,5262,9195,3933,-1401,1892,-3293,-654
"24340",NA,26123,"Newaygo County, MI","County or equivalent",2003,49026,322,165,613,448,222,25,197,-65
"24500",NA,NA,"Great Falls, MT","Metropolitan Statistical Area",2003,81059,469,363,1124,761,-233,-460,227,339
"24500",NA,30013,"Cascade County, MT","County or equivalent",2003,81059,469,363,1124,761,-233,-460,227,339
"24540",NA,NA,"Greeley, CO /1","Metropolitan Statistical Area",2003,210836,7176,2417,3640,1223,4758,776,3982,1
"24540",NA,8123,"Weld County, CO /1","County or equivalent",2003,210836,7176,2417,3640,1223,4758,776,3982,1
"24580",NA,NA,"Green Bay, WI","Metropolitan Statistical Area",2003,290930,2221,1862,3899,2037,767,419,348,-408
"24580",NA,55009,"Brown County, WI","County or equivalent",2003,233950,1948,1743,3304,1561,566,412,154,-361
"24580",NA,55061,"Kewaunee County, WI","County or equivalent",2003,20288,-80,70,235,165,-130,6,-136,-20
"24580",NA,55083,"Oconto County, WI","County or equivalent",2003,36692,353,49,360,311,331,1,330,-27
"24660",NA,NA,"Greensboro-High Point, NC","Metropolitan Statistical Area",2003,660771,4269,3209,8815,5606,2030,2462,-432,-970
"24660",NA,37081,"Guilford County, NC","County or equivalent",2003,434385,3439,2466,5899,3433,1627,1740,-113,-654
"24660",NA,37151,"Randolph County, NC","County or equivalent",2003,134200,1039,685,1812,1127,556,551,5,-202
"24660",NA,37157,"Rockingham County, NC","County or equivalent",2003,92186,-209,58,1104,1046,-153,171,-324,-114
"24780",NA,NA,"Greenville, NC","Metropolitan Statistical Area",2003,159010,1958,971,2239,1268,1165,317,848,-178
"24780",NA,37079,"Greene County, NC","County or equivalent",2003,19587,232,27,241,214,219,73,146,-14
"24780",NA,37147,"Pitt County, NC","County or equivalent",2003,139423,1726,944,1998,1054,946,244,702,-164
"24860",NA,NA,"Greenville-Mauldin-Easley, SC","Metropolitan Statistical Area",2003,576337,4474,2472,7510,5038,2755,1363,1392,-753
"24860",NA,45045,"Greenville County, SC","County or equivalent",2003,394511,3900,2098,5429,3331,2317,1100,1217,-515
"24860",NA,45059,"Laurens County, SC","County or equivalent",2003,69587,-112,95,846,751,-114,71,-185,-93
"24860",NA,45077,"Pickens County, SC","County or equivalent",2003,112239,686,279,1235,956,552,192,360,-145
"25060",NA,NA,"Gulfport-Biloxi, MS","Metropolitan Statistical Area",2003,249907,161,1275,3635,2360,-777,-1132,355,-337
"25060",NA,28045,"Hancock County, MS","County or equivalent",2003,44835,400,113,521,408,330,-9,339,-43
"25060",NA,28047,"Harrison County, MS","County or equivalent",2003,190933,-362,1118,2918,1800,-1200,-1119,-81,-280
"25060",NA,28131,"Stone County, MS","County or equivalent",2003,14139,123,44,196,152,93,-4,97,-14
"25180",NA,NA,"Hagerstown-Martinsburg, MD-WV","Metropolitan Statistical Area",2003,236556,5688,788,2982,2194,4887,37,4850,13
"25180",NA,24043,"Washington County, MD","County or equivalent",2003,136331,1781,313,1661,1348,1558,36,1522,-90
"25180",NA,54003,"Berkeley County, WV","County or equivalent",2003,84808,3722,496,1170,674,3116,-5,3121,110
"25180",NA,54065,"Morgan County, WV","County or equivalent",2003,15417,185,-21,151,172,213,6,207,-7
"25260",NA,NA,"Hanford-Corcoran, CA","Metropolitan Statistical Area",2003,138879,4098,1550,2334,784,2551,-63,2614,-3
"25260",NA,6031,"Kings County, CA","County or equivalent",2003,138879,4098,1550,2334,784,2551,-63,2614,-3
"25420",NA,NA,"Harrisburg-Carlisle, PA","Metropolitan Statistical Area",2003,515759,2357,965,5804,4839,2008,474,1534,-616
"25420",NA,42041,"Cumberland County, PA","County or equivalent",2003,219050,1869,151,2201,2050,1918,122,1796,-200
"25420",NA,42043,"Dauphin County, PA","County or equivalent",2003,252654,236,689,3079,2390,-91,354,-445,-362
"25420",NA,42099,"Perry County, PA","County or equivalent",2003,44055,252,125,524,399,181,-2,183,-54
"25500",NA,NA,"Harrisonburg, VA","Metropolitan Statistical Area",2003,111503,387,530,1349,819,-83,336,-419,-60
"25500",NA,51165,"Rockingham County, VA","County or equivalent",2003,69477,451,236,837,601,255,104,151,-40
"25500",NA,51660,"Harrisonburg city, VA","County or equivalent",2003,42026,-64,294,512,218,-338,232,-570,-20
"25540",NA,NA,"Hartford-West Hartford-East Hartford, CT","Metropolitan Statistical Area",2003,1173571,7987,3339,13713,10374,6214,3156,3058,-1566
"25540",NA,9003,"Hartford County, CT","County or equivalent",2003,868490,3947,2332,10407,8075,2923,2750,173,-1308
"25540",NA,9007,"Middlesex County, CT","County or equivalent",2003,160707,1566,459,1823,1364,1279,205,1074,-172
"25540",NA,9013,"Tolland County, CT","County or equivalent",2003,144374,2474,548,1483,935,2012,201,1811,-86
"25620",NA,NA,"Hattiesburg, MS","Metropolitan Statistical Area",2003,128052,1398,765,1893,1128,777,6,771,-144
"25620",NA,28035,"Forrest County, MS","County or equivalent",2003,74240,730,380,1080,700,446,32,414,-96
"25620",NA,28073,"Lamar County, MS","County or equivalent",2003,41609,681,314,625,311,399,-24,423,-32
"25620",NA,28111,"Perry County, MS","County or equivalent",2003,12203,-13,71,188,117,-68,-2,-66,-16
"25860",NA,NA,"Hickory-Lenoir-Morganton, NC","Metropolitan Statistical Area",2003,348816,706,1198,4348,3150,-108,813,-921,-384
"25860",NA,37003,"Alexander County, NC","County or equivalent",2003,34574,205,89,362,273,159,29,130,-43
"25860",NA,37023,"Burke County, NC","County or equivalent",2003,88892,-146,197,1015,818,-235,178,-413,-108
"25860",NA,37027,"Caldwell County, NC","County or equivalent",2003,78595,65,169,918,749,-59,74,-133,-45
"25860",NA,37035,"Catawba County, NC","County or equivalent",2003,146755,582,743,2053,1310,27,532,-505,-188
"25980",NA,NA,"Hinesville-Fort Stewart, GA","Metropolitan Statistical Area",2003,71130,-961,1215,1539,324,-2083,-1859,-224,-93
"25980",NA,13179,"Liberty County, GA","County or equivalent",2003,60662,-863,1119,1385,266,-1897,-1796,-101,-85
"25980",NA,13183,"Long County, GA","County or equivalent",2003,10468,-98,96,154,58,-186,-63,-123,-8
"26100",NA,NA,"Holland-Grand Haven, MI","Metropolitan Statistical Area",2003,249129,2890,1941,3431,1490,1277,301,976,-328
"26100",NA,26139,"Ottawa County, MI","County or equivalent",2003,249129,2890,1941,3431,1490,1277,301,976,-328
"26180",NA,NA,"Honolulu, HI","Metropolitan Statistical Area",2003,887576,5298,7054,13088,6034,-634,-2930,2296,-1122
"26180",NA,15003,"Honolulu County, HI","County or equivalent",2003,887576,5298,7054,13088,6034,-634,-2930,2296,-1122
"26300",NA,NA,"Hot Springs, AR","Metropolitan Statistical Area",2003,91161,1037,-204,1086,1290,1265,45,1220,-24
"26300",NA,5051,"Garland County, AR","County or equivalent",2003,91161,1037,-204,1086,1290,1265,45,1220,-24
"26380",NA,NA,"Houma-Bayou Cane-Thibodaux, LA","Metropolitan Statistical Area",2003,196378,814,1404,2974,1570,-332,77,-409,-258
"26380",NA,22057,"Lafourche Parish, LA","County or equivalent",2003,91221,569,521,1271,750,182,39,143,-134
"26380",NA,22109,"Terrebonne Parish, LA","County or equivalent",2003,105157,245,883,1703,820,-514,38,-552,-124
"26420",NA,NA,"Houston-Sugar Land-Baytown, TX","Metropolitan Statistical Area",2003,5086012,106073,58168,88281,30113,36562,33667,2895,11343
"26420",NA,48015,"Austin County, TX","County or equivalent",2003,25019,448,73,359,286,399,51,348,-24
"26420",NA,48039,"Brazoria County, TX","County or equivalent",2003,261149,5852,2641,4358,1717,3400,620,2780,-189
"26420",NA,48071,"Chambers County, TX","County or equivalent",2003,27207,250,164,358,194,120,46,74,-34
"26420",NA,48157,"Fort Bend County, TX","County or equivalent",2003,416407,19710,4302,5900,1598,14481,1648,12833,927
"26420",NA,48167,"Galveston County, TX","County or equivalent",2003,265208,5068,1692,3994,2302,3561,659,2902,-185
"26420",NA,48201,"Harris County, TX","County or equivalent",2003,3616850,57872,45625,66282,20657,1841,29396,-27555,10406
"26420",NA,48291,"Liberty County, TX","County or equivalent",2003,73744,463,409,1102,693,168,95,73,-114
"26420",NA,48339,"Montgomery County, TX","County or equivalent",2003,341974,15074,2934,5127,2193,11569,1043,10526,571
"26420",NA,48407,"San Jacinto County, TX","County or equivalent",2003,23700,550,39,261,222,509,18,491,2
"26420",NA,48473,"Waller County, TX","County or equivalent",2003,34754,786,289,540,251,514,91,423,-17
"26580",NA,NA,"Huntington-Ashland, WV-KY-OH","Metropolitan Statistical Area",2003,286062,118,-9,3356,3365,489,48,441,-362
"26580",NA,21019,"Boyd County, KY","County or equivalent",2003,49381,38,17,591,574,86,1,85,-65
"26580",NA,21089,"Greenup County, KY","County or equivalent",2003,36936,151,28,420,392,167,-3,170,-44
"26580",NA,39087,"Lawrence County, OH","County or equivalent",2003,62177,311,26,749,723,348,10,338,-63
"26580",NA,54011,"Cabell County, WV","County or equivalent",2003,95231,-316,-93,1128,1221,-93,33,-126,-130
"26580",NA,54099,"Wayne County, WV","County or equivalent",2003,42337,-66,13,468,455,-19,7,-26,-60
"26620",NA,NA,"Huntsville, AL","Metropolitan Statistical Area",2003,357984,5141,1541,4395,2854,3554,283,3271,46
"26620",NA,1083,"Limestone County, AL","County or equivalent",2003,67653,574,167,792,625,473,27,446,-66
"26620",NA,1089,"Madison County, AL","County or equivalent",2003,290331,4567,1374,3603,2229,3081,256,2825,112
"26820",NA,NA,"Idaho Falls, ID","Metropolitan Statistical Area",2003,106216,1916,1203,1947,744,827,119,708,-114
"26820",NA,16019,"Bonneville County, ID","County or equivalent",2003,86210,1573,960,1578,618,704,88,616,-91
"26820",NA,16051,"Jefferson County, ID","County or equivalent",2003,20006,343,243,369,126,123,31,92,-23
"26900",NA,NA,"Indianapolis-Carmel, IN","Metropolitan Statistical Area",2003,1599068,21579,12316,24654,12338,8529,2503,6026,734
"26900",NA,18011,"Boone County, IN","County or equivalent",2003,49139,985,230,671,441,778,10,768,-23
"26900",NA,18013,"Brown County, IN","County or equivalent",2003,15135,-46,24,146,122,-47,2,-49,-23
"26900",NA,18057,"Hamilton County, IN","County or equivalent",2003,219631,11898,2569,3519,950,7818,241,7577,1511
"26900",NA,18059,"Hancock County, IN","County or equivalent",2003,59220,1242,379,816,437,892,2,890,-29
"26900",NA,18063,"Hendricks County, IN","County or equivalent",2003,118332,3705,670,1433,763,2988,53,2935,47
"26900",NA,18081,"Johnson County, IN","County or equivalent",2003,123968,2114,661,1633,972,1291,69,1222,162
"26900",NA,18097,"Marion County, IN","County or equivalent",2003,865171,819,7180,14568,7388,-5578,2047,-7625,-783
"26900",NA,18109,"Morgan County, IN","County or equivalent",2003,68421,643,311,890,579,403,7,396,-71
"26900",NA,18133,"Putnam County, IN","County or equivalent",2003,36648,455,91,406,315,390,13,377,-26
"26900",NA,18145,"Shelby County, IN","County or equivalent",2003,43403,-236,201,572,371,-406,59,-465,-31
"26980",NA,NA,"Iowa City, IA","Metropolitan Statistical Area",2003,138468,1941,1010,1788,778,810,464,346,121
"26980",NA,19103,"Johnson County, IA","County or equivalent",2003,117460,1926,948,1491,543,826,454,372,152
"26980",NA,19183,"Washington County, IA","County or equivalent",2003,21008,15,62,297,235,-16,10,-26,-31
"27060",NA,NA,"Ithaca, NY","Metropolitan Statistical Area",2003,99272,854,306,891,585,701,608,93,-153
"27060",NA,36109,"Tompkins County, NY","County or equivalent",2003,99272,854,306,891,585,701,608,93,-153
"27100",NA,NA,"Jackson, MI","Metropolitan Statistical Area",2003,161839,1037,550,2070,1520,692,73,619,-205
"27100",NA,26075,"Jackson County, MI","County or equivalent",2003,161839,1037,550,2070,1520,692,73,619,-205
"27140",NA,NA,"Jackson, MS","Metropolitan Statistical Area",2003,508985,4621,3229,7761,4532,1823,117,1706,-431
"27140",NA,28029,"Copiah County, MS","County or equivalent",2003,28957,255,132,395,263,158,-23,181,-35
"27140",NA,28049,"Hinds County, MS","County or equivalent",2003,248429,-219,1759,3872,2113,-1683,57,-1740,-295
"27140",NA,28089,"Madison County, MS","County or equivalent",2003,79765,1784,257,1244,987,1583,32,1551,-56
"27140",NA,28121,"Rankin County, MS","County or equivalent",2003,124341,3027,991,1841,850,2056,45,2011,-20
"27140",NA,28127,"Simpson County, MS","County or equivalent",2003,27493,-226,90,409,319,-291,6,-297,-25
"27180",NA,NA,"Jackson, TN","Metropolitan Statistical Area",2003,109201,-94,440,1510,1070,-412,125,-537,-122
"27180",NA,47023,"Chester County, TN","County or equivalent",2003,15532,-306,28,190,162,-337,2,-339,3
"27180",NA,47113,"Madison County, TN","County or equivalent",2003,93669,212,412,1320,908,-75,123,-198,-125
"27260",NA,NA,"Jacksonville, FL","Metropolitan Statistical Area",2003,1194253,21760,6168,16688,10520,16106,-1437,17543,-514
"27260",NA,12003,"Baker County, FL","County or equivalent",2003,23311,143,163,345,182,15,-6,21,-35
"27260",NA,12019,"Clay County, FL","County or equivalent",2003,155254,4676,848,1996,1148,3770,-288,4058,58
"27260",NA,12031,"Duval County, FL","County or equivalent",2003,811975,9488,4763,12202,7439,5468,-1170,6638,-743
"27260",NA,12089,"Nassau County, FL","County or equivalent",2003,61506,1052,135,684,549,943,-8,951,-26
"27260",NA,12109,"St. Johns County, FL","County or equivalent",2003,142207,6401,259,1461,1202,5910,35,5875,232
"27340",NA,NA,"Jacksonville, NC","Metropolitan Statistical Area",2003,156039,2759,2418,3168,750,92,-5607,5699,249
"27340",NA,37133,"Onslow County, NC","County or equivalent",2003,156039,2759,2418,3168,750,92,-5607,5699,249
"27500",NA,NA,"Janesville, WI","Metropolitan Statistical Area",2003,153989,467,748,2041,1293,-73,239,-312,-208
"27500",NA,55105,"Rock County, WI","County or equivalent",2003,153989,467,748,2041,1293,-73,239,-312,-208
"27620",NA,NA,"Jefferson City, MO","Metropolitan Statistical Area",2003,142642,703,697,1830,1133,190,72,118,-184
"27620",NA,29027,"Callaway County, MO","County or equivalent",2003,41931,-38,171,489,318,-160,14,-174,-49
"27620",NA,29051,"Cole County, MO","County or equivalent",2003,72534,512,374,926,552,236,57,179,-98
"27620",NA,29135,"Moniteau County, MO","County or equivalent",2003,14952,43,71,207,136,-4,2,-6,-24
"27620",NA,29151,"Osage County, MO","County or equivalent",2003,13225,186,81,208,127,118,-1,119,-13
"27740",NA,NA,"Johnson City, TN","Metropolitan Statistical Area",2003,186068,2364,24,2078,2054,2435,95,2340,-95
"27740",NA,47019,"Carter County, TN","County or equivalent",2003,58239,1423,-66,585,651,1455,18,1437,34
"27740",NA,47171,"Unicoi County, TN","County or equivalent",2003,17686,75,-81,167,248,170,-2,172,-14
"27740",NA,47179,"Washington County, TN","County or equivalent",2003,110143,866,171,1326,1155,810,79,731,-115
"27780",NA,NA,"Johnstown, PA","Metropolitan Statistical Area",2003,148710,-1123,-471,1439,1910,-456,25,-481,-196
"27780",NA,42021,"Cambria County, PA","County or equivalent",2003,148710,-1123,-471,1439,1910,-456,25,-481,-196
"27860",NA,NA,"Jonesboro, AR","Metropolitan Statistical Area",2003,110139,932,430,1519,1089,632,113,519,-130
"27860",NA,5031,"Craighead County, AR","County or equivalent",2003,84940,970,395,1183,788,671,101,570,-96
"27860",NA,5111,"Poinsett County, AR","County or equivalent",2003,25199,-38,35,336,301,-39,12,-51,-34
"27900",NA,NA,"Joplin, MO","Metropolitan Statistical Area",2003,161885,1807,756,2398,1642,1219,149,1070,-168
"27900",NA,29097,"Jasper County, MO","County or equivalent",2003,108121,1098,563,1669,1106,663,126,537,-128
"27900",NA,29145,"Newton County, MO","County or equivalent",2003,53764,709,193,729,536,556,23,533,-40
"28020",NA,NA,"Kalamazoo-Portage, MI","Metropolitan Statistical Area",2003,321001,2041,1402,4082,2680,1082,499,583,-443
"28020",NA,26077,"Kalamazoo County, MI","County or equivalent",2003,243382,1673,1144,3102,1958,875,451,424,-346
"28020",NA,26159,"Van Buren County, MI","County or equivalent",2003,77619,368,258,980,722,207,48,159,-97
"28100",NA,NA,"Kankakee-Bradley, IL","Metropolitan Statistical Area",2003,106068,672,481,1538,1057,300,119,181,-109
"28100",NA,17091,"Kankakee County, IL","County or equivalent",2003,106068,672,481,1538,1057,300,119,181,-109
"28140",NA,NA,"Kansas City, MO-KS","Metropolitan Statistical Area",2003,1902540,16629,13791,28983,15192,3275,3079,196,-437
"28140",NA,20059,"Franklin County, KS","County or equivalent",2003,25704,211,140,378,238,-5,13,-18,76
"28140",NA,20091,"Johnson County, KS","County or equivalent",2003,486160,10405,4615,7432,2817,6168,1114,5054,-378
"28140",NA,20103,"Leavenworth County, KS","County or equivalent",2003,71195,446,435,967,532,88,-372,460,-77
"28140",NA,20107,"Linn County, KS","County or equivalent",2003,9677,5,-1,94,95,18,-1,19,-12
"28140",NA,20121,"Miami County, KS","County or equivalent",2003,28934,192,161,403,242,69,2,67,-38
"28140",NA,20209,"Wyandotte County, KS","County or equivalent",2003,155913,-1380,1375,2902,1527,-2755,856,-3611,0
"28140",NA,29013,"Bates County, MO","County or equivalent",2003,17006,55,13,220,207,62,5,57,-20
"28140",NA,29025,"Caldwell County, MO","County or equivalent",2003,9083,83,16,117,101,73,-1,74,-6
"28140",NA,29037,"Cass County, MO","County or equivalent",2003,88194,1427,496,1224,728,998,-17,1015,-67
"28140",NA,29047,"Clay County, MO","County or equivalent",2003,193625,2435,1453,2918,1465,1206,205,1001,-224
"28140",NA,29049,"Clinton County, MO","County or equivalent",2003,20118,534,23,262,239,513,-2,515,-2
"28140",NA,29095,"Jackson County, MO","County or equivalent",2003,661156,576,4331,10249,5918,-4204,1195,-5399,449
"28140",NA,29107,"Lafayette County, MO","County or equivalent",2003,32884,19,55,444,389,11,-4,15,-47
"28140",NA,29165,"Platte County, MO","County or equivalent",2003,79278,1489,614,1079,465,938,90,848,-63
"28140",NA,29177,"Ray County, MO","County or equivalent",2003,23613,132,65,294,229,95,-4,99,-28
"28420",NA,NA,"Kennewick-Pasco-Richland, WA","Metropolitan Statistical Area",2003,208582,6108,2164,3434,1270,4031,962,3069,-87
"28420",NA,53005,"Benton County, WA","County or equivalent",2003,152513,2842,1161,2148,987,1820,439,1381,-139
"28420",NA,53021,"Franklin County, WA","County or equivalent",2003,56069,3266,1003,1286,283,2211,523,1688,52
"28660",NA,NA,"Killeen-Temple-Fort Hood, TX","Metropolitan Statistical Area",2003,346384,6431,4604,6778,2174,1254,-6062,7316,573
"28660",NA,48027,"Bell County, TX","County or equivalent",2003,253842,5884,3965,5613,1648,1393,-3718,5111,526
"28660",NA,48099,"Coryell County, TX","County or equivalent",2003,73538,218,582,917,335,-411,-2304,1893,47
"28660",NA,48281,"Lampasas County, TX","County or equivalent",2003,19004,329,57,248,191,272,-40,312,0
"28700",NA,NA,"Kingsport-Bristol-Bristol, TN-VA","Metropolitan Statistical Area",2003,298925,507,-350,3147,3497,1225,90,1135,-368
"28700",NA,47073,"Hawkins County, TN","County or equivalent",2003,55000,495,86,650,564,471,4,467,-62
"28700",NA,47163,"Sullivan County, TN","County or equivalent",2003,152377,-215,-250,1582,1832,243,69,174,-208
"28700",NA,51169,"Scott County, VA","County or equivalent",2003,22825,-140,-63,222,285,-43,4,-47,-34
"28700",NA,51191,"Washington County, VA","County or equivalent",2003,51294,35,-26,527,553,127,9,118,-66
"28700",NA,51520,"Bristol city, VA","County or equivalent",2003,17429,332,-97,166,263,427,4,423,2
"28740",NA,NA,"Kingston, NY","Metropolitan Statistical Area",2003,180282,522,223,1785,1562,532,155,377,-233
"28740",NA,36111,"Ulster County, NY","County or equivalent",2003,180282,522,223,1785,1562,532,155,377,-233
"28940",NA,NA,"Knoxville, TN","Metropolitan Statistical Area",2003,640981,8282,1454,7689,6235,5703,509,5194,1125
"28940",NA,47001,"Anderson County, TN","County or equivalent",2003,71365,25,-8,804,812,134,75,59,-101
"28940",NA,47009,"Blount County, TN","County or equivalent",2003,111073,1574,81,1294,1213,1558,42,1516,-65
"28940",NA,47093,"Knox County, TN","County or equivalent",2003,398571,5848,1285,4864,3579,3238,363,2875,1325
"28940",NA,47105,"Loudon County, TN","County or equivalent",2003,41389,657,8,478,470,667,31,636,-18
"28940",NA,47173,"Union County, TN","County or equivalent",2003,18583,178,88,249,161,106,-2,108,-16
"29020",NA,NA,"Kokomo, IN","Metropolitan Statistical Area",2003,100894,-142,386,1422,1036,-411,49,-460,-117
"29020",NA,18067,"Howard County, IN","County or equivalent",2003,84503,-84,303,1177,874,-287,46,-333,-100
"29020",NA,18159,"Tipton County, IN","County or equivalent",2003,16391,-58,83,245,162,-124,3,-127,-17
"29100",NA,NA,"La Crosse, WI-MN","Metropolitan Statistical Area",2003,128617,425,382,1459,1077,228,58,170,-185
"29100",NA,27055,"Houston County, MN","County or equivalent",2003,19772,-64,15,197,182,-53,3,-56,-26
"29100",NA,55063,"La Crosse County, WI","County or equivalent",2003,108845,489,367,1262,895,281,55,226,-159
"29140",NA,NA,"Lafayette, IN","Metropolitan Statistical Area",2003,181755,1094,1102,2283,1181,213,822,-609,-221
"29140",NA,18007,"Benton County, IN","County or equivalent",2003,9102,-30,34,115,81,-55,-1,-54,-9
"29140",NA,18015,"Carroll County, IN","County or equivalent",2003,20301,108,58,227,169,73,18,55,-23
"29140",NA,18157,"Tippecanoe County, IN","County or equivalent",2003,152352,1016,1010,1941,931,195,805,-610,-189
"29180",NA,NA,"Lafayette, LA","Metropolitan Statistical Area",2003,243395,1355,1743,3604,1861,-45,187,-232,-343
"29180",NA,22055,"Lafayette Parish, LA","County or equivalent",2003,193820,1120,1502,2928,1426,-107,183,-290,-275
"29180",NA,22099,"St. Martin Parish, LA","County or equivalent",2003,49575,235,241,676,435,62,4,58,-68
"29340",NA,NA,"Lake Charles, LA","Metropolitan Statistical Area",2003,193272,697,1071,2843,1772,-84,60,-144,-290
"29340",NA,22019,"Calcasieu Parish, LA","County or equivalent",2003,183590,748,1040,2749,1709,-14,52,-66,-278
"29340",NA,22023,"Cameron Parish, LA","County or equivalent",2003,9682,-51,31,94,63,-70,8,-78,-12
"29420",NA,NA,"Lake Havasu City-Kingman, AZ","Metropolitan Statistical Area",2003,170971,5820,-75,2174,2249,5762,262,5500,133
"29420",NA,4015,"Mohave County, AZ","County or equivalent",2003,170971,5820,-75,2174,2249,5762,262,5500,133
"29460",NA,NA,"Lakeland-Winter Haven, FL","Metropolitan Statistical Area",2003,507692,9542,1640,6919,5279,8076,1042,7034,-174
"29460",NA,12105,"Polk County, FL","County or equivalent",2003,507692,9542,1640,6919,5279,8076,1042,7034,-174
"29540",NA,NA,"Lancaster, PA","Metropolitan Statistical Area",2003,481595,3668,2393,6635,4242,1932,419,1513,-657
"29540",NA,42071,"Lancaster County, PA","County or equivalent",2003,481595,3668,2393,6635,4242,1932,419,1513,-657
"29620",NA,NA,"Lansing-East Lansing, MI","Metropolitan Statistical Area",2003,454468,1551,2559,5705,3146,-616,1065,-1681,-392
"29620",NA,26037,"Clinton County, MI","County or equivalent",2003,67408,922,327,811,484,646,6,640,-51
"29620",NA,26045,"Eaton County, MI","County or equivalent",2003,106511,1082,500,1251,751,707,59,648,-125
"29620",NA,26065,"Ingham County, MI","County or equivalent",2003,280549,-453,1732,3643,1911,-1969,1000,-2969,-216
"29700",NA,NA,"Laredo, TX","Metropolitan Statistical Area",2003,210312,5177,4957,5994,1037,479,1484,-1005,-259
"29700",NA,48479,"Webb County, TX","County or equivalent",2003,210312,5177,4957,5994,1037,479,1484,-1005,-259
"29740",NA,NA,"Las Cruces, NM","Metropolitan Statistical Area",2003,182264,3690,1995,3165,1170,1867,605,1262,-172
"29740",NA,35013,"Dona Ana County, NM","County or equivalent",2003,182264,3690,1995,3165,1170,1867,605,1262,-172
"29820",NA,NA,"Las Vegas-Paradise, NV","Metropolitan Statistical Area",2003,1570341,56213,12783,24218,11435,43090,7376,35714,340
"29820",NA,32003,"Clark County, NV","County or equivalent",2003,1570341,56213,12783,24218,11435,43090,7376,35714,340
"29940",NA,NA,"Lawrence, KS","Metropolitan Statistical Area",2003,106327,1855,721,1245,524,473,270,203,661
"29940",NA,20045,"Douglas County, KS","County or equivalent",2003,106327,1855,721,1245,524,473,270,203,661
"30020",NA,NA,"Lawton, OK","Metropolitan Statistical Area",2003,110467,-1526,1000,1870,870,-2383,-1965,-418,-143
"30020",NA,40031,"Comanche County, OK","County or equivalent",2003,110467,-1526,1000,1870,870,-2383,-1965,-418,-143
"30140",NA,NA,"Lebanon, PA","Metropolitan Statistical Area",2003,122437,1128,217,1493,1276,1023,77,946,-112
"30140",NA,42075,"Lebanon County, PA","County or equivalent",2003,122437,1128,217,1493,1276,1023,77,946,-112
"30300",NA,NA,"Lewiston, ID-WA","Metropolitan Statistical Area",2003,58199,558,57,697,640,550,12,538,-49
"30300",NA,16069,"Nez Perce County, ID","County or equivalent",2003,37692,568,5,431,426,585,15,570,-22
"30300",NA,53003,"Asotin County, WA","County or equivalent",2003,20507,-10,52,266,214,-35,-3,-32,-27
"30340",NA,NA,"Lewiston-Auburn, ME","Metropolitan Statistical Area",2003,105746,904,221,1275,1054,787,12,775,-104
"30340",NA,23001,"Androscoggin County, ME","County or equivalent",2003,105746,904,221,1275,1054,787,12,775,-104
"30460",NA,NA,"Lexington-Fayette, KY","Metropolitan Statistical Area",2003,422046,5352,2509,5745,3236,3323,1127,2196,-480
"30460",NA,21017,"Bourbon County, KY","County or equivalent",2003,19457,61,30,230,200,57,35,22,-26
"30460",NA,21049,"Clark County, KY","County or equivalent",2003,33809,299,85,436,351,250,12,238,-36
"30460",NA,21067,"Fayette County, KY","County or equivalent",2003,267363,3110,1721,3685,1964,1735,972,763,-346
"30460",NA,21113,"Jessamine County, KY","County or equivalent",2003,41335,711,228,533,305,518,25,493,-35
"30460",NA,21209,"Scott County, KY","County or equivalent",2003,36518,1031,297,532,235,740,33,707,-6
"30460",NA,21239,"Woodford County, KY","County or equivalent",2003,23564,140,148,329,181,23,50,-27,-31
"30620",NA,NA,"Lima, OH","Metropolitan Statistical Area",2003,106534,-1313,391,1480,1089,-1670,21,-1691,-34
"30620",NA,39003,"Allen County, OH","County or equivalent",2003,106534,-1313,391,1480,1089,-1670,21,-1691,-34
"30700",NA,NA,"Lincoln, NE","Metropolitan Statistical Area",2003,278571,3994,2264,4165,1901,2054,787,1267,-324
"30700",NA,31109,"Lancaster County, NE","County or equivalent",2003,262032,4048,2246,3977,1731,2105,786,1319,-303
"30700",NA,31159,"Seward County, NE","County or equivalent",2003,16539,-54,18,188,170,-51,1,-52,-21
"30780",NA,NA,"Little Rock-North Little Rock-Conway, AR","Metropolitan Statistical Area",2003,629352,6490,3689,9059,5370,2990,-199,3189,-189
"30780",NA,5045,"Faulkner County, AR","County or equivalent",2003,93241,2876,639,1298,659,2163,60,2103,74
"30780",NA,5053,"Grant County, AR","County or equivalent",2003,16747,89,1,165,164,105,-3,108,-17
"30780",NA,5085,"Lonoke County, AR","County or equivalent",2003,56198,1223,303,768,465,951,-88,1039,-31
"30780",NA,5105,"Perry County, AR","County or equivalent",2003,10297,-42,-4,111,115,-22,-1,-21,-16
"30780",NA,5119,"Pulaski County, AR","County or equivalent",2003,366153,1386,2499,5753,3254,-979,-182,-797,-134
"30780",NA,5125,"Saline County, AR","County or equivalent",2003,86716,958,251,964,713,772,15,757,-65
"30860",NA,NA,"Logan, UT-ID","Metropolitan Statistical Area",2003,111847,2923,1999,2528,529,-360,347,-707,1284
"30860",NA,16041,"Franklin County, ID","County or equivalent",2003,11677,15,99,190,91,-74,21,-95,-10
"30860",NA,49005,"Cache County, UT","County or equivalent",2003,100170,2908,1900,2338,438,-286,326,-612,1294
"30980",NA,NA,"Longview, TX","Metropolitan Statistical Area",2003,197312,1002,810,2893,2083,453,342,111,-261
"30980",NA,48183,"Gregg County, TX","County or equivalent",2003,113150,760,725,1852,1127,203,242,-39,-168
"30980",NA,48401,"Rusk County, TX","County or equivalent",2003,47259,-119,78,599,521,-142,88,-230,-55
"30980",NA,48459,"Upshur County, TX","County or equivalent",2003,36903,361,7,442,435,392,12,380,-38
"31020",NA,NA,"Longview, WA","Metropolitan Statistical Area",2003,94355,85,193,1152,959,25,107,-82,-133
"31020",NA,53015,"Cowlitz County, WA","County or equivalent",2003,94355,85,193,1152,959,25,107,-82,-133
"31100",NA,NA,"Los Angeles-Long Beach-Santa Ana, CA","Metropolitan Statistical Area",2003,12748533,93027,121266,197857,76591,-16831,103045,-119876,-11408
"31100",31084,NA,"Los Angeles-Long Beach-Glendale, CA","Metropolitan Division",2003,9801378,67699,92957,152601,59644,-16708,80682,-97390,-8550
"31100",31084,6037,"Los Angeles County, CA","County or equivalent",2003,9801378,67699,92957,152601,59644,-16708,80682,-97390,-8550
"31100",42044,NA,"Santa Ana-Anaheim-Irvine, CA","Metropolitan Division",2003,2947155,25328,28309,45256,16947,-123,22363,-22486,-2858
"31100",42044,6059,"Orange County, CA","County or equivalent",2003,2947155,25328,28309,45256,16947,-123,22363,-22486,-2858
"31140",NA,NA,"Louisville/Jefferson County, KY-IN","Metropolitan Statistical Area",2003,1188471,8931,4901,15866,10965,4771,1186,3585,-741
"31140",NA,18019,"Clark County, IN","County or equivalent",2003,99114,1286,304,1316,1012,1072,75,997,-90
"31140",NA,18043,"Floyd County, IN","County or equivalent",2003,71157,-243,128,819,691,-289,8,-297,-82
"31140",NA,18061,"Harrison County, IN","County or equivalent",2003,35384,341,114,426,312,269,11,258,-42
"31140",NA,18175,"Washington County, IN","County or equivalent",2003,27575,-7,93,344,251,-63,0,-63,-37
"31140",NA,21029,"Bullitt County, KY","County or equivalent",2003,66553,1741,436,820,384,728,-29,757,577
"31140",NA,21103,"Henry County, KY","County or equivalent",2003,15420,172,69,222,153,117,10,107,-14
"31140",NA,21111,"Jefferson County, KY","County or equivalent",2003,697783,1835,2667,9684,7017,163,1129,-966,-995
"31140",NA,21163,"Meade County, KY","County or equivalent",2003,27307,117,151,297,146,-7,-152,145,-27
"31140",NA,21179,"Nelson County, KY","County or equivalent",2003,39455,658,240,541,301,447,21,426,-29
"31140",NA,21185,"Oldham County, KY","County or equivalent",2003,50227,1276,292,566,274,992,17,975,-8
"31140",NA,21211,"Shelby County, KY","County or equivalent",2003,35743,941,268,546,278,688,95,593,-15
"31140",NA,21215,"Spencer County, KY","County or equivalent",2003,14115,721,105,182,77,587,0,587,29
"31140",NA,21223,"Trimble County, KY","County or equivalent",2003,8638,93,34,103,69,67,1,66,-8
"31180",NA,NA,"Lubbock, TX","Metropolitan Statistical Area",2003,259055,3378,2136,4153,2017,1318,236,1082,-76
"31180",NA,48107,"Crosby County, TX","County or equivalent",2003,6726,-134,40,105,65,-178,3,-181,4
"31180",NA,48303,"Lubbock County, TX","County or equivalent",2003,252329,3512,2096,4048,1952,1496,233,1263,-80
"31340",NA,NA,"Lynchburg, VA","Metropolitan Statistical Area",2003,231131,1699,323,2580,2257,1616,164,1452,-240
"31340",NA,51009,"Amherst County, VA","County or equivalent",2003,31762,3,5,312,307,42,15,27,-44
"31340",NA,51011,"Appomattox County, VA","County or equivalent",2003,13659,-8,3,142,139,9,9,0,-20
"31340",NA,51019,"Bedford County, VA","County or equivalent",2003,62040,684,133,620,487,591,24,567,-40
"31340",NA,51031,"Campbell County, VA","County or equivalent",2003,51400,-3,153,577,424,-78,13,-91,-78
"31340",NA,51515,"Bedford city, VA","County or equivalent",2003,6241,-46,-66,54,120,29,-4,33,-9
"31340",NA,51680,"Lynchburg city, VA","County or equivalent",2003,66029,1069,95,875,780,1023,107,916,-49
"31420",NA,NA,"Macon, GA","Metropolitan Statistical Area",2003,225682,1284,1079,3341,2262,392,107,285,-187
"31420",NA,13021,"Bibb County, GA","County or equivalent",2003,153868,-97,743,2412,1669,-669,95,-764,-171
"31420",NA,13079,"Crawford County, GA","County or equivalent",2003,12440,-8,77,170,93,-70,1,-71,-15
"31420",NA,13169,"Jones County, GA","County or equivalent",2003,25399,722,125,331,206,588,7,581,9
"31420",NA,13207,"Monroe County, GA","County or equivalent",2003,23196,612,108,306,198,503,9,494,1
"31420",NA,13289,"Twiggs County, GA","County or equivalent",2003,10779,55,26,122,96,40,-5,45,-11
"31460",NA,NA,"Madera, CA","Metropolitan Statistical Area",2003,132200,4251,1305,2229,924,2971,736,2235,-25
"31460",NA,6039,"Madera County, CA","County or equivalent",2003,132200,4251,1305,2229,924,2971,736,2235,-25
"31540",NA,NA,"Madison, WI","Metropolitan Statistical Area",2003,526246,6807,3167,6560,3393,4255,1531,2724,-615
"31540",NA,55021,"Columbia County, WI","County or equivalent",2003,53649,501,129,626,497,420,11,409,-48
"31540",NA,55025,"Dane County, WI","County or equivalent",2003,449459,6170,2932,5624,2692,3776,1521,2255,-538
"31540",NA,55049,"Iowa County, WI","County or equivalent",2003,23138,136,106,310,204,59,-1,60,-29
"31700",NA,NA,"Manchester-Nashua, NH","Metropolitan Statistical Area",2003,392641,1959,2256,4932,2676,255,1025,-770,-552
"31700",NA,33011,"Hillsborough County, NH","County or equivalent",2003,392641,1959,2256,4932,2676,255,1025,-770,-552
"31900",NA,NA,"Mansfield, OH","Metropolitan Statistical Area",2003,127817,-242,369,1562,1193,-449,21,-470,-162
"31900",NA,39139,"Richland County, OH","County or equivalent",2003,127817,-242,369,1562,1193,-449,21,-470,-162
"32580",NA,NA,"McAllen-Edinburg-Mission, TX","Metropolitan Statistical Area",2003,628043,20037,13064,16042,2978,7679,4253,3426,-706
"32580",NA,48215,"Hidalgo County, TX","County or equivalent",2003,628043,20037,13064,16042,2978,7679,4253,3426,-706
"32780",NA,NA,"Medford, OR","Metropolitan Statistical Area",2003,189533,2941,87,2104,2017,2954,218,2736,-100
"32780",NA,41029,"Jackson County, OR","County or equivalent",2003,189533,2941,87,2104,2017,2954,218,2736,-100
"32820",NA,NA,"Memphis, TN-MS-AR","Metropolitan Statistical Area",2003,1233260,9744,8408,19026,10618,2364,1308,1056,-1028
"32820",NA,5035,"Crittenden County, AR","County or equivalent",2003,50975,-171,356,874,518,-560,25,-585,33
"32820",NA,28033,"DeSoto County, MS","County or equivalent",2003,123803,5509,986,1823,837,4375,94,4281,148
"32820",NA,28093,"Marshall County, MS","County or equivalent",2003,35609,351,112,485,373,270,4,266,-31
"32820",NA,28137,"Tate County, MS","County or equivalent",2003,25726,225,159,407,248,96,-5,101,-30
"32820",NA,28143,"Tunica County, MS","County or equivalent",2003,9987,269,115,217,102,159,5,154,-5
"32820",NA,47047,"Fayette County, TN","County or equivalent",2003,32026,1007,126,408,282,856,5,851,25
"32820",NA,47157,"Shelby County, TN","County or equivalent",2003,901585,2056,6358,14148,7790,-3186,1214,-4400,-1116
"32820",NA,47167,"Tipton County, TN","County or equivalent",2003,53549,498,196,664,468,354,-34,388,-52
"32900",NA,NA,"Merced, CA","Metropolitan Statistical Area",2003,228763,5467,2740,4243,1503,2928,1142,1786,-201
"32900",NA,6047,"Merced County, CA","County or equivalent",2003,228763,5467,2740,4243,1503,2928,1142,1786,-201
"33100",NA,NA,"Miami-Fort Lauderdale-Pompano Beach, FL","Metropolitan Statistical Area",2003,5243747,55016,21029,69080,48051,32954,53088,-20134,1033
"33100",22744,NA,"Fort Lauderdale-Pompano Beach-Deerfield Beach, FL","Metropolitan Division",2003,1718271,19734,6248,22368,16120,14286,13081,1205,-800
"33100",22744,12011,"Broward County, FL","County or equivalent",2003,1718271,19734,6248,22368,16120,14286,13081,1205,-800
"33100",33124,NA,"Miami-Miami Beach-Kendall, FL","Metropolitan Division",2003,2320649,13578,14224,32470,18246,-3034,33422,-36456,2388
"33100",33124,12086,"Miami-Dade County, FL","County or equivalent",2003,2320649,13578,14224,32470,18246,-3034,33422,-36456,2388
"33100",48424,NA,"West Palm Beach-Boca Raton-Boynton Beach, FL","Metropolitan Division",2003,1204827,21704,557,14242,13685,21702,6585,15117,-555
"33100",48424,12099,"Palm Beach County, FL","County or equivalent",2003,1204827,21704,557,14242,13685,21702,6585,15117,-555
"33140",NA,NA,"Michigan City-La Porte, IN","Metropolitan Statistical Area",2003,108743,-681,259,1305,1046,-843,79,-922,-97
"33140",NA,18091,"LaPorte County, IN","County or equivalent",2003,108743,-681,259,1305,1046,-843,79,-922,-97
"33260",NA,NA,"Midland, TX","Metropolitan Statistical Area",2003,117941,1005,976,1856,880,200,155,45,-171
"33260",NA,48329,"Midland County, TX","County or equivalent",2003,117941,1005,976,1856,880,200,155,45,-171
"33340",NA,NA,"Milwaukee-Waukesha-West Allis, WI","Metropolitan Statistical Area",2003,1526411,7093,8157,21178,13021,-4974,2892,-7866,3910
"33340",NA,55079,"Milwaukee County, WI","County or equivalent",2003,949209,2502,5680,14437,8757,-7841,2499,-10340,4663
"33340",NA,55089,"Ozaukee County, WI","County or equivalent",2003,84164,611,268,867,599,458,60,398,-115
"33340",NA,55131,"Washington County, WI","County or equivalent",2003,121694,1177,624,1518,894,701,58,643,-148
"33340",NA,55133,"Waukesha County, WI","County or equivalent",2003,371344,2803,1585,4356,2771,1708,275,1433,-490
"33460",NA,NA,"Minneapolis-St. Paul-Bloomington, MN-WI","Metropolitan Statistical Area",2003,3077414,24794,26455,45251,18796,-105,9046,-9151,-1556
"33460",NA,27003,"Anoka County, MN","County or equivalent",2003,311970,3094,2835,4268,1433,721,351,370,-462
"33460",NA,27019,"Carver County, MN","County or equivalent",2003,78343,2690,863,1176,313,1828,117,1711,-1
"33460",NA,27025,"Chisago County, MN","County or equivalent",2003,46340,1612,373,707,334,1223,1,1222,16
"33460",NA,27037,"Dakota County, MN","County or equivalent",2003,371759,3731,3647,5416,1769,667,548,119,-583
"33460",NA,27053,"Hennepin County, MN","County or equivalent",2003,1122057,-969,8411,16272,7861,-8678,5693,-14371,-702
"33460",NA,27059,"Isanti County, MN","County or equivalent",2003,35232,1478,232,476,244,1209,7,1202,37
"33460",NA,27123,"Ramsey County, MN","County or equivalent",2003,505581,-4982,3715,7454,3739,-8723,1992,-10715,26
"33460",NA,27139,"Scott County, MN","County or equivalent",2003,107939,4779,1619,2016,397,3095,113,2982,65
"33460",NA,27141,"Sherburne County, MN","County or equivalent",2003,74915,2935,848,1234,386,1862,18,1844,225
"33460",NA,27163,"Washington County, MN","County or equivalent",2003,212285,3115,1924,2966,1042,1450,162,1288,-259
"33460",NA,27171,"Wright County, MN","County or equivalent",2003,102238,4162,1243,1813,570,2854,27,2827,65
"33460",NA,55093,"Pierce County, WI","County or equivalent",2003,37932,454,190,437,247,295,2,293,-31
"33460",NA,55109,"St. Croix County, WI","County or equivalent",2003,70823,2695,555,1016,461,2092,15,2077,48
"33540",NA,NA,"Missoula, MT","Metropolitan Statistical Area",2003,99854,929,399,1093,694,635,56,579,-105
"33540",NA,30063,"Missoula County, MT","County or equivalent",2003,99854,929,399,1093,694,635,56,579,-105
"33660",NA,NA,"Mobile, AL","Metropolitan Statistical Area",2003,397442,-786,1864,5752,3888,-2228,260,-2488,-422
"33660",NA,1097,"Mobile County, AL","County or equivalent",2003,397442,-786,1864,5752,3888,-2228,260,-2488,-422
"33700",NA,NA,"Modesto, CA","Metropolitan Statistical Area",2003,487104,9566,4348,8089,3741,5679,1879,3800,-461
"33700",NA,6099,"Stanislaus County, CA","County or equivalent",2003,487104,9566,4348,8089,3741,5679,1879,3800,-461
"33740",NA,NA,"Monroe, LA","Metropolitan Statistical Area",2003,170642,672,908,2525,1617,13,30,-17,-249
"33740",NA,22073,"Ouachita Parish, LA","County or equivalent",2003,147887,561,890,2221,1331,-105,19,-124,-224
"33740",NA,22111,"Union Parish, LA","County or equivalent",2003,22755,111,18,304,286,118,11,107,-25
"33780",NA,NA,"Monroe, MI","Metropolitan Statistical Area",2003,149649,1083,567,1718,1151,701,85,616,-185
"33780",NA,26115,"Monroe County, MI","County or equivalent",2003,149649,1083,567,1718,1151,701,85,616,-185
"33860",NA,NA,"Montgomery, AL","Metropolitan Statistical Area",2003,351657,1316,1767,4958,3191,-115,-409,294,-336
"33860",NA,1001,"Autauga County, AL","County or equivalent",2003,45766,606,212,613,401,427,-72,499,-33
"33860",NA,1051,"Elmore County, AL","County or equivalent",2003,70157,1331,306,925,619,1042,-76,1118,-17
"33860",NA,1085,"Lowndes County, AL","County or equivalent",2003,13319,-141,42,183,141,-174,-3,-171,-9
"33860",NA,1101,"Montgomery County, AL","County or equivalent",2003,222415,-480,1207,3237,2030,-1410,-258,-1152,-277
"34060",NA,NA,"Morgantown, WV","Metropolitan Statistical Area",2003,114069,1289,248,1228,980,1130,194,936,-89
"34060",NA,54061,"Monongalia County, WV","County or equivalent",2003,84621,1272,291,922,631,1036,195,841,-55
"34060",NA,54077,"Preston County, WV","County or equivalent",2003,29448,17,-43,306,349,94,-1,95,-34
"34100",NA,NA,"Morristown, TN","Metropolitan Statistical Area",2003,126720,1580,291,1623,1332,1402,329,1073,-113
"34100",NA,47057,"Grainger County, TN","County or equivalent",2003,21412,333,62,290,228,288,16,272,-17
"34100",NA,47063,"Hamblen County, TN","County or equivalent",2003,58622,285,192,826,634,183,268,-85,-90
"34100",NA,47089,"Jefferson County, TN","County or equivalent",2003,46686,962,37,507,470,931,45,886,-6
"34580",NA,NA,"Mount Vernon-Anacortes, WA","Metropolitan Statistical Area",2003,108205,2079,285,1325,1040,1845,261,1584,-51
"34580",NA,53057,"Skagit County, WA","County or equivalent",2003,108205,2079,285,1325,1040,1845,261,1584,-51
"34620",NA,NA,"Muncie, IN","Metropolitan Statistical Area",2003,118952,-403,98,1326,1228,-365,99,-464,-136
"34620",NA,18035,"Delaware County, IN","County or equivalent",2003,118952,-403,98,1326,1228,-365,99,-464,-136
"34740",NA,NA,"Muskegon-Norton Shores, MI","Metropolitan Statistical Area",2003,172479,676,737,2312,1575,195,90,105,-256
"34740",NA,26121,"Muskegon County, MI","County or equivalent",2003,172479,676,737,2312,1575,195,90,105,-256
"34820",NA,NA,"Myrtle Beach-North Myrtle Beach-Conway, SC","Metropolitan Statistical Area",2003,210840,4730,630,2608,1978,4115,361,3754,-15
"34820",NA,45051,"Horry County, SC","County or equivalent",2003,210840,4730,630,2608,1978,4115,361,3754,-15
"34900",NA,NA,"Napa, CA","Metropolitan Statistical Area",2003,129904,1265,364,1650,1286,1072,703,369,-171
"34900",NA,6055,"Napa County, CA","County or equivalent",2003,129904,1265,364,1650,1286,1072,703,369,-171
"34940",NA,NA,"Naples-Marco Island, FL","Metropolitan Statistical Area",2003,284354,9320,1241,3647,2406,7999,2077,5922,80
"34940",NA,12021,"Collier County, FL","County or equivalent",2003,284354,9320,1241,3647,2406,7999,2077,5922,80
"34980",NA,NA,"Nashville-Davidson--Murfreesboro--Franklin, TN","Metropolitan Statistical Area",2003,1386544,22713,8439,19547,11108,10421,3089,7332,3853
"34980",NA,47015,"Cannon County, TN","County or equivalent",2003,13016,50,5,151,146,60,4,56,-15
"34980",NA,47021,"Cheatham County, TN","County or equivalent",2003,37160,225,198,475,277,79,1,78,-52
"34980",NA,47037,"Davidson County, TN","County or equivalent",2003,588512,6166,3498,8716,5218,-1589,2315,-3904,4257
"34980",NA,47043,"Dickson County, TN","County or equivalent",2003,44828,498,203,649,446,333,-1,334,-38
"34980",NA,47081,"Hickman County, TN","County or equivalent",2003,23071,18,30,279,249,21,-2,23,-33
"34980",NA,47111,"Macon County, TN","County or equivalent",2003,20882,120,49,271,222,97,29,68,-26
"34980",NA,47147,"Robertson County, TN","County or equivalent",2003,57791,886,366,870,504,577,103,474,-57
"34980",NA,47149,"Rutherford County, TN","County or equivalent",2003,202458,6519,1880,3059,1179,4630,258,4372,9
"34980",NA,47159,"Smith County, TN","County or equivalent",2003,18204,114,6,214,208,126,6,120,-18
"34980",NA,47165,"Sumner County, TN","County or equivalent",2003,137910,1930,643,1777,1134,1399,132,1267,-112
"34980",NA,47169,"Trousdale County, TN","County or equivalent",2003,7257,-28,-12,78,90,-5,7,-12,-11
"34980",NA,47187,"Williamson County, TN","County or equivalent",2003,140661,4427,1077,1758,681,3343,204,3139,7
"34980",NA,47189,"Wilson County, TN","County or equivalent",2003,94794,1788,496,1250,754,1350,33,1317,-58
"35300",NA,NA,"New Haven-Milford, CT","Metropolitan Statistical Area",2003,837452,5081,2950,10429,7479,3345,2527,818,-1214
"35300",NA,9009,"New Haven County, CT","County or equivalent",2003,837452,5081,2950,10429,7479,3345,2527,818,-1214
"35380",NA,NA,"New Orleans-Metairie-Kenner, LA","Metropolitan Statistical Area",2003,1311300,421,6224,18668,12444,-5624,626,-6250,-179
"35380",NA,22051,"Jefferson Parish, LA","County or equivalent",2003,451144,-69,2071,6218,4147,-1991,519,-2510,-149
"35380",NA,22071,"Orleans Parish, LA","County or equivalent",2003,467515,-5041,1922,6945,5023,-7088,142,-7230,125
"35380",NA,22075,"Plaquemines Parish, LA","County or equivalent",2003,27652,529,182,415,233,355,-49,404,-8
"35380",NA,22087,"St. Bernard Parish, LA","County or equivalent",2003,65684,-571,53,854,801,-612,-12,-600,-12
"35380",NA,22089,"St. Charles Parish, LA","County or equivalent",2003,49037,78,309,670,361,-172,35,-207,-59
"35380",NA,22095,"St. John the Baptist Parish, LA","County or equivalent",2003,44435,495,360,685,325,191,18,173,-56
"35380",NA,22103,"St. Tammany Parish, LA","County or equivalent",2003,205833,5000,1327,2881,1554,3693,-27,3720,-20
"35620",NA,NA,"New York-Northern New Jersey-Long Island, NY-NJ-PA","Metropolitan Statistical Area",2003,18676263,82991,116964,260839,143875,-98020,138747,-236767,64047
"35620",20764,NA,"Edison-New Brunswick, NJ","Metropolitan Division",2003,2262910,22428,10856,30668,19812,10853,10794,59,719
"35620",20764,34023,"Middlesex County, NJ","County or equivalent",2003,771744,4954,5447,10890,5443,272,7015,-6743,-765
"35620",20764,34025,"Monmouth County, NJ","County or equivalent",2003,636050,5507,2649,7976,5327,1105,1371,-266,1753
"35620",20764,34029,"Ocean County, NJ","County or equivalent",2003,545526,8924,368,7264,6896,8420,504,7916,136
"35620",20764,34035,"Somerset County, NJ","County or equivalent",2003,309590,3043,2392,4538,2146,1056,1904,-848,-405
"35620",35004,NA,"Nassau-Suffolk, NY","Metropolitan Division",2003,2839842,22348,13370,36189,22819,-3448,7862,-11310,12426
"35620",35004,36059,"Nassau County, NY","County or equivalent",2003,1353586,3981,4986,16253,11267,-6665,4144,-10809,5660
"35620",35004,36103,"Suffolk County, NY","County or equivalent",2003,1486256,18367,8384,19936,11552,3217,3718,-501,6766
"35620",35084,NA,"Newark-Union, NJ-PA","Metropolitan Division",2003,2125329,5047,13021,29806,16785,-6331,12011,-18342,-1643
"35620",35084,34013,"Essex County, NJ","County or equivalent",2003,791203,-2077,5371,12183,6812,-6989,5413,-12402,-459
"35620",35084,34019,"Hunterdon County, NJ","County or equivalent",2003,127248,1104,622,1446,824,634,193,441,-152
"35620",35084,34027,"Morris County, NJ","County or equivalent",2003,479944,3252,2979,6329,3350,888,2355,-1467,-615
"35620",35084,34037,"Sussex County, NJ","County or equivalent",2003,149506,1615,701,1741,1040,1076,128,948,-162
"35620",35084,34039,"Union County, NJ","County or equivalent",2003,525726,-823,3311,7718,4407,-3800,3917,-7717,-334
"35620",35084,42103,"Pike County, PA","County or equivalent",2003,51702,1976,37,389,352,1860,5,1855,79
"35620",35644,NA,"New York-White Plains-Wayne, NY-NJ","Metropolitan Division",2003,11448182,33168,79717,164176,84459,-99094,108080,-207174,52545
"35620",35644,34003,"Bergen County, NJ","County or equivalent",2003,891317,860,3002,10564,7562,-1188,6289,-7477,-954
"35620",35644,34017,"Hudson County, NJ","County or equivalent",2003,604526,-4097,4246,8771,4525,-8464,7954,-16418,121
"35620",35644,34031,"Passaic County, NJ","County or equivalent",2003,493066,-471,3573,7716,4143,-3806,3863,-7669,-238
"35620",35644,36005,"Bronx County, NY","County or equivalent",2003,1354935,4821,12562,22459,9897,-13957,11239,-25196,6216
"35620",35644,36047,"Kings County, NY","County or equivalent",2003,2483164,5802,21398,39350,17952,-36184,25767,-61951,20588
"35620",35644,36061,"New York County, NY","County or equivalent",2003,1576621,11144,9095,20243,11148,-267,14434,-14701,2316
"35620",35644,36079,"Putnam County, NY","County or equivalent",2003,98740,553,560,1182,622,143,197,-54,-150
"35620",35644,36081,"Queens County, NY","County or equivalent",2003,2244238,4685,15011,30581,15570,-30044,29310,-59354,19718
"35620",35644,36085,"Richmond County, NY","County or equivalent",2003,466539,6406,2280,5861,3581,1774,1647,127,2352
"35620",35644,36087,"Rockland County, NY","County or equivalent",2003,290948,748,2460,4551,2091,-1668,1318,-2986,-44
"35620",35644,36119,"Westchester County, NY","County or equivalent",2003,944088,2717,5530,12898,7368,-5433,6062,-11495,2620
"35660",NA,NA,"Niles-Benton Harbor, MI","Metropolitan Statistical Area",2003,161352,-97,577,2128,1551,-493,291,-784,-181
"35660",NA,26021,"Berrien County, MI","County or equivalent",2003,161352,-97,577,2128,1551,-493,291,-784,-181
"35980",NA,NA,"Norwich-New London, CT","Metropolitan Statistical Area",2003,265149,2204,933,3197,2264,1507,-736,2243,-236
"35980",NA,9011,"New London County, CT","County or equivalent",2003,265149,2204,933,3197,2264,1507,-736,2243,-236
"36100",NA,NA,"Ocala, FL","Metropolitan Statistical Area",2003,279023,7835,-885,2874,3759,8490,289,8201,230
"36100",NA,12083,"Marion County, FL","County or equivalent",2003,279023,7835,-885,2874,3759,8490,289,8201,230
"36140",NA,NA,"Ocean City, NJ","Metropolitan Statistical Area",2003,101329,-86,-224,1019,1243,252,-52,304,-114
"36140",NA,34009,"Cape May County, NJ","County or equivalent",2003,101329,-86,-224,1019,1243,252,-52,304,-114
"36220",NA,NA,"Odessa, TX","Metropolitan Statistical Area",2003,122096,294,1235,2309,1074,-833,193,-1026,-108
"36220",NA,48135,"Ector County, TX","County or equivalent",2003,122096,294,1235,2309,1074,-833,193,-1026,-108
"36260",NA,NA,"Ogden-Clearfield, UT","Metropolitan Statistical Area",2003,471167,9409,6872,9417,2545,1662,144,1518,875
"36260",NA,49011,"Davis County, UT","County or equivalent",2003,256120,6355,4091,5290,1199,1908,-296,2204,356
"36260",NA,49029,"Morgan County, UT","County or equivalent",2003,7449,46,71,109,38,-14,-3,-11,-11
"36260",NA,49057,"Weber County, UT","County or equivalent",2003,207598,3008,2710,4018,1308,-232,443,-675,530
"36420",NA,NA,"Oklahoma City, OK","Metropolitan Statistical Area",2003,1131044,11203,7415,17161,9746,4998,1514,3484,-1210
"36420",NA,40017,"Canadian County, OK","County or equivalent",2003,92173,1510,550,1197,647,1030,47,983,-70
"36420",NA,40027,"Cleveland County, OK","County or equivalent",2003,219306,3720,1267,2592,1325,2583,131,2452,-130
"36420",NA,40051,"Grady County, OK","County or equivalent",2003,47093,462,119,590,471,380,-5,385,-37
"36420",NA,40081,"Lincoln County, OK","County or equivalent",2003,32073,-22,23,374,351,0,-4,4,-45
"36420",NA,40083,"Logan County, OK","County or equivalent",2003,35395,691,84,408,324,613,5,608,-6
"36420",NA,40087,"McClain County, OK","County or equivalent",2003,28556,554,119,377,258,445,18,427,-10
"36420",NA,40109,"Oklahoma County, OK","County or equivalent",2003,676448,4288,5253,11623,6370,-53,1322,-1375,-912
"36500",NA,NA,"Olympia, WA","Metropolitan Statistical Area",2003,219993,3444,941,2558,1617,2674,-22,2696,-171
"36500",NA,53067,"Thurston County, WA","County or equivalent",2003,219993,3444,941,2558,1617,2674,-22,2696,-171
"36540",NA,NA,"Omaha-Council Bluffs, NE-IA","Metropolitan Statistical Area",2003,790252,8094,6734,12759,6025,2314,572,1742,-954
"36540",NA,19085,"Harrison County, IA","County or equivalent",2003,15549,50,-3,188,191,72,2,70,-19
"36540",NA,19129,"Mills County, IA","County or equivalent",2003,14600,65,45,170,125,36,-1,37,-16
"36540",NA,19155,"Pottawattamie County, IA","County or equivalent",2003,88044,111,355,1223,868,-120,31,-151,-124
"36540",NA,31025,"Cass County, NE","County or equivalent",2003,25016,308,118,308,190,210,-18,228,-20
"36540",NA,31055,"Douglas County, NE","County or equivalent",2003,475799,4354,4406,8073,3667,641,1254,-613,-693
"36540",NA,31153,"Sarpy County, NE","County or equivalent",2003,131933,2900,1701,2327,626,1240,-714,1954,-41
"36540",NA,31155,"Saunders County, NE","County or equivalent",2003,19952,122,80,260,180,67,4,63,-25
"36540",NA,31177,"Washington County, NE","County or equivalent",2003,19359,184,32,210,178,168,14,154,-16
"36740",NA,NA,"Orlando-Kissimmee, FL","Metropolitan Statistical Area",2003,1801361,45889,10989,24729,13740,35537,8353,27184,-637
"36740",NA,12069,"Lake County, FL","County or equivalent",2003,245685,11286,-290,2738,3028,11285,299,10986,291
"36740",NA,12095,"Orange County, FL","County or equivalent",2003,964789,18559,7785,14373,6588,11737,5534,6203,-963
"36740",NA,12097,"Osceola County, FL","County or equivalent",2003,205434,11714,1534,2962,1428,9701,1403,8298,479
"36740",NA,12117,"Seminole County, FL","County or equivalent",2003,385453,4330,1960,4656,2696,2814,1117,1697,-444
"36780",NA,NA,"Oshkosh-Neenah, WI","Metropolitan Statistical Area",2003,158222,-150,502,1801,1299,-445,153,-598,-207
"36780",NA,55139,"Winnebago County, WI","County or equivalent",2003,158222,-150,502,1801,1299,-445,153,-598,-207
"36980",NA,NA,"Owensboro, KY","Metropolitan Statistical Area",2003,110279,328,460,1505,1045,16,32,-16,-148
"36980",NA,21059,"Daviess County, KY","County or equivalent",2003,92005,427,410,1276,866,148,21,127,-131
"36980",NA,21091,"Hancock County, KY","County or equivalent",2003,8438,1,32,109,77,-20,2,-22,-11
"36980",NA,21149,"McLean County, KY","County or equivalent",2003,9836,-100,18,120,102,-112,9,-121,-6
"37100",NA,NA,"Oxnard-Thousand Oaks-Ventura, CA","Metropolitan Statistical Area",2003,785220,7799,7043,11891,4848,1886,2768,-882,-1130
"37100",NA,6111,"Ventura County, CA","County or equivalent",2003,785220,7799,7043,11891,4848,1886,2768,-882,-1130
"37340",NA,NA,"Palm Bay-Melbourne-Titusville, FL","Metropolitan Statistical Area",2003,502995,8737,-567,4854,5421,9362,171,9191,-58
"37340",NA,12009,"Brevard County, FL","County or equivalent",2003,502995,8737,-567,4854,5421,9362,171,9191,-58
"37380",NA,NA,"Palm Coast, FL","Metropolitan Statistical Area",2003,62103,4702,-169,544,713,4640,56,4584,231
"37380",NA,12035,"Flagler County, FL","County or equivalent",2003,62103,4702,-169,544,713,4640,56,4584,231
"37460",NA,NA,"Panama City-Lynn Haven, FL","Metropolitan Statistical Area",2003,154642,2484,587,2059,1472,1929,-566,2495,-32
"37460",NA,12005,"Bay County, FL","County or equivalent",2003,154642,2484,587,2059,1472,1929,-566,2495,-32
"37620",NA,NA,"Parkersburg-Marietta-Vienna, WV-OH","Metropolitan Statistical Area",2003,162624,-689,-46,1796,1842,-445,11,-456,-198
"37620",NA,39167,"Washington County, OH","County or equivalent",2003,62411,-13,-6,687,693,80,1,79,-87
"37620",NA,54073,"Pleasants County, WV","County or equivalent",2003,7388,-122,-30,67,97,-88,2,-90,-4
"37620",NA,54105,"Wirt County, WV","County or equivalent",2003,5741,-57,-8,61,69,-42,1,-43,-7
"37620",NA,54107,"Wood County, WV","County or equivalent",2003,87084,-497,-2,981,983,-395,7,-402,-100
"37700",NA,NA,"Pascagoula, MS","Metropolitan Statistical Area",2003,152943,692,740,2166,1426,167,-310,477,-215
"37700",NA,28039,"George County, MS","County or equivalent",2003,20244,393,131,337,206,275,6,269,-13
"37700",NA,28059,"Jackson County, MS","County or equivalent",2003,132699,299,609,1829,1220,-108,-316,208,-202
"37860",NA,NA,"Pensacola-Ferry Pass-Brent, FL","Metropolitan Statistical Area",2003,433413,5711,1695,5531,3836,4211,-2033,6244,-195
"37860",NA,12033,"Escambia County, FL","County or equivalent",2003,300920,1252,1045,3946,2901,518,-1585,2103,-311
"37860",NA,12113,"Santa Rosa County, FL","County or equivalent",2003,132493,4459,650,1585,935,3693,-448,4141,116
"37900",NA,NA,"Peoria, IL","Metropolitan Statistical Area",2003,364743,-691,1159,4870,3711,-1488,195,-1683,-362
"37900",NA,17123,"Marshall County, IL","County or equivalent",2003,12907,-35,-19,165,184,1,-2,3,-17
"37900",NA,17143,"Peoria County, IL","County or equivalent",2003,181830,-569,839,2653,1814,-1237,177,-1414,-171
"37900",NA,17175,"Stark County, IL","County or equivalent",2003,6175,-81,-26,64,90,-49,-2,-47,-6
"37900",NA,17179,"Tazewell County, IL","County or equivalent",2003,127804,-330,274,1578,1304,-452,20,-472,-152
"37900",NA,17203,"Woodford County, IL","County or equivalent",2003,36027,324,91,410,319,249,2,247,-16
"37980",NA,NA,"Philadelphia-Camden-Wilmington, PA-NJ-DE-MD","Metropolitan Statistical Area",2003,5749056,19929,21350,75583,54233,3699,10738,-7039,-5120
"37980",15804,NA,"Camden, NJ","Metropolitan Division",2003,1220984,11773,4482,15417,10935,7423,822,6601,-132
"37980",15804,34005,"Burlington County, NJ","County or equivalent",2003,442523,6293,1675,5431,3756,4927,-236,5163,-309
"37980",15804,34007,"Camden County, NJ","County or equivalent",2003,510338,770,1988,6784,4796,-1219,929,-2148,1
"37980",15804,34015,"Gloucester County, NJ","County or equivalent",2003,268123,4710,819,3202,2383,3715,129,3586,176
"37980",37964,NA,"Philadelphia, PA","Metropolitan Division",2003,3858938,2365,13235,51078,37843,-6756,8557,-15313,-4114
"37980",37964,42017,"Bucks County, PA","County or equivalent",2003,610026,2651,1978,7016,5038,1589,727,862,-916
"37980",37964,42029,"Chester County, PA","County or equivalent",2003,455290,6932,2589,5925,3336,4742,806,3936,-399
"37980",37964,42045,"Delaware County, PA","County or equivalent",2003,552037,-328,1033,6792,5759,-624,1040,-1664,-737
"37980",37964,42091,"Montgomery County, PA","County or equivalent",2003,768226,5021,2638,9688,7050,3377,1198,2179,-994
"37980",37964,42101,"Philadelphia County, PA","County or equivalent",2003,1473359,-11911,4997,21657,16660,-15840,4786,-20626,-1068
"37980",48864,NA,"Wilmington, DE-MD-NJ","Metropolitan Division",2003,669134,5791,3633,9088,5455,3032,1359,1673,-874
"37980",48864,10003,"New Castle County, DE","County or equivalent",2003,512370,3597,3168,7206,4038,1208,1275,-67,-779
"37980",48864,24015,"Cecil County, MD","County or equivalent",2003,92367,2308,472,1175,703,1844,32,1812,-8
"37980",48864,34033,"Salem County, NJ","County or equivalent",2003,64397,-114,-7,707,714,-20,52,-72,-87
"38060",NA,NA,"Phoenix-Mesa-Scottsdale, AZ","Metropolitan Statistical Area",2003,3595488,100934,35879,60907,25028,65298,20625,44673,-243
"38060",NA,4013,"Maricopa County, AZ","County or equivalent",2003,3386847,90057,34744,58113,23369,57739,20163,37576,-2426
"38060",NA,4021,"Pinal County, AZ","County or equivalent",2003,208641,10877,1135,2794,1659,7559,462,7097,2183
"38220",NA,NA,"Pine Bluff, AR","Metropolitan Statistical Area",2003,105399,-587,248,1364,1116,-735,36,-771,-100
"38220",NA,5025,"Cleveland County, AR","County or equivalent",2003,8625,29,3,82,79,37,0,37,-11
"38220",NA,5069,"Jefferson County, AR","County or equivalent",2003,82424,-538,219,1136,917,-686,37,-723,-71
"38220",NA,5079,"Lincoln County, AR","County or equivalent",2003,14350,-78,26,146,120,-86,-1,-85,-18
"38300",NA,NA,"Pittsburgh, PA","Metropolitan Statistical Area",2003,2400215,-8732,-3002,25300,28302,-2847,1807,-4654,-2883
"38300",NA,42003,"Allegheny County, PA","County or equivalent",2003,1257299,-8170,-1400,13663,15063,-5350,1684,-7034,-1420
"38300",NA,42005,"Armstrong County, PA","County or equivalent",2003,71188,-279,-176,699,875,-4,-6,2,-99
"38300",NA,42007,"Beaver County, PA","County or equivalent",2003,177871,-728,-310,1801,2111,-175,20,-195,-243
"38300",NA,42019,"Butler County, PA","County or equivalent",2003,178617,1145,290,2041,1751,1079,57,1022,-224
"38300",NA,42051,"Fayette County, PA","County or equivalent",2003,145412,-786,-289,1510,1799,-296,8,-304,-201
"38300",NA,42125,"Washington County, PA","County or equivalent",2003,203564,597,-192,2137,2329,1004,19,985,-215
"38300",NA,42129,"Westmoreland County, PA","County or equivalent",2003,366264,-511,-925,3449,4374,895,25,870,-481
"38340",NA,NA,"Pittsfield, MA","Metropolitan Statistical Area",2003,132565,-518,-319,1264,1583,-13,111,-124,-186
"38340",NA,25003,"Berkshire County, MA","County or equivalent",2003,132565,-518,-319,1264,1583,-13,111,-124,-186
"38540",NA,NA,"Pocatello, ID","Metropolitan Statistical Area",2003,84720,57,845,1528,683,-1336,75,-1411,548
"38540",NA,16005,"Bannock County, ID","County or equivalent",2003,77318,117,793,1409,616,-1171,48,-1219,495
"38540",NA,16077,"Power County, ID","County or equivalent",2003,7402,-60,52,119,67,-165,27,-192,53
"38860",NA,NA,"Portland-South Portland-Biddeford, ME","Metropolitan Statistical Area",2003,505919,5136,1283,5638,4355,4319,-2,4321,-466
"38860",NA,23005,"Cumberland County, ME","County or equivalent",2003,271795,2125,621,3072,2451,1810,105,1705,-306
"38860",NA,23023,"Sagadahoc County, ME","County or equivalent",2003,36691,884,107,430,323,772,-86,858,5
"38860",NA,23031,"York County, ME","County or equivalent",2003,197433,2127,555,2136,1581,1737,-21,1758,-165
"38900",NA,NA,"Portland-Vancouver-Beaverton, OR-WA","Metropolitan Statistical Area",2003,2035389,23953,13659,28509,14850,12602,8577,4025,-2308
"38900",NA,41005,"Clackamas County, OR","County or equivalent",2003,355791,4130,1387,4072,2685,3170,801,2369,-427
"38900",NA,41009,"Columbia County, OR","County or equivalent",2003,45675,520,125,526,401,433,3,430,-38
"38900",NA,41051,"Multnomah County, OR","County or equivalent",2003,679187,2412,3713,9517,5804,-571,3578,-4149,-730
"38900",NA,41067,"Washington County, OR","County or equivalent",2003,478630,6906,4999,7772,2773,2612,2717,-105,-705
"38900",NA,41071,"Yamhill County, OR","County or equivalent",2003,88793,1260,530,1184,654,842,278,564,-112
"38900",NA,53011,"Clark County, WA","County or equivalent",2003,377274,8574,2852,5329,2477,6013,1198,4815,-291
"38900",NA,53059,"Skamania County, WA","County or equivalent",2003,10039,151,53,109,56,103,2,101,-5
"38940",NA,NA,"Port St. Lucie, FL","Metropolitan Statistical Area",2003,346907,11074,-513,3549,4062,11293,770,10523,294
"38940",NA,12085,"Martin County, FL","County or equivalent",2003,134416,2897,-453,1193,1646,3280,279,3001,70
"38940",NA,12111,"St. Lucie County, FL","County or equivalent",2003,212491,8177,-60,2356,2416,8013,491,7522,224
"39100",NA,NA,"Poughkeepsie-Newburgh-Middletown, NY","Metropolitan Statistical Area",2003,651878,9803,3555,8308,4753,6749,564,6185,-501
"39100",NA,36027,"Dutchess County, NY","County or equivalent",2003,289200,2372,978,3238,2260,1746,589,1157,-352
"39100",NA,36071,"Orange County, NY","County or equivalent",2003,362678,7431,2577,5070,2493,5003,-25,5028,-149
"39140",NA,NA,"Prescott, AZ","Metropolitan Statistical Area",2003,183313,4967,-129,1919,2048,5000,275,4725,96
"39140",NA,4025,"Yavapai County, AZ","County or equivalent",2003,183313,4967,-129,1919,2048,5000,275,4725,96
"39300",NA,NA,"Providence-New Bedford-Fall River, RI-MA","Metropolitan Statistical Area",2003,1617695,8695,4259,19328,15069,6554,3126,3428,-2118
"39300",NA,25005,"Bristol County, MA","County or equivalent",2003,546393,3330,1489,6646,5157,2501,636,1865,-660
"39300",NA,44001,"Bristol County, RI","County or equivalent",2003,50896,-163,-51,468,519,-42,18,-60,-70
"39300",NA,44003,"Kent County, RI","County or equivalent",2003,170998,1235,94,1831,1737,1312,106,1206,-171
"39300",NA,44005,"Newport County, RI","County or equivalent",2003,85229,-260,126,847,721,-261,-288,27,-125
"39300",NA,44007,"Providence County, RI","County or equivalent",2003,636429,3543,2209,8254,6045,2289,2608,-319,-955
"39300",NA,44009,"Washington County, RI","County or equivalent",2003,127750,1010,392,1282,890,755,46,709,-137
"39340",NA,NA,"Provo-Orem, UT","Metropolitan Statistical Area",2003,418175,12418,9091,10940,1849,669,1217,-548,2658
"39340",NA,49023,"Juab County, UT","County or equivalent",2003,8603,127,111,173,62,28,1,27,-12
"39340",NA,49049,"Utah County, UT","County or equivalent",2003,409572,12291,8980,10767,1787,641,1216,-575,2670
"39380",NA,NA,"Pueblo, CO","Metropolitan Statistical Area",2003,147930,1204,605,2058,1453,770,132,638,-171
"39380",NA,8101,"Pueblo County, CO","County or equivalent",2003,147930,1204,605,2058,1453,770,132,638,-171
"39460",NA,NA,"Punta Gorda, FL","Metropolitan Statistical Area",2003,151969,2623,-1150,1058,2208,3659,150,3509,114
"39460",NA,12015,"Charlotte County, FL","County or equivalent",2003,151969,2623,-1150,1058,2208,3659,150,3509,114
"39540",NA,NA,"Racine, WI","Metropolitan Statistical Area",2003,192967,1605,1007,2536,1529,264,225,39,334
"39540",NA,55101,"Racine County, WI","County or equivalent",2003,192967,1605,1007,2536,1529,264,225,39,334
"39580",NA,NA,"Raleigh-Cary, NC","Metropolitan Statistical Area",2003,889078,25853,9025,13843,4818,15764,4205,11559,1064
"39580",NA,37069,"Franklin County, NC","County or equivalent",2003,51928,1307,224,656,432,1082,121,961,1
"39580",NA,37101,"Johnston County, NC","County or equivalent",2003,136092,3647,1178,2131,953,2516,439,2077,-47
"39580",NA,37183,"Wake County, NC","County or equivalent",2003,701058,20899,7623,11056,3433,12166,3645,8521,1110
"39660",NA,NA,"Rapid City, SD","Metropolitan Statistical Area",2003,115874,629,878,1824,946,-94,-373,279,-155
"39660",NA,46093,"Meade County, SD","County or equivalent",2003,24382,-20,187,375,188,-171,-226,55,-36
"39660",NA,46103,"Pennington County, SD","County or equivalent",2003,91492,649,691,1449,758,77,-147,224,-119
"39740",NA,NA,"Reading, PA","Metropolitan Statistical Area",2003,384285,3838,1083,4738,3655,3110,531,2579,-355
"39740",NA,42011,"Berks County, PA","County or equivalent",2003,384285,3838,1083,4738,3655,3110,531,2579,-355
"39820",NA,NA,"Redding, CA","Metropolitan Statistical Area",2003,174406,3277,120,1959,1839,3195,96,3099,-38
"39820",NA,6089,"Shasta County, CA","County or equivalent",2003,174406,3277,120,1959,1839,3195,96,3099,-38
"39900",NA,NA,"Reno-Sparks, NV","Metropolitan Statistical Area",2003,374166,9289,2572,5413,2841,6934,1525,5409,-217
"39900",NA,32029,"Storey County, NV","County or equivalent",2003,3512,114,-2,20,22,112,3,109,4
"39900",NA,32031,"Washoe County, NV","County or equivalent",2003,370654,9175,2574,5393,2819,6822,1522,5300,-221
"40060",NA,NA,"Richmond, VA","Metropolitan Statistical Area",2003,1138744,13777,5109,14831,9722,9427,805,8622,-759
"40060",NA,51007,"Amelia County, VA","County or equivalent",2003,11640,21,-12,128,140,49,1,48,-16
"40060",NA,51033,"Caroline County, VA","County or equivalent",2003,23024,535,70,290,220,459,-4,463,6
"40060",NA,51036,"Charles City County, VA","County or equivalent",2003,7079,56,4,75,71,59,1,58,-7
"40060",NA,51041,"Chesterfield County, VA","County or equivalent",2003,273909,4643,1899,3438,1539,2931,325,2606,-187
"40060",NA,51049,"Cumberland County, VA","County or equivalent",2003,9138,90,8,101,93,90,10,80,-8
"40060",NA,51053,"Dinwiddie County, VA","County or equivalent",2003,24845,198,25,259,234,189,-7,196,-16
"40060",NA,51075,"Goochland County, VA","County or equivalent",2003,18008,400,20,177,157,383,13,370,-3
"40060",NA,51085,"Hanover County, VA","County or equivalent",2003,93548,2063,394,1036,642,1684,27,1657,-15
"40060",NA,51087,"Henrico County, VA","County or equivalent",2003,271104,3005,1416,3715,2299,1926,761,1165,-337
"40060",NA,51097,"King and Queen County, VA","County or equivalent",2003,6524,-42,-31,64,95,-2,-2,0,-9
"40060",NA,51101,"King William County, VA","County or equivalent",2003,13936,263,70,197,127,198,2,196,-5
"40060",NA,51109,"Louisa County, VA","County or equivalent",2003,27849,841,14,303,289,806,4,802,21
"40060",NA,51127,"New Kent County, VA","County or equivalent",2003,14764,569,63,149,86,488,-9,497,18
"40060",NA,51145,"Powhatan County, VA","County or equivalent",2003,24835,738,145,280,135,581,1,580,12
"40060",NA,51149,"Prince George County, VA","County or equivalent",2003,36030,885,209,374,165,622,-618,1240,54
"40060",NA,51183,"Sussex County, VA","County or equivalent",2003,12143,98,-39,114,153,142,6,136,-5
"40060",NA,51570,"Colonial Heights city, VA","County or equivalent",2003,17173,63,-18,188,206,103,-2,105,-22
"40060",NA,51670,"Hopewell city, VA","County or equivalent",2003,22297,-175,54,322,268,-213,-2,-211,-16
"40060",NA,51730,"Petersburg city, VA","County or equivalent",2003,32974,-42,19,515,496,-13,-39,26,-48
"40060",NA,51760,"Richmond city, VA","County or equivalent",2003,197924,-432,799,3106,2307,-1055,337,-1392,-176
"40140",NA,NA,"Riverside-San Bernardino-Ontario, CA","Metropolitan Statistical Area",2003,3617130,130299,33474,58290,24816,95672,9762,85910,1153
"40140",NA,6065,"Riverside County, CA","County or equivalent",2003,1766393,82015,14701,27734,13033,65420,5923,59497,1894
"40140",NA,6071,"San Bernardino County, CA","County or equivalent",2003,1850737,48284,18773,30556,11783,30252,3839,26413,-741
"40220",NA,NA,"Roanoke, VA","Metropolitan Statistical Area",2003,289326,630,69,3205,3136,814,257,557,-253
"40220",NA,51023,"Botetourt County, VA","County or equivalent",2003,31303,247,68,306,238,205,0,205,-26
"40220",NA,51045,"Craig County, VA","County or equivalent",2003,5065,14,-6,54,60,26,1,25,-6
"40220",NA,51067,"Franklin County, VA","County or equivalent",2003,48669,402,72,502,430,371,2,369,-41
"40220",NA,51161,"Roanoke County, VA","County or equivalent",2003,86823,568,-81,827,908,720,89,631,-71
"40220",NA,51770,"Roanoke city, VA","County or equivalent",2003,92698,-578,64,1273,1209,-566,151,-717,-76
"40220",NA,51775,"Salem city, VA","County or equivalent",2003,24768,-23,-48,243,291,58,14,44,-33
"40340",NA,NA,"Rochester, MN","Metropolitan Statistical Area",2003,171710,2305,1431,2569,1138,1097,579,518,-223
"40340",NA,27039,"Dodge County, MN","County or equivalent",2003,18726,236,165,281,116,94,14,80,-23
"40340",NA,27109,"Olmsted County, MN","County or equivalent",2003,131123,2006,1207,2035,828,968,543,425,-169
"40340",NA,27157,"Wabasha County, MN","County or equivalent",2003,21861,63,59,253,194,35,22,13,-31
"40380",NA,NA,"Rochester, NY","Metropolitan Statistical Area",2003,1040259,-1132,3459,12357,8898,-3424,1632,-5056,-1167
"40380",NA,36051,"Livingston County, NY","County or equivalent",2003,63887,-307,162,661,499,-404,6,-410,-65
"40380",NA,36055,"Monroe County, NY","County or equivalent",2003,737994,-1165,2673,8935,6262,-3048,1528,-4576,-790
"40380",NA,36069,"Ontario County, NY","County or equivalent",2003,102094,582,218,1151,933,508,57,451,-144
"40380",NA,36073,"Orleans County, NY","County or equivalent",2003,43214,-193,86,465,379,-232,12,-244,-47
"40380",NA,36117,"Wayne County, NY","County or equivalent",2003,93070,-49,320,1145,825,-248,29,-277,-121
"40420",NA,NA,"Rockford, IL","Metropolitan Statistical Area",2003,331253,4212,1815,4646,2831,2149,830,1319,248
"40420",NA,17007,"Boone County, IL","County or equivalent",2003,46123,1600,368,661,293,1222,127,1095,10
"40420",NA,17201,"Winnebago County, IL","County or equivalent",2003,285130,2612,1447,3985,2538,927,703,224,238
"40580",NA,NA,"Rocky Mount, NC","Metropolitan Statistical Area",2003,143410,103,419,1892,1473,-91,155,-246,-225
"40580",NA,37065,"Edgecombe County, NC","County or equivalent",2003,54222,-424,108,711,603,-439,72,-511,-93
"40580",NA,37127,"Nash County, NC","County or equivalent",2003,89188,527,311,1181,870,348,83,265,-132
"40660",NA,NA,"Rome, GA","Metropolitan Statistical Area",2003,93442,863,418,1450,1032,551,217,334,-106
"40660",NA,13115,"Floyd County, GA","County or equivalent",2003,93442,863,418,1450,1032,551,217,334,-106
"40900",NA,NA,"Sacramento--Arden-Arcade--Roseville, CA","Metropolitan Statistical Area",2003,1968902,45942,13466,27545,14079,33610,7736,25874,-1134
"40900",NA,6017,"El Dorado County, CA","County or equivalent",2003,167371,2752,606,1788,1182,2220,267,1953,-74
"40900",NA,6061,"Placer County, CA","County or equivalent",2003,291921,14088,1376,3540,2164,12377,414,11963,335
"40900",NA,6067,"Sacramento County, CA","County or equivalent",2003,1326638,26526,10220,19767,9547,17419,5746,11673,-1113
"40900",NA,6113,"Yolo County, CA","County or equivalent",2003,182972,2576,1264,2450,1186,1594,1309,285,-282
"40980",NA,NA,"Saginaw-Saginaw Township North, MI","Metropolitan Statistical Area",2003,208176,-866,614,2639,2025,-1264,125,-1389,-216
"40980",NA,26145,"Saginaw County, MI","County or equivalent",2003,208176,-866,614,2639,2025,-1264,125,-1389,-216
"41060",NA,NA,"St. Cloud, MN","Metropolitan Statistical Area",2003,177906,2837,1288,2368,1080,407,137,270,1142
"41060",NA,27009,"Benton County, MN","County or equivalent",2003,37683,926,283,597,314,492,20,472,151
"41060",NA,27145,"Stearns County, MN","County or equivalent",2003,140223,1911,1005,1771,766,-85,117,-202,991
"41100",NA,NA,"St. George, UT","Metropolitan Statistical Area",2003,104245,4833,1324,2042,718,3458,144,3314,51
"41100",NA,49053,"Washington County, UT","County or equivalent",2003,104245,4833,1324,2042,718,3458,144,3314,51
"41140",NA,NA,"St. Joseph, MO-KS","Metropolitan Statistical Area",2003,123968,13,202,1493,1291,-406,-1,-405,217
"41140",NA,20043,"Doniphan County, KS","County or equivalent",2003,8050,-72,-5,77,82,-60,-3,-57,-7
"41140",NA,29003,"Andrew County, MO","County or equivalent",2003,16612,99,32,190,158,82,-6,88,-15
"41140",NA,29021,"Buchanan County, MO","County or equivalent",2003,86304,-20,182,1114,932,-459,5,-464,257
"41140",NA,29063,"DeKalb County, MO","County or equivalent",2003,13002,6,-7,112,119,31,3,28,-18
"41180",NA,NA,"St. Louis, MO-IL","Metropolitan Statistical Area",2003,2743680,10498,9688,35653,25965,0,2145,-2145,810
"41180",NA,17005,"Bond County, IL","County or equivalent",2003,18069,271,31,208,177,249,1,248,-9
"41180",NA,17013,"Calhoun County, IL","County or equivalent",2003,5098,122,0,58,58,124,1,123,-2
"41180",NA,17027,"Clinton County, IL","County or equivalent",2003,35851,125,41,399,358,125,-25,150,-41
"41180",NA,17083,"Jersey County, IL","County or equivalent",2003,21940,41,-2,242,244,71,2,69,-28
"41180",NA,17117,"Macoupin County, IL","County or equivalent",2003,48719,-55,-75,528,603,87,-2,89,-67
"41180",NA,17119,"Madison County, IL","County or equivalent",2003,262957,1659,663,3360,2697,734,-5,739,262
"41180",NA,17133,"Monroe County, IL","County or equivalent",2003,29931,738,109,377,268,564,5,559,65
"41180",NA,17163,"St. Clair County, IL","County or equivalent",2003,257691,616,944,3621,2677,-138,-910,772,-190
"41180",NA,29071,"Franklin County, MO","County or equivalent",2003,96324,614,389,1296,907,354,2,352,-129
"41180",NA,29099,"Jefferson County, MO","County or equivalent",2003,205081,2481,1120,2700,1580,1564,45,1519,-203
"41180",NA,29113,"Lincoln County, MO","County or equivalent",2003,43863,1675,235,617,382,1398,2,1396,42
"41180",NA,29183,"St. Charles County, MO","County or equivalent",2003,310482,7753,2459,4302,1843,5408,127,5281,-114
"41180",NA,29189,"St. Louis County, MO","County or equivalent",2003,1009045,-3958,2494,12125,9631,-5407,1453,-6860,-1045
"41180",NA,29219,"Warren County, MO","County or equivalent",2003,26869,793,130,351,221,652,8,644,11
"41180",NA,29221,"Washington County, MO","County or equivalent",2003,23721,55,50,318,268,39,4,35,-34
"41180",NA,29510,"St. Louis city, MO","County or equivalent",2003,348039,-2432,1100,5151,4051,-5824,1437,-7261,2292
"41420",NA,NA,"Salem, OR","Metropolitan Statistical Area",2003,362565,4216,2240,5282,3042,2461,1618,843,-485
"41420",NA,41047,"Marion County, OR","County or equivalent",2003,296615,3037,2023,4508,2485,1454,1457,-3,-440
"41420",NA,41053,"Polk County, OR","County or equivalent",2003,65950,1179,217,774,557,1007,161,846,-45
"41500",NA,NA,"Salinas, CA","Metropolitan Statistical Area",2003,411385,1575,4889,7304,2415,-3041,2663,-5704,-273
"41500",NA,6053,"Monterey County, CA","County or equivalent",2003,411385,1575,4889,7304,2415,-3041,2663,-5704,-273
"41540",NA,NA,"Salisbury, MD","Metropolitan Statistical Area",2003,112659,1350,332,1408,1076,1119,132,987,-101
"41540",NA,24039,"Somerset County, MD","County or equivalent",2003,25407,33,-8,267,275,74,22,52,-33
"41540",NA,24045,"Wicomico County, MD","County or equivalent",2003,87252,1317,340,1141,801,1045,110,935,-68
"41620",NA,NA,"Salt Lake City, UT","Metropolitan Statistical Area",2003,1016736,14858,14591,20129,5538,-5204,4936,-10140,5471
"41620",NA,49035,"Salt Lake County, UT","County or equivalent",2003,936714,12199,13348,18562,5214,-6650,4745,-11395,5501
"41620",NA,49043,"Summit County, UT","County or equivalent",2003,32653,900,420,527,107,500,136,364,-20
"41620",NA,49045,"Tooele County, UT","County or equivalent",2003,47369,1759,823,1040,217,946,55,891,-10
"41660",NA,NA,"San Angelo, TX","Metropolitan Statistical Area",2003,106372,612,685,1659,974,58,-360,418,-131
"41660",NA,48235,"Irion County, TX","County or equivalent",2003,1729,-11,1,11,10,-9,1,-10,-3
"41660",NA,48451,"Tom Green County, TX","County or equivalent",2003,104643,623,684,1648,964,67,-361,428,-128
"41700",NA,NA,"San Antonio, TX","Metropolitan Statistical Area",2003,1808661,31086,16310,29393,13083,16224,-354,16578,-1448
"41700",NA,48013,"Atascosa County, TX","County or equivalent",2003,41297,477,341,650,309,191,28,163,-55
"41700",NA,48019,"Bandera County, TX","County or equivalent",2003,19122,385,46,205,159,337,7,330,2
"41700",NA,48029,"Bexar County, TX","County or equivalent",2003,1462550,22458,14524,24884,10360,9362,-460,9822,-1428
"41700",NA,48091,"Comal County, TX","County or equivalent",2003,86919,2697,395,1137,742,2258,60,2198,44
"41700",NA,48187,"Guadalupe County, TX","County or equivalent",2003,96400,2309,487,1159,672,1819,0,1819,3
"41700",NA,48259,"Kendall County, TX","County or equivalent",2003,26190,1032,78,340,262,935,26,909,19
"41700",NA,48325,"Medina County, TX","County or equivalent",2003,41180,702,251,566,315,476,0,476,-25
"41700",NA,48493,"Wilson County, TX","County or equivalent",2003,35003,1026,188,452,264,846,-15,861,-8
"41740",NA,NA,"San Diego-Carlsbad-San Marcos, CA","Metropolitan Statistical Area",2003,2927311,21702,25506,44948,19442,542,-591,1133,-4346
"41740",NA,6073,"San Diego County, CA","County or equivalent",2003,2927311,21702,25506,44948,19442,542,-591,1133,-4346
"41780",NA,NA,"Sandusky, OH","Metropolitan Statistical Area",2003,78472,-171,133,932,799,-211,20,-231,-93
"41780",NA,39043,"Erie County, OH","County or equivalent",2003,78472,-171,133,932,799,-211,20,-231,-93
"41860",NA,NA,"San Francisco-Oakland-Fremont, CA","Metropolitan Statistical Area",2003,4157602,-10959,27359,56724,29365,-42632,31542,-74174,4314
"41860",36084,NA,"Oakland-Fremont-Hayward, CA","Metropolitan Division",2003,2442094,-1206,18479,35072,16593,-18440,16967,-35407,-1245
"41860",36084,6001,"Alameda County, CA","County or equivalent",2003,1452923,-8957,12121,21818,9697,-21217,12301,-33518,139
"41860",36084,6013,"Contra Costa County, CA","County or equivalent",2003,989171,7751,6358,13254,6896,2777,4666,-1889,-1384
"41860",41884,NA,"San Francisco-San Mateo-Redwood City, CA","Metropolitan Division",2003,1715508,-9753,8880,21652,12772,-24192,14575,-38767,5559
"41860",41884,6041,"Marin County, CA","County or equivalent",2003,245281,-1202,981,2790,1809,-2051,1199,-3250,-132
"41860",41884,6075,"San Francisco County, CA","County or equivalent",2003,774359,-4414,2463,8661,6198,-12532,7135,-19667,5655
"41860",41884,6081,"San Mateo County, CA","County or equivalent",2003,695868,-4137,5436,10201,4765,-9609,6241,-15850,36
"41940",NA,NA,"San Jose-Sunnyvale-Santa Clara, CA","Metropolitan Statistical Area",2003,1726381,-4028,19075,28103,9028,-23531,20648,-44179,428
"41940",NA,6069,"San Benito County, CA","County or equivalent",2003,55369,164,635,892,257,-439,282,-721,-32
"41940",NA,6085,"Santa Clara County, CA","County or equivalent",2003,1671012,-4192,18440,27211,8771,-23092,20366,-43458,460
"42020",NA,NA,"San Luis Obispo-Paso Robles, CA","Metropolitan Statistical Area",2003,254353,1368,518,2572,2054,1168,473,695,-318
"42020",NA,6079,"San Luis Obispo County, CA","County or equivalent",2003,254353,1368,518,2572,2054,1168,473,695,-318
"42060",NA,NA,"Santa Barbara-Santa Maria-Goleta, CA","Metropolitan Statistical Area",2003,403083,554,2859,5724,2865,-1921,1902,-3823,-384
"42060",NA,6083,"Santa Barbara County, CA","County or equivalent",2003,403083,554,2859,5724,2865,-1921,1902,-3823,-384
"42100",NA,NA,"Santa Cruz-Watsonville, CA","Metropolitan Statistical Area",2003,251899,-2018,1600,3291,1691,-3562,1250,-4812,-56
"42100",NA,6087,"Santa Cruz County, CA","County or equivalent",2003,251899,-2018,1600,3291,1691,-3562,1250,-4812,-56
"42140",NA,NA,"Santa Fe, NM","Metropolitan Statistical Area",2003,136275,1885,827,1667,840,1226,611,615,-168
"42140",NA,35049,"Santa Fe County, NM","County or equivalent",2003,136275,1885,827,1667,840,1226,611,615,-168
"42220",NA,NA,"Santa Rosa-Petaluma, CA","Metropolitan Statistical Area",2003,464222,320,1997,5806,3809,-1207,1921,-3128,-470
"42220",NA,6097,"Sonoma County, CA","County or equivalent",2003,464222,320,1997,5806,3809,-1207,1921,-3128,-470
"42340",NA,NA,"Savannah, GA","Metropolitan Statistical Area",2003,304934,3309,1928,4596,2668,1687,-352,2039,-306
"42340",NA,13029,"Bryan County, GA","County or equivalent",2003,25855,986,208,366,158,753,-76,829,25
"42340",NA,13051,"Chatham County, GA","County or equivalent",2003,236447,778,1394,3624,2230,-260,-274,14,-356
"42340",NA,13103,"Effingham County, GA","County or equivalent",2003,42632,1545,326,606,280,1194,-2,1196,25
"42540",NA,NA,"Scranton--Wilkes-Barre, PA","Metropolitan Statistical Area",2003,550319,-2029,-2057,5457,7514,751,209,542,-723
"42540",NA,42069,"Lackawanna County, PA","County or equivalent",2003,209775,-943,-656,2109,2765,9,88,-79,-296
"42540",NA,42079,"Luzerne County, PA","County or equivalent",2003,312616,-1083,-1441,3042,4483,745,120,625,-387
"42540",NA,42131,"Wyoming County, PA","County or equivalent",2003,27928,-3,40,306,266,-3,1,-4,-40
"42660",NA,NA,"Seattle-Tacoma-Bellevue, WA","Metropolitan Statistical Area",2003,3136965,16154,19411,40491,21080,-2902,10029,-12931,-355
"42660",42644,NA,"Seattle-Bellevue-Everett, WA","Metropolitan Division",2003,2400772,8404,14848,30478,15630,-6821,11142,-17963,377
"42660",42644,53033,"King County, WA","County or equivalent",2003,1767851,5158,10477,22014,11537,-6540,9954,-16494,1221
"42660",42644,53061,"Snohomish County, WA","County or equivalent",2003,632921,3246,4371,8464,4093,-281,1188,-1469,-844
"42660",45104,NA,"Tacoma, WA","Metropolitan Division",2003,736193,7750,4563,10013,5450,3919,-1113,5032,-732
"42660",45104,53053,"Pierce County, WA","County or equivalent",2003,736193,7750,4563,10013,5450,3919,-1113,5032,-732
"42680",NA,NA,"Sebastian-Vero Beach, FL","Metropolitan Statistical Area",2003,119740,1994,-445,1152,1597,2431,232,2199,8
"42680",NA,12061,"Indian River County, FL","County or equivalent",2003,119740,1994,-445,1152,1597,2431,232,2199,8
"43100",NA,NA,"Sheboygan, WI","Metropolitan Statistical Area",2003,112954,0,331,1366,1035,-186,146,-332,-145
"43100",NA,55117,"Sheboygan County, WI","County or equivalent",2003,112954,0,331,1366,1035,-186,146,-332,-145
"43300",NA,NA,"Sherman-Denison, TX","Metropolitan Statistical Area",2003,114384,1111,354,1560,1206,879,185,694,-122
"43300",NA,48181,"Grayson County, TX","County or equivalent",2003,114384,1111,354,1560,1206,879,185,694,-122
"43340",NA,NA,"Shreveport-Bossier City, LA","Metropolitan Statistical Area",2003,376790,676,1744,5440,3696,-610,-666,56,-458
"43340",NA,22015,"Bossier Parish, LA","County or equivalent",2003,101948,1050,760,1577,817,383,-548,931,-93
"43340",NA,22017,"Caddo Parish, LA","County or equivalent",2003,249211,-421,975,3559,2584,-1066,-122,-944,-330
"43340",NA,22031,"De Soto Parish, LA","County or equivalent",2003,25631,47,9,304,295,73,4,69,-35
"43580",NA,NA,"Sioux City, IA-NE-SD","Metropolitan Statistical Area",2003,141968,-312,935,2235,1300,-1158,468,-1626,-89
"43580",NA,19193,"Woodbury County, IA","County or equivalent",2003,102517,-502,602,1579,977,-1043,314,-1357,-61
"43580",NA,31043,"Dakota County, NE","County or equivalent",2003,20346,74,247,399,152,-162,130,-292,-11
"43580",NA,31051,"Dixon County, NE","County or equivalent",2003,6120,-64,16,82,66,-76,6,-82,-4
"43580",NA,46127,"Union County, SD","County or equivalent",2003,12985,180,70,175,105,123,18,105,-13
"43620",NA,NA,"Sioux Falls, SD","Metropolitan Statistical Area",2003,202690,5166,1591,3045,1454,2647,346,2301,928
"43620",NA,46083,"Lincoln County, SD","County or equivalent",2003,29238,1512,268,449,181,1121,15,1106,123
"43620",NA,46087,"McCook County, SD","County or equivalent",2003,5798,6,1,78,77,14,-2,16,-9
"43620",NA,46099,"Minnehaha County, SD","County or equivalent",2003,159092,3656,1350,2441,1091,1483,335,1148,823
"43620",NA,46125,"Turner County, SD","County or equivalent",2003,8562,-8,-28,77,105,29,-2,31,-9
"43780",NA,NA,"South Bend-Mishawaka, IN-MI","Metropolitan Statistical Area",2003,315459,-620,1450,4225,2775,-1746,546,-2292,-324
"43780",NA,18141,"St. Joseph County, IN","County or equivalent",2003,264531,-511,1421,3744,2323,-1683,534,-2217,-249
"43780",NA,26027,"Cass County, MI","County or equivalent",2003,50928,-109,29,481,452,-63,12,-75,-75
"43900",NA,NA,"Spartanburg, SC","Metropolitan Statistical Area",2003,260743,1794,890,3465,2575,1232,391,841,-328
"43900",NA,45083,"Spartanburg County, SC","County or equivalent",2003,260743,1794,890,3465,2575,1232,391,841,-328
"44060",NA,NA,"Spokane, WA","Metropolitan Statistical Area",2003,430991,3908,1889,5506,3617,2527,232,2295,-508
"44060",NA,53063,"Spokane County, WA","County or equivalent",2003,430991,3908,1889,5506,3617,2527,232,2295,-508
"44100",NA,NA,"Springfield, IL","Metropolitan Statistical Area",2003,204286,355,781,2693,1912,-296,15,-311,-130
"44100",NA,17129,"Menard County, IL","County or equivalent",2003,12476,0,28,145,117,-11,-3,-8,-17
"44100",NA,17167,"Sangamon County, IL","County or equivalent",2003,191810,355,753,2548,1795,-285,18,-303,-113
"44140",NA,NA,"Springfield, MA","Metropolitan Statistical Area",2003,685616,2088,1450,7782,6332,1639,1454,185,-1001
"44140",NA,25011,"Franklin County, MA","County or equivalent",2003,71904,17,66,691,625,59,88,-29,-108
"44140",NA,25013,"Hampden County, MA","County or equivalent",2003,460041,1294,1253,5768,4515,733,1120,-387,-692
"44140",NA,25015,"Hampshire County, MA","County or equivalent",2003,153671,777,131,1323,1192,847,246,601,-201
"44180",NA,NA,"Springfield, MO","Metropolitan Statistical Area",2003,385498,5857,1394,5020,3626,4704,135,4569,-241
"44180",NA,29043,"Christian County, MO","County or equivalent",2003,60921,2058,326,806,480,1703,-6,1709,29
"44180",NA,29059,"Dallas County, MO","County or equivalent",2003,15938,106,33,206,173,86,-2,88,-13
"44180",NA,29077,"Greene County, MO","County or equivalent",2003,247568,2860,789,3161,2372,2276,120,2156,-205
"44180",NA,29167,"Polk County, MO","County or equivalent",2003,28219,437,27,342,315,425,17,408,-15
"44180",NA,29225,"Webster County, MO","County or equivalent",2003,32852,396,219,505,286,214,6,208,-37
"44220",NA,NA,"Springfield, OH","Metropolitan Statistical Area",2003,141909,-1493,55,1743,1688,-1456,-2,-1454,-92
"44220",NA,39023,"Clark County, OH","County or equivalent",2003,141909,-1493,55,1743,1688,-1456,-2,-1454,-92
"44300",NA,NA,"State College, PA","Metropolitan Statistical Area",2003,140503,1237,388,1307,919,1033,542,491,-184
"44300",NA,42027,"Centre County, PA","County or equivalent",2003,140503,1237,388,1307,919,1033,542,491,-184
"44700",NA,NA,"Stockton, CA","Metropolitan Statistical Area",2003,626014,17156,5517,10204,4687,11860,2689,9171,-221
"44700",NA,6077,"San Joaquin County, CA","County or equivalent",2003,626014,17156,5517,10204,4687,11860,2689,9171,-221
"44940",NA,NA,"Sumter, SC","Metropolitan Statistical Area",2003,104817,-34,662,1609,947,-548,-590,42,-148
"44940",NA,45085,"Sumter County, SC","County or equivalent",2003,104817,-34,662,1609,947,-548,-590,42,-148
"45060",NA,NA,"Syracuse, NY","Metropolitan Statistical Area",2003,649719,914,2017,7726,5709,-275,848,-1123,-828
"45060",NA,36053,"Madison County, NY","County or equivalent",2003,69828,339,102,705,603,319,20,299,-82
"45060",NA,36067,"Onondaga County, NY","County or equivalent",2003,457164,131,1623,5649,4026,-914,819,-1733,-578
"45060",NA,36075,"Oswego County, NY","County or equivalent",2003,122727,444,292,1372,1080,320,9,311,-168
"45220",NA,NA,"Tallahassee, FL","Metropolitan Statistical Area",2003,332733,5213,1807,4202,2395,3664,475,3189,-258
"45220",NA,12039,"Gadsden County, FL","County or equivalent",2003,45187,19,256,715,459,-182,56,-238,-55
"45220",NA,12065,"Jefferson County, FL","County or equivalent",2003,13956,205,-7,151,158,222,-2,224,-10
"45220",NA,12073,"Leon County, FL","County or equivalent",2003,247945,4311,1480,3054,1574,3016,415,2601,-185
"45220",NA,12129,"Wakulla County, FL","County or equivalent",2003,25645,678,78,282,204,608,6,602,-8
"45300",NA,NA,"Tampa-St. Petersburg-Clearwater, FL","Metropolitan Statistical Area",2003,2522193,38885,1058,29496,28438,38817,6555,32262,-990
"45300",NA,12053,"Hernando County, FL","County or equivalent",2003,142294,4655,-1025,1256,2281,5456,64,5392,224
"45300",NA,12057,"Hillsborough County, FL","County or equivalent",2003,1071122,20300,6460,15162,8702,14613,3527,11086,-773
"45300",NA,12101,"Pasco County, FL","County or equivalent",2003,385393,14089,-1418,3944,5362,14840,556,14284,667
"45300",NA,12103,"Pinellas County, FL","County or equivalent",2003,923384,-159,-2959,9134,12093,3908,2408,1500,-1108
"45460",NA,NA,"Terre Haute, IN","Metropolitan Statistical Area",2003,169457,39,101,2090,1989,163,83,80,-225
"45460",NA,18021,"Clay County, IN","County or equivalent",2003,26633,235,56,360,304,203,4,199,-24
"45460",NA,18153,"Sullivan County, IN","County or equivalent",2003,21683,-34,-2,248,250,-1,-3,2,-31
"45460",NA,18165,"Vermillion County, IN","County or equivalent",2003,16400,-99,-36,206,242,-41,2,-43,-22
"45460",NA,18167,"Vigo County, IN","County or equivalent",2003,104741,-63,83,1276,1193,2,80,-78,-148
"45500",NA,NA,"Texarkana, TX-Texarkana, AR","Metropolitan Statistical Area",2003,130760,573,339,1717,1378,410,46,364,-176
"45500",NA,5091,"Miller County, AR","County or equivalent",2003,41451,463,216,578,362,291,16,275,-44
"45500",NA,48037,"Bowie County, TX","County or equivalent",2003,89309,110,123,1139,1016,119,30,89,-132
"45780",NA,NA,"Toledo, OH","Metropolitan Statistical Area",2003,657754,-561,2387,8520,6133,-2214,526,-2740,-734
"45780",NA,39051,"Fulton County, OH","County or equivalent",2003,42254,49,127,502,375,-22,6,-28,-56
"45780",NA,39095,"Lucas County, OH","County or equivalent",2003,452015,-1229,1845,6243,4398,-2593,431,-3024,-481
"45780",NA,39123,"Ottawa County, OH","County or equivalent",2003,41127,212,-23,407,430,245,-1,246,-10
"45780",NA,39173,"Wood County, OH","County or equivalent",2003,122358,407,438,1368,930,156,90,66,-187
"45820",NA,NA,"Topeka, KS","Metropolitan Statistical Area",2003,225506,529,905,3149,2244,-66,117,-183,-310
"45820",NA,20085,"Jackson County, KS","County or equivalent",2003,12991,151,65,185,120,100,-3,103,-14
"45820",NA,20087,"Jefferson County, KS","County or equivalent",2003,18500,10,69,216,147,-32,-2,-30,-27
"45820",NA,20139,"Osage County, KS","County or equivalent",2003,16664,9,48,225,177,-14,-5,-9,-25
"45820",NA,20177,"Shawnee County, KS","County or equivalent",2003,170662,377,703,2450,1747,-90,129,-219,-236
"45820",NA,20197,"Wabaunsee County, KS","County or equivalent",2003,6689,-18,20,73,53,-30,-2,-28,-8
"45940",NA,NA,"Trenton-Ewing, NJ","Metropolitan Statistical Area",2003,358897,2684,1845,4650,2805,1379,1918,-539,-540
"45940",NA,34021,"Mercer County, NJ","County or equivalent",2003,358897,2684,1845,4650,2805,1379,1918,-539,-540
"46060",NA,NA,"Tucson, AZ","Metropolitan Statistical Area",2003,902773,16976,4911,12627,7716,8576,1962,6614,3489
"46060",NA,4019,"Pima County, AZ","County or equivalent",2003,902773,16976,4911,12627,7716,8576,1962,6614,3489
"46140",NA,NA,"Tulsa, OK","Metropolitan Statistical Area",2003,876515,1973,4990,13077,8087,-2323,1526,-3849,-694
"46140",NA,40037,"Creek County, OK","County or equivalent",2003,68336,-21,124,896,772,-51,0,-51,-94
"46140",NA,40111,"Okmulgee County, OK","County or equivalent",2003,39579,65,59,530,471,59,4,55,-53
"46140",NA,40113,"Osage County, OK","County or equivalent",2003,44834,-39,57,449,392,-35,12,-47,-61
"46140",NA,40117,"Pawnee County, OK","County or equivalent",2003,16619,-115,35,217,182,-136,-1,-135,-14
"46140",NA,40131,"Rogers County, OK","County or equivalent",2003,76859,1918,355,966,611,1568,28,1540,-5
"46140",NA,40143,"Tulsa County, OK","County or equivalent",2003,569198,-745,4006,9253,5247,-4323,1455,-5778,-428
"46140",NA,40145,"Wagoner County, OK","County or equivalent",2003,61090,910,354,766,412,595,28,567,-39
"46220",NA,NA,"Tuscaloosa, AL","Metropolitan Statistical Area",2003,194456,452,605,2483,1878,121,189,-68,-274
"46220",NA,1063,"Greene County, AL","County or equivalent",2003,9696,-142,6,131,125,-142,1,-143,-6
"46220",NA,1065,"Hale County, AL","County or equivalent",2003,17997,-34,22,232,210,-30,1,-31,-26
"46220",NA,1125,"Tuscaloosa County, AL","County or equivalent",2003,166763,628,577,2120,1543,293,187,106,-242
"46340",NA,NA,"Tyler, TX","Metropolitan Statistical Area",2003,183299,2797,1105,2807,1702,1866,501,1365,-174
"46340",NA,48423,"Smith County, TX","County or equivalent",2003,183299,2797,1105,2807,1702,1866,501,1365,-174
"46540",NA,NA,"Utica-Rome, NY","Metropolitan Statistical Area",2003,295953,-510,49,3264,3215,-172,610,-782,-387
"46540",NA,36043,"Herkimer County, NY","County or equivalent",2003,63222,-173,-29,711,740,-50,9,-59,-94
"46540",NA,36065,"Oneida County, NY","County or equivalent",2003,232731,-337,78,2553,2475,-122,601,-723,-293
"46660",NA,NA,"Valdosta, GA","Metropolitan Statistical Area",2003,122409,923,792,1822,1030,254,-334,588,-123
"46660",NA,13027,"Brooks County, GA","County or equivalent",2003,16070,-174,-19,191,210,-143,2,-145,-12
"46660",NA,13101,"Echols County, GA","County or equivalent",2003,3926,115,47,63,16,71,44,27,-3
"46660",NA,13173,"Lanier County, GA","County or equivalent",2003,7358,200,53,113,60,146,-11,157,1
"46660",NA,13185,"Lowndes County, GA","County or equivalent",2003,95055,782,711,1455,744,180,-369,549,-109
"46700",NA,NA,"Vallejo-Fairfield, CA","Metropolitan Statistical Area",2003,408734,695,3150,5856,2706,-2006,309,-2315,-449
"46700",NA,6095,"Solano County, CA","County or equivalent",2003,408734,695,3150,5856,2706,-2006,309,-2315,-449
"47020",NA,NA,"Victoria, TX","Metropolitan Statistical Area",2003,112348,136,824,1761,937,-581,180,-761,-107
"47020",NA,48057,"Calhoun County, TX","County or equivalent",2003,20290,-74,161,340,179,-222,78,-300,-13
"47020",NA,48175,"Goliad County, TX","County or equivalent",2003,7069,59,1,70,69,65,3,62,-7
"47020",NA,48469,"Victoria County, TX","County or equivalent",2003,84989,151,662,1351,689,-424,99,-523,-87
"47220",NA,NA,"Vineland-Millville-Bridgeton, NJ","Metropolitan Statistical Area",2003,148656,1131,615,2088,1473,716,427,289,-200
"47220",NA,34011,"Cumberland County, NJ","County or equivalent",2003,148656,1131,615,2088,1473,716,427,289,-200
"47260",NA,NA,"Virginia Beach-Norfolk-Newport News, VA-NC","Metropolitan Statistical Area",2003,1625329,19761,11032,23361,12329,9011,-13170,22181,-282
"47260",NA,37053,"Currituck County, NC","County or equivalent",2003,20559,1084,65,218,153,965,-33,998,54
"47260",NA,51073,"Gloucester County, VA","County or equivalent",2003,36285,638,90,370,280,561,-74,635,-13
"47260",NA,51093,"Isle of Wight County, VA","County or equivalent",2003,31436,791,79,358,279,705,-20,725,7
"47260",NA,51095,"James City County, VA","County or equivalent",2003,53113,1800,70,517,447,1685,-4,1689,45
"47260",NA,51115,"Mathews County, VA","County or equivalent",2003,9129,-56,-74,68,142,28,-8,36,-10
"47260",NA,51181,"Surry County, VA","County or equivalent",2003,6915,15,-12,70,82,34,-1,35,-7
"47260",NA,51199,"York County, VA","County or equivalent",2003,59403,589,256,593,337,355,-494,849,-22
"47260",NA,51550,"Chesapeake city, VA","County or equivalent",2003,208428,3853,1403,2840,1437,2491,-890,3381,-41
"47260",NA,51650,"Hampton city, VA","County or equivalent",2003,145288,349,706,1825,1119,-206,-952,746,-151
"47260",NA,51700,"Newport News city, VA","County or equivalent",2003,182826,1596,1766,3187,1421,-1,-1322,1321,-169
"47260",NA,51710,"Norfolk city, VA","County or equivalent",2003,240570,350,1948,3990,2042,-1807,-4074,2267,209
"47260",NA,51735,"Poquoson city, VA","County or equivalent",2003,11700,78,0,94,94,87,-24,111,-9
"47260",NA,51740,"Portsmouth city, VA","County or equivalent",2003,99470,-101,495,1585,1090,-472,-698,226,-124
"47260",NA,51800,"Suffolk city, VA","County or equivalent",2003,72844,3564,429,1080,651,2997,-197,3194,138
"47260",NA,51810,"Virginia Beach city, VA","County or equivalent",2003,435845,5320,3767,6405,2638,1739,-4392,6131,-186
"47260",NA,51830,"Williamsburg city, VA","County or equivalent",2003,11518,-109,44,161,117,-150,13,-163,-3
"47300",NA,NA,"Visalia-Porterville, CA","Metropolitan Statistical Area",2003,387214,8390,4867,7585,2718,3968,2089,1879,-445
"47300",NA,6107,"Tulare County, CA","County or equivalent",2003,387214,8390,4867,7585,2718,3968,2089,1879,-445
"47380",NA,NA,"Waco, TX","Metropolitan Statistical Area",2003,219591,2299,1479,3372,1893,1119,505,614,-299
"47380",NA,48309,"McLennan County, TX","County or equivalent",2003,219591,2299,1479,3372,1893,1119,505,614,-299
"47580",NA,NA,"Warner Robins, GA","Metropolitan Statistical Area",2003,119959,3595,925,1766,841,2582,-713,3295,88
"47580",NA,13153,"Houston County, GA","County or equivalent",2003,119959,3595,925,1766,841,2582,-713,3295,88
"47900",NA,NA,"Washington-Arlington-Alexandria, DC-VA-MD-WV","Metropolitan Statistical Area",2003,5084606,70261,45756,75789,30033,16143,24643,-8500,8362
"47900",13644,NA,"Bethesda-Frederick-Gaithersburg, MD","Metropolitan Division",2003,1129895,13164,9730,16426,6696,1650,7821,-6171,1784
"47900",13644,24021,"Frederick County, MD","County or equivalent",2003,212735,4237,1638,2985,1347,2745,90,2655,-146
"47900",13644,24031,"Montgomery County, MD","County or equivalent",2003,917160,8927,8092,13441,5349,-1095,7731,-8826,1930
"47900",47894,NA,"Washington-Arlington-Alexandria, DC-VA-MD-WV","Metropolitan Division",2003,3954711,57097,36026,59363,23337,14493,16822,-2329,6578
"47900",47894,11001,"District of Columbia, DC","County or equivalent",2003,577371,-1741,1802,7480,5678,-7509,2752,-10261,3966
"47900",47894,24009,"Calvert County, MD","County or equivalent",2003,83342,2962,435,1013,578,2479,-45,2524,48
"47900",47894,24017,"Charles County, MD","County or equivalent",2003,131448,3671,1061,1862,801,2582,-258,2840,28
"47900",47894,24033,"Prince George's County, MD","County or equivalent",2003,828822,5636,7048,12300,5252,-262,2946,-3208,-1150
"47900",47894,51013,"Arlington County, VA","County or equivalent",2003,196890,1166,1702,2719,1017,-2431,2207,-4638,1895
"47900",47894,51043,"Clarke County, VA","County or equivalent",2003,13277,191,-12,112,124,211,8,203,-8
"47900",47894,51059,"Fairfax County, VA","County or equivalent",2003,991863,2548,10293,14518,4225,-7132,7228,-14360,-613
"47900",47894,51061,"Fauquier County, VA","County or equivalent",2003,60797,1602,286,724,438,1312,48,1264,4
"47900",47894,51107,"Loudoun County, VA","County or equivalent",2003,219423,16416,3544,4256,712,12279,689,11590,593
"47900",47894,51153,"Prince William County, VA","County or equivalent",2003,320618,11306,4553,5775,1222,6689,-177,6866,64
"47900",47894,51177,"Spotsylvania County, VA","County or equivalent",2003,106536,4687,967,1582,615,3591,-40,3631,129
"47900",47894,51179,"Stafford County, VA","County or equivalent",2003,109035,5390,1054,1552,498,4126,-497,4623,210
"47900",47894,51187,"Warren County, VA","County or equivalent",2003,33501,697,158,474,316,547,5,542,-8
"47900",47894,51510,"Alexandria city, VA","County or equivalent",2003,135162,646,1712,2477,765,-2545,1410,-3955,1479
"47900",47894,51600,"Fairfax city, VA","County or equivalent",2003,22173,135,166,379,213,-18,231,-249,-13
"47900",47894,51610,"Falls Church city, VA","County or equivalent",2003,10555,-4,138,214,76,-142,58,-200,0
"47900",47894,51630,"Fredericksburg city, VA","County or equivalent",2003,20396,102,167,378,211,-47,23,-70,-18
"47900",47894,51683,"Manassas city, VA","County or equivalent",2003,36670,389,555,753,198,-134,164,-298,-32
"47900",47894,51685,"Manassas Park city, VA","County or equivalent",2003,10878,29,191,218,27,-160,60,-220,-2
"47900",47894,54037,"Jefferson County, WV","County or equivalent",2003,45954,1269,206,577,371,1057,10,1047,6
"47940",NA,NA,"Waterloo-Cedar Falls, IA","Metropolitan Statistical Area",2003,161616,-517,502,1932,1430,-869,345,-1214,-150
"47940",NA,19013,"Black Hawk County, IA","County or equivalent",2003,126090,-532,507,1574,1067,-934,341,-1275,-105
"47940",NA,19017,"Bremer County, IA","County or equivalent",2003,23283,77,34,239,205,71,6,65,-28
"47940",NA,19075,"Grundy County, IA","County or equivalent",2003,12243,-62,-39,119,158,-6,-2,-4,-17
"48140",NA,NA,"Wausau, WI","Metropolitan Statistical Area",2003,126418,105,568,1561,993,-295,87,-382,-168
"48140",NA,55073,"Marathon County, WI","County or equivalent",2003,126418,105,568,1561,993,-295,87,-382,-168
"48260",NA,NA,"Weirton-Steubenville, WV-OH","Metropolitan Statistical Area",2003,127789,-1096,-421,1302,1723,-517,5,-522,-158
"48260",NA,39081,"Jefferson County, OH","County or equivalent",2003,71396,-561,-262,724,986,-207,12,-219,-92
"48260",NA,54009,"Brooke County, WV","County or equivalent",2003,24813,-166,-84,227,311,-49,-4,-45,-33
"48260",NA,54029,"Hancock County, WV","County or equivalent",2003,31580,-369,-75,351,426,-261,-3,-258,-33
"48300",NA,NA,"Wenatchee, WA","Metropolitan Statistical Area",2003,100622,781,515,1367,852,400,390,10,-134
"48300",NA,53007,"Chelan County, WA","County or equivalent",2003,67277,421,335,912,577,173,262,-89,-87
"48300",NA,53017,"Douglas County, WA","County or equivalent",2003,33345,360,180,455,275,227,128,99,-47
"48540",NA,NA,"Wheeling, WV-OH","Metropolitan Statistical Area",2003,149441,-1219,-427,1454,1881,-612,27,-639,-180
"48540",NA,39013,"Belmont County, OH","County or equivalent",2003,69261,-396,-242,671,913,-53,9,-62,-101
"48540",NA,54051,"Marshall County, WV","County or equivalent",2003,34609,-218,-44,325,369,-128,0,-128,-46
"48540",NA,54069,"Ohio County, WV","County or equivalent",2003,45571,-605,-141,458,599,-431,18,-449,-33
"48620",NA,NA,"Wichita, KS","Metropolitan Statistical Area",2003,579771,1189,4040,9064,5024,-2215,777,-2992,-636
"48620",NA,20015,"Butler County, KS","County or equivalent",2003,60510,378,200,710,510,248,15,233,-70
"48620",NA,20079,"Harvey County, KS","County or equivalent",2003,33273,108,86,444,358,70,43,27,-48
"48620",NA,20173,"Sedgwick County, KS","County or equivalent",2003,460966,1041,3744,7601,3857,-2197,719,-2916,-506
"48620",NA,20191,"Sumner County, KS","County or equivalent",2003,25022,-338,10,309,299,-336,0,-336,-12
"48660",NA,NA,"Wichita Falls, TX","Metropolitan Statistical Area",2003,150728,452,625,2076,1451,-49,-1182,1133,-124
"48660",NA,48009,"Archer County, TX","County or equivalent",2003,8930,53,30,97,67,33,-2,35,-10
"48660",NA,48077,"Clay County, TX","County or equivalent",2003,11313,-12,-11,96,107,12,-7,19,-13
"48660",NA,48485,"Wichita County, TX","County or equivalent",2003,130485,411,606,1883,1277,-94,-1173,1079,-101
"48700",NA,NA,"Williamsport, PA","Metropolitan Statistical Area",2003,118238,-281,56,1297,1241,-175,-2,-173,-162
"48700",NA,42081,"Lycoming County, PA","County or equivalent",2003,118238,-281,56,1297,1241,-175,-2,-173,-162
"48900",NA,NA,"Wilmington, NC","Metropolitan Statistical Area",2003,294213,6081,798,3348,2550,5334,231,5103,-51
"48900",NA,37019,"Brunswick County, NC","County or equivalent",2003,80901,2373,102,856,754,2212,38,2174,59
"48900",NA,37129,"New Hanover County, NC","County or equivalent",2003,170167,3144,592,2026,1434,2630,144,2486,-78
"48900",NA,37141,"Pender County, NC","County or equivalent",2003,43145,564,104,466,362,492,49,443,-32
"49020",NA,NA,"Winchester, VA-WV","Metropolitan Statistical Area",2003,110276,2082,518,1429,911,1585,138,1447,-21
"49020",NA,51069,"Frederick County, VA","County or equivalent",2003,64549,1762,390,809,419,1364,30,1334,8
"49020",NA,51840,"Winchester city, VA","County or equivalent",2003,24654,48,84,372,288,-16,107,-123,-20
"49020",NA,54027,"Hampshire County, WV","County or equivalent",2003,21073,272,44,248,204,237,1,236,-9
"49180",NA,NA,"Winston-Salem, NC","Metropolitan Statistical Area",2003,435045,2625,1975,5918,3943,1286,1398,-112,-636
"49180",NA,37059,"Davie County, NC","County or equivalent",2003,36935,412,56,397,341,397,64,333,-41
"49180",NA,37067,"Forsyth County, NC","County or equivalent",2003,316106,2209,1790,4559,2769,900,1223,-323,-481
"49180",NA,37169,"Stokes County, NC","County or equivalent",2003,44889,67,76,506,430,59,35,24,-68
"49180",NA,37197,"Yadkin County, NC","County or equivalent",2003,37115,-63,53,456,403,-70,76,-146,-46
"49340",NA,NA,"Worcester, MA","Metropolitan Statistical Area",2003,772514,4980,3236,10053,6817,2852,2184,668,-1108
"49340",NA,25027,"Worcester County, MA","County or equivalent",2003,772514,4980,3236,10053,6817,2852,2184,668,-1108
"49420",NA,NA,"Yakima, WA","Metropolitan Statistical Area",2003,225046,1561,2290,3995,1705,-484,953,-1437,-245
"49420",NA,53077,"Yakima County, WA","County or equivalent",2003,225046,1561,2290,3995,1705,-484,953,-1437,-245
"49620",NA,NA,"York-Hanover, PA","Metropolitan Statistical Area",2003,393359,4651,1319,4611,3292,3658,212,3446,-326
"49620",NA,42133,"York County, PA","County or equivalent",2003,393359,4651,1319,4611,3292,3658,212,3446,-326
"49660",NA,NA,"Youngstown-Warren-Boardman, OH-PA","Metropolitan Statistical Area",2003,589898,-3851,-504,6211,6715,-2651,143,-2794,-696
"49660",NA,39099,"Mahoning County, OH","County or equivalent",2003,250399,-1805,-419,2558,2977,-1079,93,-1172,-307
"49660",NA,39155,"Trumbull County, OH","County or equivalent",2003,220385,-1857,9,2415,2406,-1651,33,-1684,-215
"49660",NA,42085,"Mercer County, PA","County or equivalent",2003,119114,-189,-94,1238,1332,79,17,62,-174
"49700",NA,NA,"Yuba City, CA","Metropolitan Statistical Area",2003,147513,3362,1296,2552,1256,2141,215,1926,-75
"49700",NA,6101,"Sutter County, CA","County or equivalent",2003,84062,2299,625,1334,709,1707,412,1295,-33
"49700",NA,6115,"Yuba County, CA","County or equivalent",2003,63451,1063,671,1218,547,434,-197,631,-42
"49740",NA,NA,"Yuma, AZ","Metropolitan Statistical Area",2003,169272,3175,1995,3133,1138,1347,376,971,-167
"49740",NA,4027,"Yuma County, AZ","County or equivalent",2003,169272,3175,1995,3133,1138,1347,376,971,-167
" ",NA,NA,"","",2003,NA,NA,NA,NA,NA,NA,NA,NA,NA
" ",NA,NA,"Micropolitan Statistical Area","",2003,NA,NA,NA,NA,NA,NA,NA,NA,NA
" ",NA,NA,"","",2003,NA,NA,NA,NA,NA,NA,NA,NA,NA
"10020",NA,NA,"Abbeville, LA","Micropolitan Statistical Area",2003,54131,-69,256,809,553,-266,42,-308,-59
"10020",NA,22113,"Vermilion Parish, LA","County or equivalent",2003,54131,-69,256,809,553,-266,42,-308,-59
"10100",NA,NA,"Aberdeen, SD","Micropolitan Statistical Area",2003,39014,-107,150,518,368,-217,8,-225,-40
"10100",NA,46013,"Brown County, SD","County or equivalent",2003,34847,-60,158,483,325,-181,7,-188,-37
"10100",NA,46045,"Edmunds County, SD","County or equivalent",2003,4167,-47,-8,35,43,-36,1,-37,-3
"10140",NA,NA,"Aberdeen, WA","Micropolitan Statistical Area",2003,69020,720,103,856,753,673,76,597,-56
"10140",NA,53027,"Grays Harbor County, WA","County or equivalent",2003,69020,720,103,856,753,673,76,597,-56
"10220",NA,NA,"Ada, OK","Micropolitan Statistical Area",2003,35164,135,76,500,424,107,12,95,-48
"10220",NA,40123,"Pontotoc County, OK","County or equivalent",2003,35164,135,76,500,424,107,12,95,-48
"10300",NA,NA,"Adrian, MI","Micropolitan Statistical Area",2003,100491,306,383,1250,867,74,38,36,-151
"10300",NA,26091,"Lenawee County, MI","County or equivalent",2003,100491,306,383,1250,867,74,38,36,-151
"10460",NA,NA,"Alamogordo, NM","Micropolitan Statistical Area",2003,62201,723,374,858,484,397,-231,628,-48
"10460",NA,35035,"Otero County, NM","County or equivalent",2003,62201,723,374,858,484,397,-231,628,-48
"10540",NA,NA,"Albany-Lebanon, OR","Micropolitan Statistical Area",2003,106132,1474,388,1351,963,1174,86,1088,-88
"10540",NA,41043,"Linn County, OR","County or equivalent",2003,106132,1474,388,1351,963,1174,86,1088,-88
"10620",NA,NA,"Albemarle, NC","Micropolitan Statistical Area",2003,58432,-75,135,729,594,-140,78,-218,-70
"10620",NA,37167,"Stanly County, NC","County or equivalent",2003,58432,-75,135,729,594,-140,78,-218,-70
"10660",NA,NA,"Albert Lea, MN","Micropolitan Statistical Area",2003,31894,-81,-28,359,387,-13,31,-44,-40
"10660",NA,27047,"Freeborn County, MN","County or equivalent",2003,31894,-81,-28,359,387,-13,31,-44,-40
"10700",NA,NA,"Albertville, AL","Micropolitan Statistical Area",2003,83407,588,368,1304,936,332,218,114,-112
"10700",NA,1095,"Marshall County, AL","County or equivalent",2003,83407,588,368,1304,936,332,218,114,-112
"10760",NA,NA,"Alexander City, AL","Micropolitan Statistical Area",2003,52106,-370,-29,594,623,-283,-4,-279,-58
"10760",NA,1037,"Coosa County, AL","County or equivalent",2003,11444,-114,-4,121,125,-97,-1,-96,-13
"10760",NA,1123,"Tallapoosa County, AL","County or equivalent",2003,40662,-256,-25,473,498,-186,-3,-183,-45
"10820",NA,NA,"Alexandria, MN","Micropolitan Statistical Area",2003,34160,509,18,362,344,509,1,508,-18
"10820",NA,27041,"Douglas County, MN","County or equivalent",2003,34160,509,18,362,344,509,1,508,-18
"10860",NA,NA,"Alice, TX","Micropolitan Statistical Area",2003,40108,197,256,598,342,-2,13,-15,-57
"10860",NA,48249,"Jim Wells County, TX","County or equivalent",2003,40108,197,256,598,342,-2,13,-15,-57
"10880",NA,NA,"Allegan, MI","Micropolitan Statistical Area",2003,109891,1112,689,1466,777,566,94,472,-143
"10880",NA,26005,"Allegan County, MI","County or equivalent",2003,109891,1112,689,1466,777,566,94,472,-143
"10940",NA,NA,"Alma, MI","Micropolitan Statistical Area",2003,42343,21,-4,467,471,84,8,76,-59
"10940",NA,26057,"Gratiot County, MI","County or equivalent",2003,42343,21,-4,467,471,84,8,76,-59
"10980",NA,NA,"Alpena, MI","Micropolitan Statistical Area",2003,30638,-208,-39,296,335,-133,-5,-128,-36
"10980",NA,26007,"Alpena County, MI","County or equivalent",2003,30638,-208,-39,296,335,-133,-5,-128,-36
"11060",NA,NA,"Altus, OK","Micropolitan Statistical Area",2003,27189,-153,191,456,265,-306,-228,-78,-38
"11060",NA,40065,"Jackson County, OK","County or equivalent",2003,27189,-153,191,456,265,-306,-228,-78,-38
"11140",NA,NA,"Americus, GA","Micropolitan Statistical Area",2003,36796,-91,97,521,424,-146,32,-178,-42
"11140",NA,13249,"Schley County, GA","County or equivalent",2003,3792,-4,28,66,38,-28,2,-30,-4
"11140",NA,13261,"Sumter County, GA","County or equivalent",2003,33004,-87,69,455,386,-118,30,-148,-38
"11220",NA,NA,"Amsterdam, NY","Micropolitan Statistical Area",2003,48949,-63,-51,600,651,58,11,47,-70
"11220",NA,36057,"Montgomery County, NY","County or equivalent",2003,48949,-63,-51,600,651,58,11,47,-70
"11380",NA,NA,"Andrews, TX","Micropolitan Statistical Area",2003,12789,-81,100,206,106,-173,12,-185,-8
"11380",NA,48003,"Andrews County, TX","County or equivalent",2003,12789,-81,100,206,106,-173,12,-185,-8
"11420",NA,NA,"Angola, IN","Micropolitan Statistical Area",2003,33542,200,177,433,256,71,20,51,-48
"11420",NA,18151,"Steuben County, IN","County or equivalent",2003,33542,200,177,433,256,71,20,51,-48
"11580",NA,NA,"Arcadia, FL","Micropolitan Statistical Area",2003,33434,836,140,440,300,712,349,363,-16
"11580",NA,12027,"DeSoto County, FL","County or equivalent",2003,33434,836,140,440,300,712,349,363,-16
"11620",NA,NA,"Ardmore, OK","Micropolitan Statistical Area",2003,54992,316,113,785,672,275,26,249,-72
"11620",NA,40019,"Carter County, OK","County or equivalent",2003,46148,265,101,677,576,227,18,209,-63
"11620",NA,40085,"Love County, OK","County or equivalent",2003,8844,51,12,108,96,48,8,40,-9
"11660",NA,NA,"Arkadelphia, AR","Micropolitan Statistical Area",2003,23274,-263,-4,279,283,-245,22,-267,-14
"11660",NA,5019,"Clark County, AR","County or equivalent",2003,23274,-263,-4,279,283,-245,22,-267,-14
"11740",NA,NA,"Ashland, OH","Micropolitan Statistical Area",2003,53464,413,177,676,499,298,14,284,-62
"11740",NA,39005,"Ashland County, OH","County or equivalent",2003,53464,413,177,676,499,298,14,284,-62
"11780",NA,NA,"Ashtabula, OH","Micropolitan Statistical Area",2003,102453,-144,94,1188,1094,-98,34,-132,-140
"11780",NA,39007,"Ashtabula County, OH","County or equivalent",2003,102453,-144,94,1188,1094,-98,34,-132,-140
"11820",NA,NA,"Astoria, OR","Micropolitan Statistical Area",2003,35788,181,18,408,390,198,-19,217,-35
"11820",NA,41007,"Clatsop County, OR","County or equivalent",2003,35788,181,18,408,390,198,-19,217,-35
"11860",NA,NA,"Atchison, KS","Micropolitan Statistical Area",2003,16697,-6,17,207,190,1,5,-4,-24
"11860",NA,20005,"Atchison County, KS","County or equivalent",2003,16697,-6,17,207,190,1,5,-4,-24
"11900",NA,NA,"Athens, OH","Micropolitan Statistical Area",2003,63270,218,150,612,462,163,138,25,-95
"11900",NA,39009,"Athens County, OH","County or equivalent",2003,63270,218,150,612,462,163,138,25,-95
"11940",NA,NA,"Athens, TN","Micropolitan Statistical Area",2003,50240,212,55,598,543,218,25,193,-61
"11940",NA,47107,"McMinn County, TN","County or equivalent",2003,50240,212,55,598,543,218,25,193,-61
"11980",NA,NA,"Athens, TX","Micropolitan Statistical Area",2003,76731,1667,76,967,891,1571,83,1488,20
"11980",NA,48213,"Henderson County, TX","County or equivalent",2003,76731,1667,76,967,891,1571,83,1488,20
"12140",NA,NA,"Auburn, IN","Micropolitan Statistical Area",2003,40918,297,231,572,341,124,15,109,-58
"12140",NA,18033,"DeKalb County, IN","County or equivalent",2003,40918,297,231,572,341,124,15,109,-58
"12180",NA,NA,"Auburn, NY","Micropolitan Statistical Area",2003,81097,-156,65,784,719,-107,22,-129,-114
"12180",NA,36011,"Cayuga County, NY","County or equivalent",2003,81097,-156,65,784,719,-107,22,-129,-114
"12300",NA,NA,"Augusta-Waterville, ME","Micropolitan Statistical Area",2003,119147,725,-5,1168,1173,840,11,829,-110
"12300",NA,23011,"Kennebec County, ME","County or equivalent",2003,119147,725,-5,1168,1173,840,11,829,-110
"12380",NA,NA,"Austin, MN","Micropolitan Statistical Area",2003,38429,-54,142,527,385,-150,80,-230,-46
"12380",NA,27099,"Mower County, MN","County or equivalent",2003,38429,-54,142,527,385,-150,80,-230,-46
"12460",NA,NA,"Bainbridge, GA","Micropolitan Statistical Area",2003,28044,-16,107,408,301,-84,40,-124,-39
"12460",NA,13087,"Decatur County, GA","County or equivalent",2003,28044,-16,107,408,301,-84,40,-124,-39
"12660",NA,NA,"Baraboo, WI","Micropolitan Statistical Area",2003,56248,456,216,699,483,302,18,284,-62
"12660",NA,55111,"Sauk County, WI","County or equivalent",2003,56248,456,216,699,483,302,18,284,-62
"12740",NA,NA,"Barre, VT","Micropolitan Statistical Area",2003,58697,-32,167,644,477,-115,49,-164,-84
"12740",NA,50023,"Washington County, VT","County or equivalent",2003,58697,-32,167,644,477,-115,49,-164,-84
"12780",NA,NA,"Bartlesville, OK","Micropolitan Statistical Area",2003,48845,-108,-19,585,604,-24,61,-85,-65
"12780",NA,40147,"Washington County, OK","County or equivalent",2003,48845,-108,-19,585,604,-24,61,-85,-65
"12820",NA,NA,"Bastrop, LA","Micropolitan Statistical Area",2003,30263,-98,37,435,398,-98,2,-100,-37
"12820",NA,22067,"Morehouse Parish, LA","County or equivalent",2003,30263,-98,37,435,398,-98,2,-100,-37
"12860",NA,NA,"Batavia, NY","Micropolitan Statistical Area",2003,59526,-135,78,687,609,-135,19,-154,-78
"12860",NA,36037,"Genesee County, NY","County or equivalent",2003,59526,-135,78,687,609,-135,19,-154,-78
"12900",NA,NA,"Batesville, AR","Micropolitan Statistical Area",2003,34109,-21,66,451,385,-35,14,-49,-52
"12900",NA,5063,"Independence County, AR","County or equivalent",2003,34109,-21,66,451,385,-35,14,-49,-52
"13060",NA,NA,"Bay City, TX","Micropolitan Statistical Area",2003,37795,25,183,550,367,-118,139,-257,-40
"13060",NA,48321,"Matagorda County, TX","County or equivalent",2003,37795,25,183,550,367,-118,139,-257,-40
"13100",NA,NA,"Beatrice, NE","Micropolitan Statistical Area",2003,23167,50,0,283,283,76,-1,77,-26
"13100",NA,31067,"Gage County, NE","County or equivalent",2003,23167,50,0,283,283,76,-1,77,-26
"13180",NA,NA,"Beaver Dam, WI","Micropolitan Statistical Area",2003,86834,229,37,959,922,311,27,284,-119
"13180",NA,55027,"Dodge County, WI","County or equivalent",2003,86834,229,37,959,922,311,27,284,-119
"13220",NA,NA,"Beckley, WV","Micropolitan Statistical Area",2003,78604,-250,-134,838,972,-3,12,-15,-113
"13220",NA,54081,"Raleigh County, WV","County or equivalent",2003,78604,-250,-134,838,972,-3,12,-15,-113
"13260",NA,NA,"Bedford, IN","Micropolitan Statistical Area",2003,46019,60,114,552,438,14,8,6,-68
"13260",NA,18093,"Lawrence County, IN","County or equivalent",2003,46019,60,114,552,438,14,8,6,-68
"13300",NA,NA,"Beeville, TX","Micropolitan Statistical Area",2003,32857,884,168,389,221,707,3,704,9
"13300",NA,48025,"Bee County, TX","County or equivalent",2003,32857,884,168,389,221,707,3,704,9
"13340",NA,NA,"Bellefontaine, OH","Micropolitan Statistical Area",2003,46400,186,154,609,455,96,20,76,-64
"13340",NA,39091,"Logan County, OH","County or equivalent",2003,46400,186,154,609,455,96,20,76,-64
"13420",NA,NA,"Bemidji, MN","Micropolitan Statistical Area",2003,41637,582,307,632,325,317,16,301,-42
"13420",NA,27007,"Beltrami County, MN","County or equivalent",2003,41637,582,307,632,325,317,16,301,-42
"13500",NA,NA,"Bennettsville, SC","Micropolitan Statistical Area",2003,28279,-193,28,361,333,-189,0,-189,-32
"13500",NA,45069,"Marlboro County, SC","County or equivalent",2003,28279,-193,28,361,333,-189,0,-189,-32
"13540",NA,NA,"Bennington, VT","Micropolitan Statistical Area",2003,36821,-132,-16,348,364,-68,24,-92,-48
"13540",NA,50003,"Bennington County, VT","County or equivalent",2003,36821,-132,-16,348,364,-68,24,-92,-48
"13620",NA,NA,"Berlin, NH-VT","Micropolitan Statistical Area",2003,39340,-21,-99,362,461,124,7,117,-46
"13620",NA,33007,"Coos County, NH","County or equivalent",2003,32829,-2,-109,300,409,144,6,138,-37
"13620",NA,50009,"Essex County, VT","County or equivalent",2003,6511,-19,10,62,52,-20,1,-21,-9
"13660",NA,NA,"Big Rapids, MI","Micropolitan Statistical Area",2003,41697,279,130,448,318,202,38,164,-53
"13660",NA,26107,"Mecosta County, MI","County or equivalent",2003,41697,279,130,448,318,202,38,164,-53
"13700",NA,NA,"Big Spring, TX","Micropolitan Statistical Area",2003,32602,-367,127,463,336,-482,20,-502,-12
"13700",NA,48227,"Howard County, TX","County or equivalent",2003,32602,-367,127,463,336,-482,20,-502,-12
"13860",NA,NA,"Bishop, CA","Micropolitan Statistical Area",2003,18120,39,-55,187,242,113,26,87,-19
"13860",NA,6027,"Inyo County, CA","County or equivalent",2003,18120,39,-55,187,242,113,26,87,-19
"13940",NA,NA,"Blackfoot, ID","Micropolitan Statistical Area",2003,42361,367,514,804,290,-86,58,-144,-61
"13940",NA,16011,"Bingham County, ID","County or equivalent",2003,42361,367,514,804,290,-86,58,-144,-61
"14100",NA,NA,"Bloomsburg-Berwick, PA","Micropolitan Statistical Area",2003,82537,82,-49,850,899,222,20,202,-91
"14100",NA,42037,"Columbia County, PA","County or equivalent",2003,64477,138,-54,639,693,262,14,248,-70
"14100",NA,42093,"Montour County, PA","County or equivalent",2003,18060,-56,5,211,206,-40,6,-46,-21
"14140",NA,NA,"Bluefield, WV-VA","Micropolitan Statistical Area",2003,105778,-166,-160,1188,1348,148,18,130,-154
"14140",NA,51185,"Tazewell County, VA","County or equivalent",2003,43942,-13,-68,453,521,120,11,109,-65
"14140",NA,54055,"Mercer County, WV","County or equivalent",2003,61836,-153,-92,735,827,28,7,21,-89
"14180",NA,NA,"Blytheville, AR","Micropolitan Statistical Area",2003,48387,-1476,161,757,596,-1683,20,-1703,46
"14180",NA,5093,"Mississippi County, AR","County or equivalent",2003,48387,-1476,161,757,596,-1683,20,-1703,46
"14220",NA,NA,"Bogalusa, LA","Micropolitan Statistical Area",2003,43690,-76,68,628,560,-89,-4,-85,-55
"14220",NA,22117,"Washington Parish, LA","County or equivalent",2003,43690,-76,68,628,560,-89,-4,-85,-55
"14300",NA,NA,"Bonham, TX","Micropolitan Statistical Area",2003,32053,473,-62,358,420,549,24,525,-14
"14300",NA,48147,"Fannin County, TX","County or equivalent",2003,32053,473,-62,358,420,549,24,525,-14
"14340",NA,NA,"Boone, IA","Micropolitan Statistical Area",2003,26137,93,59,330,271,66,-2,68,-32
"14340",NA,19015,"Boone County, IA","County or equivalent",2003,26137,93,59,330,271,66,-2,68,-32
"14380",NA,NA,"Boone, NC","Micropolitan Statistical Area",2003,43328,-65,78,358,280,-84,43,-127,-59
"14380",NA,37189,"Watauga County, NC","County or equivalent",2003,43328,-65,78,358,280,-84,43,-127,-59
"14420",NA,NA,"Borger, TX","Micropolitan Statistical Area",2003,22602,-421,75,323,248,-496,39,-535,0
"14420",NA,48233,"Hutchinson County, TX","County or equivalent",2003,22602,-421,75,323,248,-496,39,-535,0
"14580",NA,NA,"Bozeman, MT","Micropolitan Statistical Area",2003,74689,2722,611,996,385,2072,70,2002,39
"14580",NA,30031,"Gallatin County, MT","County or equivalent",2003,74689,2722,611,996,385,2072,70,2002,39
"14620",NA,NA,"Bradford, PA","Micropolitan Statistical Area",2003,44814,-537,-59,479,538,-442,0,-442,-36
"14620",NA,42083,"McKean County, PA","County or equivalent",2003,44814,-537,-59,479,538,-442,0,-442,-36
"14660",NA,NA,"Brainerd, MN","Micropolitan Statistical Area",2003,86174,1099,260,1051,791,885,0,885,-46
"14660",NA,27021,"Cass County, MN","County or equivalent",2003,28014,127,25,298,273,122,0,122,-20
"14660",NA,27035,"Crow Wing County, MN","County or equivalent",2003,58160,972,235,753,518,763,0,763,-26
"14700",NA,NA,"Branson, MO","Micropolitan Statistical Area",2003,71406,1175,99,840,741,1091,27,1064,-15
"14700",NA,29209,"Stone County, MO","County or equivalent",2003,29916,588,-9,289,298,592,4,588,5
"14700",NA,29213,"Taney County, MO","County or equivalent",2003,41490,587,108,551,443,499,23,476,-20
"14780",NA,NA,"Brenham, TX","Micropolitan Statistical Area",2003,30859,163,64,401,337,138,57,81,-39
"14780",NA,48477,"Washington County, TX","County or equivalent",2003,30859,163,64,401,337,138,57,81,-39
"14820",NA,NA,"Brevard, NC","Micropolitan Statistical Area",2003,29182,-220,-148,263,411,-40,28,-68,-32
"14820",NA,37175,"Transylvania County, NC","County or equivalent",2003,29182,-220,-148,263,411,-40,28,-68,-32
"14940",NA,NA,"Brigham City, UT","Micropolitan Statistical Area",2003,45213,702,496,800,304,-41,37,-78,247
"14940",NA,49003,"Box Elder County, UT","County or equivalent",2003,45213,702,496,800,304,-41,37,-78,247
"15020",NA,NA,"Brookhaven, MS","Micropolitan Statistical Area",2003,33352,55,69,453,384,34,4,30,-48
"15020",NA,28085,"Lincoln County, MS","County or equivalent",2003,33352,55,69,453,384,34,4,30,-48
"15060",NA,NA,"Brookings, OR","Micropolitan Statistical Area",2003,21500,119,-197,155,352,315,-2,317,1
"15060",NA,41015,"Curry County, OR","County or equivalent",2003,21500,119,-197,155,352,315,-2,317,1
"15100",NA,NA,"Brookings, SD","Micropolitan Statistical Area",2003,28557,49,113,283,170,-23,27,-50,-41
"15100",NA,46011,"Brookings County, SD","County or equivalent",2003,28557,49,113,283,170,-23,27,-50,-41
"15140",NA,NA,"Brownsville, TN","Micropolitan Statistical Area",2003,19459,-79,61,285,224,-117,17,-134,-23
"15140",NA,47075,"Haywood County, TN","County or equivalent",2003,19459,-79,61,285,224,-117,17,-134,-23
"15220",NA,NA,"Brownwood, TX","Micropolitan Statistical Area",2003,37617,-186,-35,468,503,-103,17,-120,-48
"15220",NA,48049,"Brown County, TX","County or equivalent",2003,37617,-186,-35,468,503,-103,17,-120,-48
"15340",NA,NA,"Bucyrus, OH","Micropolitan Statistical Area",2003,45720,-450,53,548,495,-464,1,-465,-39
"15340",NA,39033,"Crawford County, OH","County or equivalent",2003,45720,-450,53,548,495,-464,1,-465,-39
"15420",NA,NA,"Burley, ID","Micropolitan Statistical Area",2003,40274,-403,356,709,353,-757,112,-869,-2
"15420",NA,16031,"Cassia County, ID","County or equivalent",2003,21171,-149,205,391,186,-348,47,-395,-6
"15420",NA,16067,"Minidoka County, ID","County or equivalent",2003,19103,-254,151,318,167,-409,65,-474,4
"15460",NA,NA,"Burlington, IA-IL","Micropolitan Statistical Area",2003,49077,-332,40,563,523,-328,22,-350,-44
"15460",NA,17071,"Henderson County, IL","County or equivalent",2003,7945,-159,-40,61,101,-113,1,-114,-6
"15460",NA,19057,"Des Moines County, IA","County or equivalent",2003,41132,-173,80,502,422,-215,21,-236,-38
"15580",NA,NA,"Butte-Silver Bow, MT","Micropolitan Statistical Area",2003,33053,-295,-14,384,398,-252,1,-253,-29
"15580",NA,30093,"Silver Bow County, MT","County or equivalent",2003,33053,-295,-14,384,398,-252,1,-253,-29
"15620",NA,NA,"Cadillac, MI","Micropolitan Statistical Area",2003,46099,508,104,561,457,436,8,428,-32
"15620",NA,26113,"Missaukee County, MI","County or equivalent",2003,15012,174,36,172,136,149,-2,151,-11
"15620",NA,26165,"Wexford County, MI","County or equivalent",2003,31087,334,68,389,321,287,10,277,-21
"15660",NA,NA,"Calhoun, GA","Micropolitan Statistical Area",2003,47503,964,395,751,356,611,177,434,-42
"15660",NA,13129,"Gordon County, GA","County or equivalent",2003,47503,964,395,751,356,611,177,434,-42
"15700",NA,NA,"Cambridge, MD","Micropolitan Statistical Area",2003,30465,32,-77,321,398,142,0,142,-33
"15700",NA,24019,"Dorchester County, MD","County or equivalent",2003,30465,32,-77,321,398,142,0,142,-33
"15740",NA,NA,"Cambridge, OH","Micropolitan Statistical Area",2003,41050,98,90,516,426,63,-2,65,-55
"15740",NA,39059,"Guernsey County, OH","County or equivalent",2003,41050,98,90,516,426,63,-2,65,-55
"15780",NA,NA,"Camden, AR","Micropolitan Statistical Area",2003,32882,-329,-88,389,477,-202,14,-216,-39
"15780",NA,5013,"Calhoun County, AR","County or equivalent",2003,5563,-41,-17,54,71,-16,6,-22,-8
"15780",NA,5103,"Ouachita County, AR","County or equivalent",2003,27319,-288,-71,335,406,-186,8,-194,-31
"15820",NA,NA,"Campbellsville, KY","Micropolitan Statistical Area",2003,23312,32,27,279,252,41,4,37,-36
"15820",NA,21217,"Taylor County, KY","County or equivalent",2003,23312,32,27,279,252,41,4,37,-36
"15860",NA,NA,"Canon City, CO","Micropolitan Statistical Area",2003,47120,-83,-112,420,532,94,6,88,-65
"15860",NA,8043,"Fremont County, CO","County or equivalent",2003,47120,-83,-112,420,532,94,6,88,-65
"15900",NA,NA,"Canton, IL","Micropolitan Statistical Area",2003,37521,28,-80,395,475,153,-3,156,-45
"15900",NA,17057,"Fulton County, IL","County or equivalent",2003,37521,28,-80,395,475,153,-3,156,-45
"16020",NA,NA,"Cape Girardeau-Jackson, MO-IL","Micropolitan Statistical Area",2003,91041,-103,279,1136,857,-274,21,-295,-108
"16020",NA,17003,"Alexander County, IL","County or equivalent",2003,9040,-360,14,144,130,-389,1,-390,15
"16020",NA,29017,"Bollinger County, MO","County or equivalent",2003,12213,-36,46,144,98,-64,-1,-63,-18
"16020",NA,29031,"Cape Girardeau County, MO","County or equivalent",2003,69788,293,219,848,629,179,21,158,-105
"16060",NA,NA,"Carbondale, IL","Micropolitan Statistical Area",2003,58736,169,228,680,452,15,217,-202,-74
"16060",NA,17077,"Jackson County, IL","County or equivalent",2003,58736,169,228,680,452,15,217,-202,-74
"16100",NA,NA,"Carlsbad-Artesia, NM","Micropolitan Statistical Area",2003,50700,-105,181,737,556,-224,34,-258,-62
"16100",NA,35015,"Eddy County, NM","County or equivalent",2003,50700,-105,181,737,556,-224,34,-258,-62
"16260",NA,NA,"Cedar City, UT","Micropolitan Statistical Area",2003,36077,420,576,780,204,-117,55,-172,-39
"16260",NA,49021,"Iron County, UT","County or equivalent",2003,36077,420,576,780,204,-117,55,-172,-39
"16340",NA,NA,"Cedartown, GA","Micropolitan Statistical Area",2003,39562,196,197,652,455,55,125,-70,-56
"16340",NA,13233,"Polk County, GA","County or equivalent",2003,39562,196,197,652,455,55,125,-70,-56
"16380",NA,NA,"Celina, OH","Micropolitan Statistical Area",2003,40715,-60,152,533,381,-165,9,-174,-47
"16380",NA,39107,"Mercer County, OH","County or equivalent",2003,40715,-60,152,533,381,-165,9,-174,-47
"16420",NA,NA,"Central City, KY","Micropolitan Statistical Area",2003,31463,-92,-56,357,413,10,-3,13,-46
"16420",NA,21177,"Muhlenberg County, KY","County or equivalent",2003,31463,-92,-56,357,413,10,-3,13,-46
"16460",NA,NA,"Centralia, IL","Micropolitan Statistical Area",2003,40462,-435,-33,501,534,-375,-3,-372,-27
"16460",NA,17121,"Marion County, IL","County or equivalent",2003,40462,-435,-33,501,534,-375,-3,-372,-27
"16500",NA,NA,"Centralia, WA","Micropolitan Statistical Area",2003,70112,778,131,849,718,719,92,627,-72
"16500",NA,53041,"Lewis County, WA","County or equivalent",2003,70112,778,131,849,718,719,92,627,-72
"16540",NA,NA,"Chambersburg, PA","Micropolitan Statistical Area",2003,132380,1155,328,1618,1290,956,90,866,-129
"16540",NA,42055,"Franklin County, PA","County or equivalent",2003,132380,1155,328,1618,1290,956,90,866,-129
"16660",NA,NA,"Charleston-Mattoon, IL","Micropolitan Statistical Area",2003,63283,198,39,682,643,219,29,190,-60
"16660",NA,17029,"Coles County, IL","County or equivalent",2003,52365,336,49,561,512,339,27,312,-52
"16660",NA,17035,"Cumberland County, IL","County or equivalent",2003,10918,-138,-10,121,131,-120,2,-122,-8
"16900",NA,NA,"Chester, SC","Micropolitan Statistical Area",2003,33601,-266,104,432,328,-334,11,-345,-36
"16900",NA,45023,"Chester County, SC","County or equivalent",2003,33601,-266,104,432,328,-334,11,-345,-36
"17060",NA,NA,"Chillicothe, OH","Micropolitan Statistical Area",2003,74305,410,116,877,761,378,20,358,-84
"17060",NA,39141,"Ross County, OH","County or equivalent",2003,74305,410,116,877,761,378,20,358,-84
"17180",NA,NA,"City of The Dalles, OR","Micropolitan Statistical Area",2003,23560,69,6,278,272,99,27,72,-36
"17180",NA,41065,"Wasco County, OR","County or equivalent",2003,23560,69,6,278,272,99,27,72,-36
"17200",NA,NA,"Claremont, NH","Micropolitan Statistical Area",2003,41729,541,74,468,394,488,15,473,-21
"17200",NA,33019,"Sullivan County, NH","County or equivalent",2003,41729,541,74,468,394,488,15,473,-21
"17220",NA,NA,"Clarksburg, WV","Micropolitan Statistical Area",2003,91136,-98,-145,1003,1148,173,20,153,-126
"17220",NA,54017,"Doddridge County, WV","County or equivalent",2003,7438,5,0,64,64,14,-1,15,-9
"17220",NA,54033,"Harrison County, WV","County or equivalent",2003,67714,-99,-118,774,892,114,22,92,-95
"17220",NA,54091,"Taylor County, WV","County or equivalent",2003,15984,-4,-27,165,192,45,-1,46,-22
"17260",NA,NA,"Clarksdale, MS","Micropolitan Statistical Area",2003,29281,-556,168,510,342,-730,7,-737,6
"17260",NA,28027,"Coahoma County, MS","County or equivalent",2003,29281,-556,168,510,342,-730,7,-737,6
"17340",NA,NA,"Clearlake, CA","Micropolitan Statistical Area",2003,62679,1022,-73,681,754,1091,86,1005,4
"17340",NA,6033,"Lake County, CA","County or equivalent",2003,62679,1022,-73,681,754,1091,86,1005,4
"17380",NA,NA,"Cleveland, MS","Micropolitan Statistical Area",2003,38830,-380,197,588,391,-554,4,-558,-23
"17380",NA,28011,"Bolivar County, MS","County or equivalent",2003,38830,-380,197,588,391,-554,4,-558,-23
"17500",NA,NA,"Clewiston, FL","Micropolitan Statistical Area",2003,36349,140,394,674,280,-244,351,-595,-10
"17500",NA,12051,"Hendry County, FL","County or equivalent",2003,36349,140,394,674,280,-244,351,-595,-10
"17540",NA,NA,"Clinton, IA","Micropolitan Statistical Area",2003,49471,-129,15,566,551,-82,29,-111,-62
"17540",NA,19045,"Clinton County, IA","County or equivalent",2003,49471,-129,15,566,551,-82,29,-111,-62
"17580",NA,NA,"Clovis, NM","Micropolitan Statistical Area",2003,44959,311,494,866,372,-131,-310,179,-52
"17580",NA,35009,"Curry County, NM","County or equivalent",2003,44959,311,494,866,372,-131,-310,179,-52
"17700",NA,NA,"Coffeyville, KS","Micropolitan Statistical Area",2003,34666,-499,-23,454,477,-459,15,-474,-17
"17700",NA,20125,"Montgomery County, KS","County or equivalent",2003,34666,-499,-23,454,477,-459,15,-474,-17
"17740",NA,NA,"Coldwater, MI","Micropolitan Statistical Area",2003,46434,-82,165,599,434,-193,66,-259,-54
"17740",NA,26023,"Branch County, MI","County or equivalent",2003,46434,-82,165,599,434,-193,66,-259,-54
"17940",NA,NA,"Columbia, TN","Micropolitan Statistical Area",2003,72656,1448,301,998,697,1178,89,1089,-31
"17940",NA,47119,"Maury County, TN","County or equivalent",2003,72656,1448,301,998,697,1178,89,1089,-31
"18060",NA,NA,"Columbus, MS","Micropolitan Statistical Area",2003,60215,-465,323,874,551,-739,-185,-554,-49
"18060",NA,28087,"Lowndes County, MS","County or equivalent",2003,60215,-465,323,874,551,-739,-185,-554,-49
"18100",NA,NA,"Columbus, NE","Micropolitan Statistical Area",2003,30912,-147,194,454,260,-319,50,-369,-22
"18100",NA,31141,"Platte County, NE","County or equivalent",2003,30912,-147,194,454,260,-319,50,-369,-22
"18180",NA,NA,"Concord, NH","Micropolitan Statistical Area",2003,143203,1799,325,1504,1179,1582,122,1460,-108
"18180",NA,33013,"Merrimack County, NH","County or equivalent",2003,143203,1799,325,1504,1179,1582,122,1460,-108
"18220",NA,NA,"Connersville, IN","Micropolitan Statistical Area",2003,24885,-176,7,313,306,-153,0,-153,-30
"18220",NA,18041,"Fayette County, IN","County or equivalent",2003,24885,-176,7,313,306,-153,0,-153,-30
"18260",NA,NA,"Cookeville, TN","Micropolitan Statistical Area",2003,96099,636,111,1180,1069,633,124,509,-108
"18260",NA,47087,"Jackson County, TN","County or equivalent",2003,11075,-14,-35,94,129,34,3,31,-13
"18260",NA,47133,"Overton County, TN","County or equivalent",2003,20064,-149,-72,210,282,-50,-2,-48,-27
"18260",NA,47141,"Putnam County, TN","County or equivalent",2003,64960,799,218,876,658,649,123,526,-68
"18300",NA,NA,"Coos Bay, OR","Micropolitan Statistical Area",2003,62543,293,-230,653,883,578,5,573,-55
"18300",NA,41011,"Coos County, OR","County or equivalent",2003,62543,293,-230,653,883,578,5,573,-55
"18340",NA,NA,"Corbin, KY","Micropolitan Statistical Area",2003,36981,308,113,528,415,235,8,227,-40
"18340",NA,21235,"Whitley County, KY","County or equivalent",2003,36981,308,113,528,415,235,8,227,-40
"18380",NA,NA,"Cordele, GA","Micropolitan Statistical Area",2003,21735,-244,72,315,243,-311,31,-342,-5
"18380",NA,13081,"Crisp County, GA","County or equivalent",2003,21735,-244,72,315,243,-311,31,-342,-5
"18420",NA,NA,"Corinth, MS","Micropolitan Statistical Area",2003,34692,-51,30,441,411,-30,13,-43,-51
"18420",NA,28003,"Alcorn County, MS","County or equivalent",2003,34692,-51,30,441,411,-30,13,-43,-51
"18460",NA,NA,"Cornelia, GA","Micropolitan Statistical Area",2003,38183,621,144,535,391,508,107,401,-31
"18460",NA,13137,"Habersham County, GA","County or equivalent",2003,38183,621,144,535,391,508,107,401,-31
"18500",NA,NA,"Corning, NY","Micropolitan Statistical Area",2003,98277,-730,127,1157,1030,-772,38,-810,-85
"18500",NA,36101,"Steuben County, NY","County or equivalent",2003,98277,-730,127,1157,1030,-772,38,-810,-85
"18620",NA,NA,"Corsicana, TX","Micropolitan Statistical Area",2003,47050,402,250,736,486,222,215,7,-70
"18620",NA,48349,"Navarro County, TX","County or equivalent",2003,47050,402,250,736,486,222,215,7,-70
"18660",NA,NA,"Cortland, NY","Micropolitan Statistical Area",2003,48825,400,104,564,460,343,26,317,-47
"18660",NA,36023,"Cortland County, NY","County or equivalent",2003,48825,400,104,564,460,343,26,317,-47
"18740",NA,NA,"Coshocton, OH","Micropolitan Statistical Area",2003,36842,-14,28,460,432,12,26,-14,-54
"18740",NA,39031,"Coshocton County, OH","County or equivalent",2003,36842,-14,28,460,432,12,26,-14,-54
"18820",NA,NA,"Crawfordsville, IN","Micropolitan Statistical Area",2003,37467,-260,100,445,345,-332,41,-373,-28
"18820",NA,18107,"Montgomery County, IN","County or equivalent",2003,37467,-260,100,445,345,-332,41,-373,-28
"18860",NA,NA,"Crescent City, CA","Micropolitan Statistical Area",2003,27736,244,38,291,253,233,46,187,-27
"18860",NA,6015,"Del Norte County, CA","County or equivalent",2003,27736,244,38,291,253,233,46,187,-27
"18900",NA,NA,"Crossville, TN","Micropolitan Statistical Area",2003,49092,494,-63,535,598,581,5,576,-24
"18900",NA,47035,"Cumberland County, TN","County or equivalent",2003,49092,494,-63,535,598,581,5,576,-24
"18940",NA,NA,"Crowley, LA","Micropolitan Statistical Area",2003,58747,-56,309,885,576,-296,5,-301,-69
"18940",NA,22001,"Acadia Parish, LA","County or equivalent",2003,58747,-56,309,885,576,-296,5,-301,-69
"18980",NA,NA,"Cullman, AL","Micropolitan Statistical Area",2003,78062,272,46,932,886,333,71,262,-107
"18980",NA,1043,"Cullman County, AL","County or equivalent",2003,78062,272,46,932,886,333,71,262,-107
"19020",NA,NA,"Culpeper, VA","Micropolitan Statistical Area",2003,38128,1484,201,503,302,1247,59,1188,36
"19020",NA,51047,"Culpeper County, VA","County or equivalent",2003,38128,1484,201,503,302,1247,59,1188,36
"19220",NA,NA,"Danville, KY","Micropolitan Statistical Area",2003,52023,391,66,597,531,383,50,333,-58
"19220",NA,21021,"Boyle County, KY","County or equivalent",2003,27779,112,1,300,299,148,38,110,-37
"19220",NA,21137,"Lincoln County, KY","County or equivalent",2003,24244,279,65,297,232,235,12,223,-21
"19300",NA,NA,"Daphne-Fairhope-Foley, AL","Micropolitan Statistical Area",2003,151502,3471,323,1795,1472,3040,109,2931,108
"19300",NA,1003,"Baldwin County, AL","County or equivalent",2003,151502,3471,323,1795,1472,3040,109,2931,108
"19540",NA,NA,"Decatur, IN","Micropolitan Statistical Area",2003,33675,178,343,638,295,-123,9,-132,-42
"19540",NA,18001,"Adams County, IN","County or equivalent",2003,33675,178,343,638,295,-123,9,-132,-42
"19580",NA,NA,"Defiance, OH","Micropolitan Statistical Area",2003,38924,-205,188,511,323,-360,11,-371,-33
"19580",NA,39039,"Defiance County, OH","County or equivalent",2003,38924,-205,188,511,323,-360,11,-371,-33
"19620",NA,NA,"Del Rio, TX","Micropolitan Statistical Area",2003,46292,821,669,948,279,216,-10,226,-64
"19620",NA,48465,"Val Verde County, TX","County or equivalent",2003,46292,821,669,948,279,216,-10,226,-64
"19700",NA,NA,"Deming, NM","Micropolitan Statistical Area",2003,25337,286,151,388,237,168,141,27,-33
"19700",NA,35029,"Luna County, NM","County or equivalent",2003,25337,286,151,388,237,168,141,27,-33
"19760",NA,NA,"De Ridder, LA","Micropolitan Statistical Area",2003,33317,236,122,426,304,150,-20,170,-36
"19760",NA,22011,"Beauregard Parish, LA","County or equivalent",2003,33317,236,122,426,304,150,-20,170,-36
"19860",NA,NA,"Dickinson, ND","Micropolitan Statistical Area",2003,22923,-90,71,280,209,-138,8,-146,-23
"19860",NA,38007,"Billings County, ND","County or equivalent",2003,830,-30,0,8,8,-31,2,-33,1
"19860",NA,38089,"Stark County, ND","County or equivalent",2003,22093,-60,71,272,201,-107,6,-113,-24
"19900",NA,NA,"Dillon, SC","Micropolitan Statistical Area",2003,30764,-29,146,491,345,-138,12,-150,-37
"19900",NA,45033,"Dillon County, SC","County or equivalent",2003,30764,-29,146,491,345,-138,12,-150,-37
"19940",NA,NA,"Dixon, IL","Micropolitan Statistical Area",2003,35105,-378,-12,365,377,-341,14,-355,-25
"19940",NA,17103,"Lee County, IL","County or equivalent",2003,35105,-378,-12,365,377,-341,14,-355,-25
"19980",NA,NA,"Dodge City, KS","Micropolitan Statistical Area",2003,32558,394,402,666,264,20,368,-348,-28
"19980",NA,20057,"Ford County, KS","County or equivalent",2003,32558,394,402,666,264,20,368,-348,-28
"20060",NA,NA,"Douglas, GA","Micropolitan Statistical Area",2003,46634,427,345,776,431,140,159,-19,-58
"20060",NA,13003,"Atkinson County, GA","County or equivalent",2003,7912,203,93,160,67,116,41,75,-6
"20060",NA,13069,"Coffee County, GA","County or equivalent",2003,38722,224,252,616,364,24,118,-94,-52
"20140",NA,NA,"Dublin, GA","Micropolitan Statistical Area",2003,55110,585,177,792,615,464,14,450,-56
"20140",NA,13167,"Johnson County, GA","County or equivalent",2003,8908,-14,7,104,97,-7,1,-8,-14
"20140",NA,13175,"Laurens County, GA","County or equivalent",2003,46202,599,170,688,518,471,13,458,-42
"20180",NA,NA,"DuBois, PA","Micropolitan Statistical Area",2003,82498,-481,-140,794,934,-230,7,-237,-111
"20180",NA,42033,"Clearfield County, PA","County or equivalent",2003,82498,-481,-140,794,934,-230,7,-237,-111
"20300",NA,NA,"Dumas, TX","Micropolitan Statistical Area",2003,19930,-40,312,436,124,-348,126,-474,-4
"20300",NA,48341,"Moore County, TX","County or equivalent",2003,19930,-40,312,436,124,-348,126,-474,-4
"20340",NA,NA,"Duncan, OK","Micropolitan Statistical Area",2003,42262,-200,-28,537,565,-112,-4,-108,-60
"20340",NA,40137,"Stephens County, OK","County or equivalent",2003,42262,-200,-28,537,565,-112,-4,-108,-60
"20380",NA,NA,"Dunn, NC","Micropolitan Statistical Area",2003,98335,1769,644,1407,763,1161,-188,1349,-36
"20380",NA,37085,"Harnett County, NC","County or equivalent",2003,98335,1769,644,1407,763,1161,-188,1349,-36
"20420",NA,NA,"Durango, CO","Micropolitan Statistical Area",2003,46253,286,218,484,266,129,30,99,-61
"20420",NA,8067,"La Plata County, CO","County or equivalent",2003,46253,286,218,484,266,129,30,99,-61
"20460",NA,NA,"Durant, OK","Micropolitan Statistical Area",2003,36865,101,44,493,449,104,37,67,-47
"20460",NA,40013,"Bryan County, OK","County or equivalent",2003,36865,101,44,493,449,104,37,67,-47
"20540",NA,NA,"Dyersburg, TN","Micropolitan Statistical Area",2003,37148,84,42,457,415,96,25,71,-54
"20540",NA,47045,"Dyer County, TN","County or equivalent",2003,37148,84,42,457,415,96,25,71,-54
"20580",NA,NA,"Eagle Pass, TX","Micropolitan Statistical Area",2003,49064,691,676,919,243,84,257,-173,-69
"20580",NA,48323,"Maverick County, TX","County or equivalent",2003,49064,691,676,919,243,84,257,-173,-69
"20620",NA,NA,"East Liverpool-Salem, OH","Micropolitan Statistical Area",2003,110844,-225,58,1242,1184,-134,11,-145,-149
"20620",NA,39029,"Columbiana County, OH","County or equivalent",2003,110844,-225,58,1242,1184,-134,11,-145,-149
"20660",NA,NA,"Easton, MD","Micropolitan Statistical Area",2003,34539,195,-81,349,430,305,26,279,-29
"20660",NA,24041,"Talbot County, MD","County or equivalent",2003,34539,195,-81,349,430,305,26,279,-29
"20700",NA,NA,"East Stroudsburg, PA","Micropolitan Statistical Area",2003,152925,4684,365,1551,1186,4202,100,4102,117
"20700",NA,42089,"Monroe County, PA","County or equivalent",2003,152925,4684,365,1551,1186,4202,100,4102,117
"20780",NA,NA,"Edwards, CO","Micropolitan Statistical Area",2003,53011,729,826,950,124,-58,612,-670,-39
"20780",NA,8037,"Eagle County, CO","County or equivalent",2003,45366,865,744,832,88,168,522,-354,-47
"20780",NA,8065,"Lake County, CO","County or equivalent",2003,7645,-136,82,118,36,-226,90,-316,8
"20820",NA,NA,"Effingham, IL","Micropolitan Statistical Area",2003,34429,116,127,461,334,42,11,31,-53
"20820",NA,17049,"Effingham County, IL","County or equivalent",2003,34429,116,127,461,334,42,11,31,-53
"20900",NA,NA,"El Campo, TX","Micropolitan Statistical Area",2003,40960,59,264,674,410,-164,111,-275,-41
"20900",NA,48481,"Wharton County, TX","County or equivalent",2003,40960,59,264,674,410,-164,111,-275,-41
"20980",NA,NA,"El Dorado, AR","Micropolitan Statistical Area",2003,44605,-421,45,607,562,-426,23,-449,-40
"20980",NA,5139,"Union County, AR","County or equivalent",2003,44605,-421,45,607,562,-426,23,-449,-40
"21020",NA,NA,"Elizabeth City, NC","Micropolitan Statistical Area",2003,55407,1045,127,696,569,926,-87,1013,-8
"21020",NA,37029,"Camden County, NC","County or equivalent",2003,7854,472,43,99,56,406,-17,423,23
"21020",NA,37139,"Pasquotank County, NC","County or equivalent",2003,36031,533,118,481,363,435,-61,496,-20
"21020",NA,37143,"Perquimans County, NC","County or equivalent",2003,11522,40,-34,116,150,85,-9,94,-11
"21120",NA,NA,"Elk City, OK","Micropolitan Statistical Area",2003,19202,-644,20,268,248,-684,9,-693,20
"21120",NA,40009,"Beckham County, OK","County or equivalent",2003,19202,-644,20,268,248,-684,9,-693,20
"21220",NA,NA,"Elko, NV","Micropolitan Statistical Area",2003,44921,-715,339,609,270,-1076,136,-1212,22
"21220",NA,32007,"Elko County, NV","County or equivalent",2003,43468,-576,340,599,259,-929,130,-1059,13
"21220",NA,32011,"Eureka County, NV","County or equivalent",2003,1453,-139,-1,10,11,-147,6,-153,9
"21260",NA,NA,"Ellensburg, WA","Micropolitan Statistical Area",2003,35399,635,133,379,246,519,59,460,-17
"21260",NA,53037,"Kittitas County, WA","County or equivalent",2003,35399,635,133,379,246,519,59,460,-17
"21380",NA,NA,"Emporia, KS","Micropolitan Statistical Area",2003,38717,-60,246,588,342,-279,168,-447,-27
"21380",NA,20017,"Chase County, KS","County or equivalent",2003,2961,-66,-12,36,48,-54,3,-57,0
"21380",NA,20111,"Lyon County, KS","County or equivalent",2003,35756,6,258,552,294,-225,165,-390,-27
"21420",NA,NA,"Enid, OK","Micropolitan Statistical Area",2003,57156,37,236,915,679,-114,-145,31,-85
"21420",NA,40047,"Garfield County, OK","County or equivalent",2003,57156,37,236,915,679,-114,-145,31,-85
"21460",NA,NA,"Enterprise-Ozark, AL","Micropolitan Statistical Area",2003,93187,383,391,1312,921,78,-531,609,-86
"21460",NA,1031,"Coffee County, AL","County or equivalent",2003,44177,423,104,556,452,341,-145,486,-22
"21460",NA,1045,"Dale County, AL","County or equivalent",2003,49010,-40,287,756,469,-263,-386,123,-64
"21540",NA,NA,"Escanaba, MI","Micropolitan Statistical Area",2003,38070,-187,-33,387,420,-110,6,-116,-44
"21540",NA,26041,"Delta County, MI","County or equivalent",2003,38070,-187,-33,387,420,-110,6,-116,-44
"21580",NA,NA,"Espanola, NM","Micropolitan Statistical Area",2003,40607,-281,330,665,335,-596,68,-664,-15
"21580",NA,35039,"Rio Arriba County, NM","County or equivalent",2003,40607,-281,330,665,335,-596,68,-664,-15
"21640",NA,NA,"Eufaula, AL-GA","Micropolitan Statistical Area",2003,31965,113,75,399,324,-128,34,-162,166
"21640",NA,1005,"Barbour County, AL","County or equivalent",2003,29441,175,64,360,296,-59,33,-92,170
"21640",NA,13239,"Quitman County, GA","County or equivalent",2003,2524,-62,11,39,28,-69,1,-70,-4
"21700",NA,NA,"Eureka-Arcata-Fortuna, CA","Micropolitan Statistical Area",2003,128224,440,199,1442,1243,421,100,321,-180
"21700",NA,6023,"Humboldt County, CA","County or equivalent",2003,128224,440,199,1442,1243,421,100,321,-180
"21740",NA,NA,"Evanston, WY","Micropolitan Statistical Area",2003,19439,-126,200,321,121,-323,8,-331,-3
"21740",NA,56041,"Uinta County, WY","County or equivalent",2003,19439,-126,200,321,121,-323,8,-331,-3
"21860",NA,NA,"Fairmont, MN","Micropolitan Statistical Area",2003,20988,-210,-45,202,247,-144,4,-148,-21
"21860",NA,27091,"Martin County, MN","County or equivalent",2003,20988,-210,-45,202,247,-144,4,-148,-21
"21900",NA,NA,"Fairmont, WV","Micropolitan Statistical Area",2003,56266,108,-89,640,729,263,9,254,-66
"21900",NA,54049,"Marion County, WV","County or equivalent",2003,56266,108,-89,640,729,263,9,254,-66
"21980",NA,NA,"Fallon, NV","Micropolitan Statistical Area",2003,24031,-48,100,347,247,-113,-113,0,-35
"21980",NA,32001,"Churchill County, NV","County or equivalent",2003,24031,-48,100,347,247,-113,-113,0,-35
"22060",NA,NA,"Faribault-Northfield, MN","Micropolitan Statistical Area",2003,59199,830,264,704,440,618,136,482,-52
"22060",NA,27131,"Rice County, MN","County or equivalent",2003,59199,830,264,704,440,618,136,482,-52
"22100",NA,NA,"Farmington, MO","Micropolitan Statistical Area",2003,57686,1142,78,733,655,1072,8,1064,-8
"22100",NA,29187,"St. Francois County, MO","County or equivalent",2003,57686,1142,78,733,655,1072,8,1064,-8
"22260",NA,NA,"Fergus Falls, MN","Micropolitan Statistical Area",2003,57332,137,-81,586,667,285,56,229,-67
"22260",NA,27111,"Otter Tail County, MN","County or equivalent",2003,57332,137,-81,586,667,285,56,229,-67
"22280",NA,NA,"Fernley, NV","Micropolitan Statistical Area",2003,39884,2122,68,467,399,1980,42,1938,74
"22280",NA,32019,"Lyon County, NV","County or equivalent",2003,39884,2122,68,467,399,1980,42,1938,74
"22300",NA,NA,"Findlay, OH","Micropolitan Statistical Area",2003,72914,403,305,921,616,200,67,133,-102
"22300",NA,39063,"Hancock County, OH","County or equivalent",2003,72914,403,305,921,616,200,67,133,-102
"22340",NA,NA,"Fitzgerald, GA","Micropolitan Statistical Area",2003,27057,-64,63,376,313,-104,42,-146,-23
"22340",NA,13017,"Ben Hill County, GA","County or equivalent",2003,17048,-110,62,261,199,-159,25,-184,-13
"22340",NA,13155,"Irwin County, GA","County or equivalent",2003,10009,46,1,115,114,55,17,38,-10
"22580",NA,NA,"Forest City, NC","Micropolitan Statistical Area",2003,63049,77,-4,746,750,170,22,148,-89
"22580",NA,37161,"Rutherford County, NC","County or equivalent",2003,63049,77,-4,746,750,170,22,148,-89
"22620",NA,NA,"Forrest City, AR","Micropolitan Statistical Area",2003,28459,-89,109,441,332,-168,-1,-167,-30
"22620",NA,5123,"St. Francis County, AR","County or equivalent",2003,28459,-89,109,441,332,-168,-1,-167,-30
"22700",NA,NA,"Fort Dodge, IA","Micropolitan Statistical Area",2003,39368,-299,-15,461,476,-241,22,-263,-43
"22700",NA,19187,"Webster County, IA","County or equivalent",2003,39368,-299,-15,461,476,-241,22,-263,-43
"22780",NA,NA,"Fort Leonard Wood, MO","Micropolitan Statistical Area",2003,44547,782,373,656,283,326,-1455,1781,83
"22780",NA,29169,"Pulaski County, MO","County or equivalent",2003,44547,782,373,656,283,326,-1455,1781,83
"22800",NA,NA,"Fort Madison-Keokuk, IA-MO","Micropolitan Statistical Area",2003,43748,-474,-9,504,513,-433,12,-445,-32
"22800",NA,19111,"Lee County, IA","County or equivalent",2003,36473,-382,14,428,414,-370,13,-383,-26
"22800",NA,29045,"Clark County, MO","County or equivalent",2003,7275,-92,-23,76,99,-63,-1,-62,-6
"22820",NA,NA,"Fort Morgan, CO","Micropolitan Statistical Area",2003,27670,157,260,494,234,-80,164,-244,-23
"22820",NA,8087,"Morgan County, CO","County or equivalent",2003,27670,157,260,494,234,-80,164,-244,-23
"22840",NA,NA,"Fort Payne, AL","Micropolitan Statistical Area",2003,65886,416,253,919,666,254,148,106,-91
"22840",NA,1049,"DeKalb County, AL","County or equivalent",2003,65886,416,253,919,666,254,148,106,-91
"22860",NA,NA,"Fort Polk South, LA","Micropolitan Statistical Area",2003,51118,-396,695,1046,351,-1023,-1125,102,-68
"22860",NA,22115,"Vernon Parish, LA","County or equivalent",2003,51118,-396,695,1046,351,-1023,-1125,102,-68
"22980",NA,NA,"Fort Valley, GA","Micropolitan Statistical Area",2003,24420,214,92,315,223,150,46,104,-28
"22980",NA,13225,"Peach County, GA","County or equivalent",2003,24420,214,92,315,223,150,46,104,-28
"23140",NA,NA,"Frankfort, IN","Micropolitan Statistical Area",2003,33677,-159,135,497,362,-276,144,-420,-18
"23140",NA,18023,"Clinton County, IN","County or equivalent",2003,33677,-159,135,497,362,-276,144,-420,-18
"23180",NA,NA,"Frankfort, KY","Micropolitan Statistical Area",2003,67725,116,159,844,685,32,44,-12,-75
"23180",NA,21005,"Anderson County, KY","County or equivalent",2003,19651,222,56,235,179,183,0,183,-17
"23180",NA,21073,"Franklin County, KY","County or equivalent",2003,48074,-106,103,609,506,-151,44,-195,-58
"23240",NA,NA,"Fredericksburg, TX","Micropolitan Statistical Area",2003,22053,486,-68,220,288,548,31,517,6
"23240",NA,48171,"Gillespie County, TX","County or equivalent",2003,22053,486,-68,220,288,548,31,517,6
"23300",NA,NA,"Freeport, IL","Micropolitan Statistical Area",2003,48006,-33,60,578,518,-30,47,-77,-63
"23300",NA,17177,"Stephenson County, IL","County or equivalent",2003,48006,-33,60,578,518,-30,47,-77,-63
"23340",NA,NA,"Fremont, NE","Micropolitan Statistical Area",2003,35815,-7,81,483,402,-42,26,-68,-46
"23340",NA,31053,"Dodge County, NE","County or equivalent",2003,35815,-7,81,483,402,-42,26,-68,-46
"23380",NA,NA,"Fremont, OH","Micropolitan Statistical Area",2003,61398,-286,200,835,635,-428,9,-437,-58
"23380",NA,39143,"Sandusky County, OH","County or equivalent",2003,61398,-286,200,835,635,-428,9,-437,-58
"23500",NA,NA,"Gaffney, SC","Micropolitan Statistical Area",2003,53250,-74,127,697,570,-124,27,-151,-77
"23500",NA,45021,"Cherokee County, SC","County or equivalent",2003,53250,-74,127,697,570,-124,27,-151,-77
"23620",NA,NA,"Gainesville, TX","Micropolitan Statistical Area",2003,37682,227,153,522,369,129,107,22,-55
"23620",NA,48097,"Cooke County, TX","County or equivalent",2003,37682,227,153,522,369,129,107,22,-55
"23660",NA,NA,"Galesburg, IL","Micropolitan Statistical Area",2003,72064,-917,-83,849,932,-783,12,-795,-51
"23660",NA,17095,"Knox County, IL","County or equivalent",2003,53952,-705,-82,644,726,-584,9,-593,-39
"23660",NA,17187,"Warren County, IL","County or equivalent",2003,18112,-212,-1,205,206,-199,3,-202,-12
"23700",NA,NA,"Gallup, NM","Micropolitan Statistical Area",2003,71484,-1395,898,1351,453,-2355,37,-2392,62
"23700",NA,35031,"McKinley County, NM","County or equivalent",2003,71484,-1395,898,1351,453,-2355,37,-2392,62
"23780",NA,NA,"Garden City, KS","Micropolitan Statistical Area",2003,40017,-105,590,780,190,-1127,356,-1483,432
"23780",NA,20055,"Finney County, KS","County or equivalent",2003,40017,-105,590,780,190,-1127,356,-1483,432
"23820",NA,NA,"Gardnerville Ranchos, NV","Micropolitan Statistical Area",2003,43910,861,125,429,304,748,35,713,-12
"23820",NA,32005,"Douglas County, NV","County or equivalent",2003,43910,861,125,429,304,748,35,713,-12
"23860",NA,NA,"Georgetown, SC","Micropolitan Statistical Area",2003,58355,676,128,698,570,603,39,564,-55
"23860",NA,45043,"Georgetown County, SC","County or equivalent",2003,58355,676,128,698,570,603,39,564,-55
"23900",NA,NA,"Gettysburg, PA","Micropolitan Statistical Area",2003,95681,1544,120,1021,901,1468,107,1361,-44
"23900",NA,42001,"Adams County, PA","County or equivalent",2003,95681,1544,120,1021,901,1468,107,1361,-44
"23940",NA,NA,"Gillette, WY","Micropolitan Statistical Area",2003,36061,207,376,546,170,-124,15,-139,-45
"23940",NA,56005,"Campbell County, WY","County or equivalent",2003,36061,207,376,546,170,-124,15,-139,-45
"23980",NA,NA,"Glasgow, KY","Micropolitan Statistical Area",2003,48931,375,32,623,591,394,24,370,-51
"23980",NA,21009,"Barren County, KY","County or equivalent",2003,38967,380,55,493,438,362,23,339,-37
"23980",NA,21169,"Metcalfe County, KY","County or equivalent",2003,9964,-5,-23,130,153,32,1,31,-14
"24100",NA,NA,"Gloversville, NY","Micropolitan Statistical Area",2003,54875,5,-18,572,590,96,20,76,-73
"24100",NA,36035,"Fulton County, NY","County or equivalent",2003,54875,5,-18,572,590,96,20,76,-73
"24180",NA,NA,"Granbury, TX","Micropolitan Statistical Area",2003,51955,1249,50,601,551,1201,53,1148,-2
"24180",NA,48221,"Hood County, TX","County or equivalent",2003,44721,1110,32,499,467,1074,43,1031,4
"24180",NA,48425,"Somervell County, TX","County or equivalent",2003,7234,139,18,102,84,127,10,117,-6
"24260",NA,NA,"Grand Island, NE","Micropolitan Statistical Area",2003,68417,324,502,1146,644,-107,228,-335,-71
"24260",NA,31079,"Hall County, NE","County or equivalent",2003,53858,273,469,948,479,-142,224,-366,-54
"24260",NA,31093,"Howard County, NE","County or equivalent",2003,6574,96,28,93,65,74,1,73,-6
"24260",NA,31121,"Merrick County, NE","County or equivalent",2003,7985,-45,5,105,100,-39,3,-42,-11
"24380",NA,NA,"Grants, NM","Micropolitan Statistical Area",2003,26971,283,203,385,182,115,9,106,-35
"24380",NA,35006,"Cibola County, NM","County or equivalent",2003,26971,283,203,385,182,115,9,106,-35
"24420",NA,NA,"Grants Pass, OR","Micropolitan Statistical Area",2003,78301,880,-306,750,1056,1216,14,1202,-30
"24420",NA,41033,"Josephine County, OR","County or equivalent",2003,78301,880,-306,750,1056,1216,14,1202,-30
"24460",NA,NA,"Great Bend, KS","Micropolitan Statistical Area",2003,27827,-67,77,370,293,-271,62,-333,127
"24460",NA,20009,"Barton County, KS","County or equivalent",2003,27827,-67,77,370,293,-271,62,-333,127
"24620",NA,NA,"Greeneville, TN","Micropolitan Statistical Area",2003,63628,226,-67,705,772,356,36,320,-63
"24620",NA,47059,"Greene County, TN","County or equivalent",2003,63628,226,-67,705,772,356,36,320,-63
"24700",NA,NA,"Greensburg, IN","Micropolitan Statistical Area",2003,24733,85,126,371,245,-7,29,-36,-34
"24700",NA,18031,"Decatur County, IN","County or equivalent",2003,24733,85,126,371,245,-7,29,-36,-34
"24740",NA,NA,"Greenville, MS","Micropolitan Statistical Area",2003,59144,-1203,334,993,659,-1556,20,-1576,19
"24740",NA,28151,"Washington County, MS","County or equivalent",2003,59144,-1203,334,993,659,-1556,20,-1576,19
"24820",NA,NA,"Greenville, OH","Micropolitan Statistical Area",2003,52873,41,115,677,562,3,3,0,-77
"24820",NA,39037,"Darke County, OH","County or equivalent",2003,52873,41,115,677,562,3,3,0,-77
"24900",NA,NA,"Greenwood, MS","Micropolitan Statistical Area",2003,45572,-1349,204,710,506,-1605,16,-1621,52
"24900",NA,28015,"Carroll County, MS","County or equivalent",2003,10434,-51,9,108,99,-49,4,-53,-11
"24900",NA,28083,"Leflore County, MS","County or equivalent",2003,35138,-1298,195,602,407,-1556,12,-1568,63
"24940",NA,NA,"Greenwood, SC","Micropolitan Statistical Area",2003,67231,264,145,819,674,215,130,85,-96
"24940",NA,45047,"Greenwood County, SC","County or equivalent",2003,67231,264,145,819,674,215,130,85,-96
"24980",NA,NA,"Grenada, MS","Micropolitan Statistical Area",2003,22755,-180,-33,278,311,-125,5,-130,-22
"24980",NA,28043,"Grenada County, MS","County or equivalent",2003,22755,-180,-33,278,311,-125,5,-130,-22
"25100",NA,NA,"Guymon, OK","Micropolitan Statistical Area",2003,19745,-199,235,394,159,-449,206,-655,15
"25100",NA,40139,"Texas County, OK","County or equivalent",2003,19745,-199,235,394,159,-449,206,-655,15
"25220",NA,NA,"Hammond, LA","Micropolitan Statistical Area",2003,103337,1052,492,1494,1002,668,9,659,-108
"25220",NA,22105,"Tangipahoa Parish, LA","County or equivalent",2003,103337,1052,492,1494,1002,668,9,659,-108
"25300",NA,NA,"Hannibal, MO","Micropolitan Statistical Area",2003,37754,99,3,476,473,143,4,139,-47
"25300",NA,29127,"Marion County, MO","County or equivalent",2003,28182,159,5,375,370,187,2,185,-33
"25300",NA,29173,"Ralls County, MO","County or equivalent",2003,9572,-60,-2,101,103,-44,2,-46,-14
"25340",NA,NA,"Harriman, TN","Micropolitan Statistical Area",2003,52410,311,-56,530,586,410,16,394,-43
"25340",NA,47145,"Roane County, TN","County or equivalent",2003,52410,311,-56,530,586,410,16,394,-43
"25380",NA,NA,"Harrisburg, IL","Micropolitan Statistical Area",2003,26114,-157,-63,343,406,-59,4,-63,-35
"25380",NA,17165,"Saline County, IL","County or equivalent",2003,26114,-157,-63,343,406,-59,4,-63,-35
"25460",NA,NA,"Harrison, AR","Micropolitan Statistical Area",2003,43058,124,14,505,491,164,5,159,-54
"25460",NA,5009,"Boone County, AR","County or equivalent",2003,34498,71,20,417,397,98,6,92,-47
"25460",NA,5101,"Newton County, AR","County or equivalent",2003,8560,53,-6,88,94,66,-1,67,-7
"25580",NA,NA,"Hastings, NE","Micropolitan Statistical Area",2003,38891,371,99,480,381,-113,92,-205,385
"25580",NA,31001,"Adams County, NE","County or equivalent",2003,32142,451,112,405,293,-54,90,-144,393
"25580",NA,31035,"Clay County, NE","County or equivalent",2003,6749,-80,-13,75,88,-59,2,-61,-8
"25660",NA,NA,"Havre, MT","Micropolitan Statistical Area",2003,16202,-95,83,226,143,-162,-2,-160,-16
"25660",NA,30041,"Hill County, MT","County or equivalent",2003,16202,-95,83,226,143,-162,-2,-160,-16
"25700",NA,NA,"Hays, KS","Micropolitan Statistical Area",2003,27310,-96,134,367,233,-207,24,-231,-23
"25700",NA,20051,"Ellis County, KS","County or equivalent",2003,27310,-96,134,367,233,-207,24,-231,-23
"25720",NA,NA,"Heber, UT","Micropolitan Statistical Area",2003,17391,650,282,371,89,371,31,340,-3
"25720",NA,49051,"Wasatch County, UT","County or equivalent",2003,17391,650,282,371,89,371,31,340,-3
"25740",NA,NA,"Helena, MT","Micropolitan Statistical Area",2003,67178,825,197,750,553,682,-7,689,-54
"25740",NA,30043,"Jefferson County, MT","County or equivalent",2003,10312,86,8,87,79,87,-3,90,-9
"25740",NA,30049,"Lewis and Clark County, MT","County or equivalent",2003,56866,739,189,663,474,595,-4,599,-45
"25760",NA,NA,"Helena-West Helena, AR","Micropolitan Statistical Area",2003,24092,-683,92,383,291,-787,5,-792,12
"25760",NA,5107,"Phillips County, AR","County or equivalent",2003,24092,-683,92,383,291,-787,5,-792,12
"25780",NA,NA,"Henderson, NC","Micropolitan Statistical Area",2003,43225,-292,178,681,503,-445,97,-542,-25
"25780",NA,37181,"Vance County, NC","County or equivalent",2003,43225,-292,178,681,503,-445,97,-542,-25
"25820",NA,NA,"Hereford, TX","Micropolitan Statistical Area",2003,18163,-92,200,337,137,-283,51,-334,-9
"25820",NA,48117,"Deaf Smith County, TX","County or equivalent",2003,18163,-92,200,337,137,-283,51,-334,-9
"25900",NA,NA,"Hilo, HI","Micropolitan Statistical Area",2003,156127,3087,837,2083,1246,2329,342,1987,-79
"25900",NA,15001,"Hawaii County, HI","County or equivalent",2003,156127,3087,837,2083,1246,2329,342,1987,-79
"25940",NA,NA,"Hilton Head Island-Beaufort, SC","Micropolitan Statistical Area",2003,151629,2382,1097,2326,1229,1315,-1015,2330,-30
"25940",NA,45013,"Beaufort County, SC","County or equivalent",2003,130793,2378,981,2029,1048,1401,-1093,2494,-4
"25940",NA,45053,"Jasper County, SC","County or equivalent",2003,20836,4,116,297,181,-86,78,-164,-26
"26020",NA,NA,"Hobbs, NM","Micropolitan Statistical Area",2003,55225,-150,440,917,477,-549,77,-626,-41
"26020",NA,35025,"Lea County, NM","County or equivalent",2003,55225,-150,440,917,477,-549,77,-626,-41
"26140",NA,NA,"Homosassa Springs, FL","Micropolitan Statistical Area",2003,125717,2502,-1268,880,2148,3679,53,3626,91
"26140",NA,12017,"Citrus County, FL","County or equivalent",2003,125717,2502,-1268,880,2148,3679,53,3626,91
"26220",NA,NA,"Hood River, OR","Micropolitan Statistical Area",2003,20604,-5,106,294,188,-95,98,-193,-16
"26220",NA,41027,"Hood River County, OR","County or equivalent",2003,20604,-5,106,294,188,-95,98,-193,-16
"26260",NA,NA,"Hope, AR","Micropolitan Statistical Area",2003,32777,-143,72,467,395,-184,115,-299,-31
"26260",NA,5057,"Hempstead County, AR","County or equivalent",2003,23142,-79,72,342,270,-130,105,-235,-21
"26260",NA,5099,"Nevada County, AR","County or equivalent",2003,9635,-64,0,125,125,-54,10,-64,-10
"26340",NA,NA,"Houghton, MI","Micropolitan Statistical Area",2003,37605,-297,-8,406,414,-253,44,-297,-36
"26340",NA,26061,"Houghton County, MI","County or equivalent",2003,35381,-272,-10,385,395,-230,43,-273,-32
"26340",NA,26083,"Keweenaw County, MI","County or equivalent",2003,2224,-25,2,21,19,-23,1,-24,-4
"26460",NA,NA,"Hudson, NY","Micropolitan Statistical Area",2003,62802,-57,-52,629,681,82,48,34,-87
"26460",NA,36021,"Columbia County, NY","County or equivalent",2003,62802,-57,-52,629,681,82,48,34,-87
"26480",NA,NA,"Humboldt, TN","Micropolitan Statistical Area",2003,47686,-222,-138,587,725,-18,16,-34,-66
"26480",NA,47053,"Gibson County, TN","County or equivalent",2003,47686,-222,-138,587,725,-18,16,-34,-66
"26500",NA,NA,"Huntingdon, PA","Micropolitan Statistical Area",2003,45677,35,21,453,432,79,-1,80,-65
"26500",NA,42061,"Huntingdon County, PA","County or equivalent",2003,45677,35,21,453,432,79,-1,80,-65
"26540",NA,NA,"Huntington, IN","Micropolitan Statistical Area",2003,38070,-79,83,473,390,-117,6,-123,-45
"26540",NA,18069,"Huntington County, IN","County or equivalent",2003,38070,-79,83,473,390,-117,6,-123,-45
"26660",NA,NA,"Huntsville, TX","Micropolitan Statistical Area",2003,62760,1104,215,629,414,916,82,834,-27
"26660",NA,48471,"Walker County, TX","County or equivalent",2003,62760,1104,215,629,414,916,82,834,-27
"26700",NA,NA,"Huron, SD","Micropolitan Statistical Area",2003,16149,-369,-5,184,189,-366,3,-369,2
"26700",NA,46005,"Beadle County, SD","County or equivalent",2003,16149,-369,-5,184,189,-366,3,-369,2
"26740",NA,NA,"Hutchinson, KS","Micropolitan Statistical Area",2003,63665,-300,167,817,650,-399,33,-432,-68
"26740",NA,20155,"Reno County, KS","County or equivalent",2003,63665,-300,167,817,650,-399,33,-432,-68
"26780",NA,NA,"Hutchinson, MN","Micropolitan Statistical Area",2003,35573,123,197,512,315,-24,22,-46,-50
"26780",NA,27085,"McLeod County, MN","County or equivalent",2003,35573,123,197,512,315,-24,22,-46,-50
"26860",NA,NA,"Indiana, PA","Micropolitan Statistical Area",2003,88892,10,-25,856,881,163,36,127,-128
"26860",NA,42063,"Indiana County, PA","County or equivalent",2003,88892,10,-25,856,881,163,36,127,-128
"26940",NA,NA,"Indianola, MS","Micropolitan Statistical Area",2003,33205,-320,121,441,320,-413,9,-422,-28
"26940",NA,28133,"Sunflower County, MS","County or equivalent",2003,33205,-320,121,441,320,-413,9,-422,-28
"27020",NA,NA,"Iron Mountain, MI-WI","Micropolitan Statistical Area",2003,32030,-169,-72,313,385,-58,3,-61,-39
"27020",NA,26043,"Dickinson County, MI","County or equivalent",2003,27034,-62,-50,281,331,26,2,24,-38
"27020",NA,55037,"Florence County, WI","County or equivalent",2003,4996,-107,-22,32,54,-84,1,-85,-1
"27220",NA,NA,"Jackson, WY-ID","Micropolitan Statistical Area",2003,25822,402,266,379,113,166,117,49,-30
"27220",NA,16081,"Teton County, ID","County or equivalent",2003,6970,249,121,151,30,132,36,96,-4
"27220",NA,56039,"Teton County, WY","County or equivalent",2003,18852,153,145,228,83,34,81,-47,-26
"27300",NA,NA,"Jacksonville, IL","Micropolitan Statistical Area",2003,41400,-124,-28,441,469,-38,5,-43,-58
"27300",NA,17137,"Morgan County, IL","County or equivalent",2003,35970,-101,-25,381,406,-25,6,-31,-51
"27300",NA,17171,"Scott County, IL","County or equivalent",2003,5430,-23,-3,60,63,-13,-1,-12,-7
"27380",NA,NA,"Jacksonville, TX","Micropolitan Statistical Area",2003,47135,457,214,736,522,299,167,132,-56
"27380",NA,48073,"Cherokee County, TX","County or equivalent",2003,47135,457,214,736,522,299,167,132,-56
"27420",NA,NA,"Jamestown, ND","Micropolitan Statistical Area",2003,21122,-250,-24,221,245,-205,2,-207,-21
"27420",NA,38093,"Stutsman County, ND","County or equivalent",2003,21122,-250,-24,221,245,-205,2,-207,-21
"27460",NA,NA,"Jamestown-Dunkirk-Fredonia, NY","Micropolitan Statistical Area",2003,136945,-1063,-62,1460,1522,-864,24,-888,-137
"27460",NA,36013,"Chautauqua County, NY","County or equivalent",2003,136945,-1063,-62,1460,1522,-864,24,-888,-137
"27540",NA,NA,"Jasper, IN","Micropolitan Statistical Area",2003,52901,121,154,668,514,44,44,0,-77
"27540",NA,18037,"Dubois County, IN","County or equivalent",2003,40143,206,160,527,367,105,44,61,-59
"27540",NA,18125,"Pike County, IN","County or equivalent",2003,12758,-85,-6,141,147,-61,0,-61,-18
"27660",NA,NA,"Jennings, LA","Micropolitan Statistical Area",2003,30874,-73,133,479,346,-173,0,-173,-33
"27660",NA,22053,"Jefferson Davis Parish, LA","County or equivalent",2003,30874,-73,133,479,346,-173,0,-173,-33
"27700",NA,NA,"Jesup, GA","Micropolitan Statistical Area",2003,27683,473,175,424,249,315,5,310,-17
"27700",NA,13305,"Wayne County, GA","County or equivalent",2003,27683,473,175,424,249,315,5,310,-17
"27940",NA,NA,"Juneau, AK","Micropolitan Statistical Area",2003,30878,172,256,385,129,-35,11,-46,-49
"27940",NA,2110,"Juneau City and Borough, AK","County or equivalent",2003,30878,172,256,385,129,-35,11,-46,-49
"27980",NA,NA,"Kahului-Wailuku, HI","Micropolitan Statistical Area",2003,134538,2007,1103,1894,791,1056,476,580,-152
"27980",NA,15009,"Maui County, HI","County or equivalent",2003,134538,2007,1103,1894,791,1056,476,580,-152
"28060",NA,NA,"Kalispell, MT","Micropolitan Statistical Area",2003,79152,1883,292,995,703,1585,25,1560,6
"28060",NA,30029,"Flathead County, MT","County or equivalent",2003,79152,1883,292,995,703,1585,25,1560,6
"28180",NA,NA,"Kapaa, HI","Micropolitan Statistical Area",2003,59963,554,368,764,396,267,109,158,-81
"28180",NA,15007,"Kauai County, HI","County or equivalent",2003,59963,554,368,764,396,267,109,158,-81
"28260",NA,NA,"Kearney, NE","Micropolitan Statistical Area",2003,49987,275,319,704,385,30,30,0,-74
"28260",NA,31019,"Buffalo County, NE","County or equivalent",2003,43215,270,313,631,318,21,31,-10,-64
"28260",NA,31099,"Kearney County, NE","County or equivalent",2003,6772,5,6,73,67,9,-1,10,-10
"28300",NA,NA,"Keene, NH","Micropolitan Statistical Area",2003,76006,991,87,732,645,947,26,921,-43
"28300",NA,33005,"Cheshire County, NH","County or equivalent",2003,76006,991,87,732,645,947,26,921,-43
"28340",NA,NA,"Kendallville, IN","Micropolitan Statistical Area",2003,46787,17,306,689,383,-247,135,-382,-42
"28340",NA,18113,"Noble County, IN","County or equivalent",2003,46787,17,306,689,383,-247,135,-382,-42
"28380",NA,NA,"Kennett, MO","Micropolitan Statistical Area",2003,32385,-262,-27,443,470,-203,14,-217,-32
"28380",NA,29069,"Dunklin County, MO","County or equivalent",2003,32385,-262,-27,443,470,-203,14,-217,-32
"28500",NA,NA,"Kerrville, TX","Micropolitan Statistical Area",2003,44882,234,-118,501,619,388,74,314,-36
"28500",NA,48265,"Kerr County, TX","County or equivalent",2003,44882,234,-118,501,619,388,74,314,-36
"28540",NA,NA,"Ketchikan, AK","Micropolitan Statistical Area",2003,13280,-282,97,173,76,-386,-16,-370,7
"28540",NA,2130,"Ketchikan Gateway Borough, AK","County or equivalent",2003,13280,-282,97,173,76,-386,-16,-370,7
"28580",NA,NA,"Key West, FL","Micropolitan Statistical Area",2003,78639,-151,-23,711,734,-15,136,-151,-113
"28580",NA,12087,"Monroe County, FL","County or equivalent",2003,78639,-151,-23,711,734,-15,136,-151,-113
"28620",NA,NA,"Kill Devil Hills, NC","Micropolitan Statistical Area",2003,32901,850,95,370,275,743,16,727,12
"28620",NA,37055,"Dare County, NC","County or equivalent",2003,32901,850,95,370,275,743,16,727,12
"28780",NA,NA,"Kingsville, TX","Micropolitan Statistical Area",2003,31520,-91,298,499,201,-360,-37,-323,-29
"28780",NA,48261,"Kenedy County, TX","County or equivalent",2003,414,-6,2,6,4,-8,1,-9,0
"28780",NA,48273,"Kleberg County, TX","County or equivalent",2003,31106,-85,296,493,197,-352,-38,-314,-29
"28820",NA,NA,"Kinston, NC","Micropolitan Statistical Area",2003,57982,-508,50,744,694,-506,56,-562,-52
"28820",NA,37107,"Lenoir County, NC","County or equivalent",2003,57982,-508,50,744,694,-506,56,-562,-52
"28860",NA,NA,"Kirksville, MO","Micropolitan Statistical Area",2003,28930,-206,29,302,273,-208,25,-233,-27
"28860",NA,29001,"Adair County, MO","County or equivalent",2003,24775,-191,52,267,215,-222,23,-245,-21
"28860",NA,29197,"Schuyler County, MO","County or equivalent",2003,4155,-15,-23,35,58,14,2,12,-6
"28900",NA,NA,"Klamath Falls, OR","Micropolitan Statistical Area",2003,64532,445,92,786,694,423,16,407,-70
"28900",NA,41035,"Klamath County, OR","County or equivalent",2003,64532,445,92,786,694,423,16,407,-70
"28980",NA,NA,"Kodiak, AK","Micropolitan Statistical Area",2003,13254,-343,179,232,53,-532,-67,-465,10
"28980",NA,2150,"Kodiak Island Borough, AK","County or equivalent",2003,13254,-343,179,232,53,-532,-67,-465,10
"29060",NA,NA,"Laconia, NH","Micropolitan Statistical Area",2003,59960,976,7,577,570,979,37,942,-10
"29060",NA,33001,"Belknap County, NH","County or equivalent",2003,59960,976,7,577,570,979,37,942,-10
"29220",NA,NA,"La Follette, TN","Micropolitan Statistical Area",2003,39958,119,31,487,456,134,21,113,-46
"29220",NA,47013,"Campbell County, TN","County or equivalent",2003,39958,119,31,487,456,134,21,113,-46
"29260",NA,NA,"La Grande, OR","Micropolitan Statistical Area",2003,24473,6,70,300,230,-32,21,-53,-32
"29260",NA,41061,"Union County, OR","County or equivalent",2003,24473,6,70,300,230,-32,21,-53,-32
"29300",NA,NA,"LaGrange, GA","Micropolitan Statistical Area",2003,60148,321,253,922,669,155,64,91,-87
"29300",NA,13285,"Troup County, GA","County or equivalent",2003,60148,321,253,922,669,155,64,91,-87
"29380",NA,NA,"Lake City, FL","Micropolitan Statistical Area",2003,59883,1560,150,807,657,1397,22,1375,13
"29380",NA,12023,"Columbia County, FL","County or equivalent",2003,59883,1560,150,807,657,1397,22,1375,13
"29500",NA,NA,"Lamesa, TX","Micropolitan Statistical Area",2003,14329,-89,40,188,148,-117,21,-138,-12
"29500",NA,48115,"Dawson County, TX","County or equivalent",2003,14329,-89,40,188,148,-117,21,-138,-12
"29580",NA,NA,"Lancaster, SC","Micropolitan Statistical Area",2003,66504,1648,209,781,572,131,54,77,1308
"29580",NA,45057,"Lancaster County, SC","County or equivalent",2003,66504,1648,209,781,572,131,54,77,1308
"29660",NA,NA,"Laramie, WY","Micropolitan Statistical Area",2003,32436,187,199,394,195,35,53,-18,-47
"29660",NA,56001,"Albany County, WY","County or equivalent",2003,32436,187,199,394,195,35,53,-18,-47
"29780",NA,NA,"Las Vegas, NM","Micropolitan Statistical Area",2003,29171,-313,83,349,266,-379,7,-386,-17
"29780",NA,35047,"San Miguel County, NM","County or equivalent",2003,29171,-313,83,349,266,-379,7,-386,-17
"29860",NA,NA,"Laurel, MS","Micropolitan Statistical Area",2003,82942,-156,299,1164,865,-364,123,-487,-91
"29860",NA,28061,"Jasper County, MS","County or equivalent",2003,18063,-159,40,212,172,-185,2,-187,-14
"29860",NA,28067,"Jones County, MS","County or equivalent",2003,64879,3,259,952,693,-179,121,-300,-77
"29900",NA,NA,"Laurinburg, NC","Micropolitan Statistical Area",2003,35491,-36,100,464,364,-88,13,-101,-48
"29900",NA,37165,"Scotland County, NC","County or equivalent",2003,35491,-36,100,464,364,-88,13,-101,-48
"29980",NA,NA,"Lawrenceburg, TN","Micropolitan Statistical Area",2003,40469,-25,162,596,434,-133,10,-143,-54
"29980",NA,47099,"Lawrence County, TN","County or equivalent",2003,40469,-25,162,596,434,-133,10,-143,-54
"30060",NA,NA,"Lebanon, MO","Micropolitan Statistical Area",2003,33138,276,106,439,333,201,2,199,-31
"30060",NA,29105,"Laclede County, MO","County or equivalent",2003,33138,276,106,439,333,201,2,199,-31
"30100",NA,NA,"Lebanon, NH-VT","Micropolitan Statistical Area",2003,169690,854,188,1671,1483,849,105,744,-183
"30100",NA,33009,"Grafton County, NH","County or equivalent",2003,83239,737,164,832,668,649,81,568,-76
"30100",NA,50017,"Orange County, VT","County or equivalent",2003,28828,164,18,271,253,171,-3,174,-25
"30100",NA,50027,"Windsor County, VT","County or equivalent",2003,57623,-47,6,568,562,29,27,2,-82
"30220",NA,NA,"Levelland, TX","Micropolitan Statistical Area",2003,22660,93,115,336,221,11,21,-10,-33
"30220",NA,48219,"Hockley County, TX","County or equivalent",2003,22660,93,115,336,221,11,21,-10,-33
"30260",NA,NA,"Lewisburg, PA","Micropolitan Statistical Area",2003,42063,20,54,417,363,27,10,17,-61
"30260",NA,42119,"Union County, PA","County or equivalent",2003,42063,20,54,417,363,27,10,17,-61
"30280",NA,NA,"Lewisburg, TN","Micropolitan Statistical Area",2003,27396,122,118,361,243,44,31,13,-40
"30280",NA,47117,"Marshall County, TN","County or equivalent",2003,27396,122,118,361,243,44,31,13,-40
"30380",NA,NA,"Lewistown, PA","Micropolitan Statistical Area",2003,46180,-240,99,616,517,-291,2,-293,-48
"30380",NA,42087,"Mifflin County, PA","County or equivalent",2003,46180,-240,99,616,517,-291,2,-293,-48
"30420",NA,NA,"Lexington, NE","Micropolitan Statistical Area",2003,26353,76,195,437,242,-97,174,-271,-22
"30420",NA,31047,"Dawson County, NE","County or equivalent",2003,24285,64,197,411,214,-113,173,-286,-20
"30420",NA,31073,"Gosper County, NE","County or equivalent",2003,2068,12,-2,26,28,16,1,15,-2
"30500",NA,NA,"Lexington Park, MD","Micropolitan Statistical Area",2003,92606,2746,717,1339,622,1986,-364,2350,43
"30500",NA,24037,"St. Mary's County, MD","County or equivalent",2003,92606,2746,717,1339,622,1986,-364,2350,43
"30580",NA,NA,"Liberal, KS","Micropolitan Statistical Area",2003,22736,6,422,554,132,-426,302,-728,10
"30580",NA,20175,"Seward County, KS","County or equivalent",2003,22736,6,422,554,132,-426,302,-728,10
"30660",NA,NA,"Lincoln, IL","Micropolitan Statistical Area",2003,30485,-226,6,346,340,-203,4,-207,-29
"30660",NA,17107,"Logan County, IL","County or equivalent",2003,30485,-226,6,346,340,-203,4,-207,-29
"30740",NA,NA,"Lincolnton, NC","Micropolitan Statistical Area",2003,66868,846,268,842,574,653,235,418,-75
"30740",NA,37109,"Lincoln County, NC","County or equivalent",2003,66868,846,268,842,574,653,235,418,-75
"30820",NA,NA,"Lock Haven, PA","Micropolitan Statistical Area",2003,37396,-134,21,417,396,-101,8,-109,-54
"30820",NA,42035,"Clinton County, PA","County or equivalent",2003,37396,-134,21,417,396,-101,8,-109,-54
"30900",NA,NA,"Logansport, IN","Micropolitan Statistical Area",2003,40151,-209,104,529,425,-279,82,-361,-34
"30900",NA,18017,"Cass County, IN","County or equivalent",2003,40151,-209,104,529,425,-279,82,-361,-34
"30940",NA,NA,"London, KY","Micropolitan Statistical Area",2003,55100,800,284,763,479,554,23,531,-38
"30940",NA,21125,"Laurel County, KY","County or equivalent",2003,55100,800,284,763,479,554,23,531,-38
"31060",NA,NA,"Los Alamos, NM","Micropolitan Statistical Area",2003,18490,364,73,176,103,297,59,238,-6
"31060",NA,35028,"Los Alamos County, NM","County or equivalent",2003,18490,364,73,176,103,297,59,238,-6
"31260",NA,NA,"Lufkin, TX","Micropolitan Statistical Area",2003,80575,367,503,1288,785,-28,147,-175,-108
"31260",NA,48005,"Angelina County, TX","County or equivalent",2003,80575,367,503,1288,785,-28,147,-175,-108
"31300",NA,NA,"Lumberton, NC","Micropolitan Statistical Area",2003,124483,540,808,2031,1223,-99,394,-493,-169
"31300",NA,37155,"Robeson County, NC","County or equivalent",2003,124483,540,808,2031,1223,-99,394,-493,-169
"31380",NA,NA,"Macomb, IL","Micropolitan Statistical Area",2003,32982,184,-13,291,304,231,57,174,-34
"31380",NA,17109,"McDonough County, IL","County or equivalent",2003,32982,184,-13,291,304,231,57,174,-34
"31500",NA,NA,"Madison, IN","Micropolitan Statistical Area",2003,31897,-66,38,350,312,-61,4,-65,-43
"31500",NA,18077,"Jefferson County, IN","County or equivalent",2003,31897,-66,38,350,312,-61,4,-65,-43
"31580",NA,NA,"Madisonville, KY","Micropolitan Statistical Area",2003,46408,186,-50,529,579,291,8,283,-55
"31580",NA,21107,"Hopkins County, KY","County or equivalent",2003,46408,186,-50,529,579,291,8,283,-55
"31620",NA,NA,"Magnolia, AR","Micropolitan Statistical Area",2003,24821,-353,-18,282,300,-317,9,-326,-18
"31620",NA,5027,"Columbia County, AR","County or equivalent",2003,24821,-353,-18,282,300,-317,9,-326,-18
"31660",NA,NA,"Malone, NY","Micropolitan Statistical Area",2003,50665,103,37,479,442,131,3,128,-65
"31660",NA,36033,"Franklin County, NY","County or equivalent",2003,50665,103,37,479,442,131,3,128,-65
"31740",NA,NA,"Manhattan, KS","Micropolitan Statistical Area",2003,112524,2364,1141,1794,653,-241,-1152,911,1464
"31740",NA,20061,"Geary County, KS","County or equivalent",2003,28606,460,388,589,201,-494,-408,-86,566
"31740",NA,20149,"Pottawatomie County, KS","County or equivalent",2003,18543,218,115,274,159,121,-10,131,-18
"31740",NA,20161,"Riley County, KS","County or equivalent",2003,65375,1686,638,931,293,132,-734,866,916
"31820",NA,NA,"Manitowoc, WI","Micropolitan Statistical Area",2003,81535,-516,83,859,776,-516,73,-589,-83
"31820",NA,55071,"Manitowoc County, WI","County or equivalent",2003,81535,-516,83,859,776,-516,73,-589,-83
"31860",NA,NA,"Mankato-North Mankato, MN","Micropolitan Statistical Area",2003,88178,807,414,1050,636,500,90,410,-107
"31860",NA,27013,"Blue Earth County, MN","County or equivalent",2003,57635,673,241,690,449,493,62,431,-61
"31860",NA,27103,"Nicollet County, MN","County or equivalent",2003,30543,134,173,360,187,7,28,-21,-46
"31940",NA,NA,"Marinette, WI-MI","Micropolitan Statistical Area",2003,67955,-231,-81,691,772,-58,9,-67,-92
"31940",NA,26109,"Menominee County, MI","County or equivalent",2003,24919,-62,-8,259,267,-18,5,-23,-36
"31940",NA,55075,"Marinette County, WI","County or equivalent",2003,43036,-169,-73,432,505,-40,4,-44,-56
"31980",NA,NA,"Marion, IN","Micropolitan Statistical Area",2003,71600,-499,-30,787,817,-394,10,-404,-75
"31980",NA,18053,"Grant County, IN","County or equivalent",2003,71600,-499,-30,787,817,-394,10,-404,-75
"32020",NA,NA,"Marion, OH","Micropolitan Statistical Area",2003,65903,23,88,784,696,29,10,19,-94
"32020",NA,39101,"Marion County, OH","County or equivalent",2003,65903,23,88,784,696,29,10,19,-94
"32060",NA,NA,"Marion-Herrin, IL","Micropolitan Statistical Area",2003,62322,233,45,785,740,246,5,241,-58
"32060",NA,17199,"Williamson County, IL","County or equivalent",2003,62322,233,45,785,740,246,5,241,-58
"32100",NA,NA,"Marquette, MI","Micropolitan Statistical Area",2003,64640,-122,-32,613,645,4,10,-6,-94
"32100",NA,26103,"Marquette County, MI","County or equivalent",2003,64640,-122,-32,613,645,4,10,-6,-94
"32140",NA,NA,"Marshall, MN","Micropolitan Statistical Area",2003,24728,-240,107,321,214,-339,42,-381,-8
"32140",NA,27083,"Lyon County, MN","County or equivalent",2003,24728,-240,107,321,214,-339,42,-381,-8
"32180",NA,NA,"Marshall, MO","Micropolitan Statistical Area",2003,22859,-98,51,294,243,-127,32,-159,-22
"32180",NA,29195,"Saline County, MO","County or equivalent",2003,22859,-98,51,294,243,-127,32,-159,-22
"32220",NA,NA,"Marshall, TX","Micropolitan Statistical Area",2003,61792,-181,242,817,575,-352,73,-425,-71
"32220",NA,48203,"Harrison County, TX","County or equivalent",2003,61792,-181,242,817,575,-352,73,-425,-71
"32260",NA,NA,"Marshalltown, IA","Micropolitan Statistical Area",2003,39040,14,68,562,494,-15,122,-137,-39
"32260",NA,19127,"Marshall County, IA","County or equivalent",2003,39040,14,68,562,494,-15,122,-137,-39
"32270",NA,NA,"Marshfield-Wisconsin Rapids, WI","Micropolitan Statistical Area",2003,74877,-221,120,831,711,-257,51,-308,-84
"32270",NA,55141,"Wood County, WI","County or equivalent",2003,74877,-221,120,831,711,-257,51,-308,-84
"32280",NA,NA,"Martin, TN","Micropolitan Statistical Area",2003,33921,-270,-33,348,381,-203,36,-239,-34
"32280",NA,47183,"Weakley County, TN","County or equivalent",2003,33921,-270,-33,348,381,-203,36,-239,-34
"32300",NA,NA,"Martinsville, VA","Micropolitan Statistical Area",2003,71595,-508,-37,772,809,-399,165,-564,-72
"32300",NA,51089,"Henry County, VA","County or equivalent",2003,56571,-491,28,606,578,-468,130,-598,-51
"32300",NA,51690,"Martinsville city, VA","County or equivalent",2003,15024,-17,-65,166,231,69,35,34,-21
"32340",NA,NA,"Maryville, MO","Micropolitan Statistical Area",2003,21924,-62,30,213,183,-63,13,-76,-29
"32340",NA,29147,"Nodaway County, MO","County or equivalent",2003,21924,-62,30,213,183,-63,13,-76,-29
"32380",NA,NA,"Mason City, IA","Micropolitan Statistical Area",2003,52868,-193,-37,585,622,-85,22,-107,-71
"32380",NA,19033,"Cerro Gordo County, IA","County or equivalent",2003,45146,-118,-13,502,515,-46,20,-66,-59
"32380",NA,19195,"Worth County, IA","County or equivalent",2003,7722,-75,-24,83,107,-39,2,-41,-12
"32460",NA,NA,"Mayfield, KY","Micropolitan Statistical Area",2003,37106,161,34,480,446,175,60,115,-48
"32460",NA,21083,"Graves County, KY","County or equivalent",2003,37106,161,34,480,446,175,60,115,-48
"32500",NA,NA,"Maysville, KY","Micropolitan Statistical Area",2003,30354,-159,-3,340,343,-119,11,-130,-37
"32500",NA,21135,"Lewis County, KY","County or equivalent",2003,13658,-46,-6,138,144,-19,0,-19,-21
"32500",NA,21161,"Mason County, KY","County or equivalent",2003,16696,-113,3,202,199,-100,11,-111,-16
"32540",NA,NA,"McAlester, OK","Micropolitan Statistical Area",2003,43703,-77,-57,505,562,41,6,35,-61
"32540",NA,40121,"Pittsburg County, OK","County or equivalent",2003,43703,-77,-57,505,562,41,6,35,-61
"32620",NA,NA,"McComb, MS","Micropolitan Statistical Area",2003,51919,-164,185,788,603,-291,-5,-286,-58
"32620",NA,28005,"Amite County, MS","County or equivalent",2003,13409,-12,-4,152,156,9,-2,11,-17
"32620",NA,28113,"Pike County, MS","County or equivalent",2003,38510,-152,189,636,447,-300,-3,-297,-41
"32660",NA,NA,"McMinnville, TN","Micropolitan Statistical Area",2003,38980,348,154,561,407,244,97,147,-50
"32660",NA,47177,"Warren County, TN","County or equivalent",2003,38980,348,154,561,407,244,97,147,-50
"32700",NA,NA,"McPherson, KS","Micropolitan Statistical Area",2003,29180,-35,-3,330,333,10,0,10,-42
"32700",NA,20113,"McPherson County, KS","County or equivalent",2003,29180,-35,-3,330,333,10,0,10,-42
"32740",NA,NA,"Meadville, PA","Micropolitan Statistical Area",2003,89608,-333,89,1018,929,-315,1,-316,-107
"32740",NA,42039,"Crawford County, PA","County or equivalent",2003,89608,-333,89,1018,929,-315,1,-316,-107
"32860",NA,NA,"Menomonie, WI","Micropolitan Statistical Area",2003,40962,166,189,469,280,37,24,13,-60
"32860",NA,55033,"Dunn County, WI","County or equivalent",2003,40962,166,189,469,280,37,24,13,-60
"32940",NA,NA,"Meridian, MS","Micropolitan Statistical Area",2003,105654,-97,273,1535,1262,-235,-207,-28,-135
"32940",NA,28023,"Clarke County, MS","County or equivalent",2003,17578,-127,65,247,182,-175,-3,-172,-17
"32940",NA,28069,"Kemper County, MS","County or equivalent",2003,10390,-45,28,137,109,-56,2,-58,-17
"32940",NA,28075,"Lauderdale County, MS","County or equivalent",2003,77686,75,180,1151,971,-4,-206,202,-101
"32980",NA,NA,"Merrill, WI","Micropolitan Statistical Area",2003,29784,-5,-37,288,325,76,14,62,-44
"32980",NA,55069,"Lincoln County, WI","County or equivalent",2003,29784,-5,-37,288,325,76,14,62,-44
"33020",NA,NA,"Mexico, MO","Micropolitan Statistical Area",2003,25748,-57,54,388,334,-80,1,-81,-31
"33020",NA,29007,"Audrain County, MO","County or equivalent",2003,25748,-57,54,388,334,-80,1,-81,-31
"33060",NA,NA,"Miami, OK","Micropolitan Statistical Area",2003,32410,-212,-17,397,414,-155,14,-169,-40
"33060",NA,40115,"Ottawa County, OK","County or equivalent",2003,32410,-212,-17,397,414,-155,14,-169,-40
"33180",NA,NA,"Middlesborough, KY","Micropolitan Statistical Area",2003,29569,-210,-47,367,414,-127,11,-138,-36
"33180",NA,21013,"Bell County, KY","County or equivalent",2003,29569,-210,-47,367,414,-127,11,-138,-36
"33220",NA,NA,"Midland, MI","Micropolitan Statistical Area",2003,83558,118,369,996,627,-146,113,-259,-105
"33220",NA,26111,"Midland County, MI","County or equivalent",2003,83558,118,369,996,627,-146,113,-259,-105
"33300",NA,NA,"Milledgeville, GA","Micropolitan Statistical Area",2003,54661,-21,115,641,526,-57,15,-72,-79
"33300",NA,13009,"Baldwin County, GA","County or equivalent",2003,45038,78,122,540,418,26,17,9,-70
"33300",NA,13141,"Hancock County, GA","County or equivalent",2003,9623,-99,-7,101,108,-83,-2,-81,-9
"33380",NA,NA,"Minden, LA","Micropolitan Statistical Area",2003,40908,-338,-32,513,545,-264,4,-268,-42
"33380",NA,22119,"Webster Parish, LA","County or equivalent",2003,40908,-338,-32,513,545,-264,4,-268,-42
"33420",NA,NA,"Mineral Wells, TX","Micropolitan Statistical Area",2003,27131,85,36,358,322,84,37,47,-35
"33420",NA,48363,"Palo Pinto County, TX","County or equivalent",2003,27131,85,36,358,322,84,37,47,-35
"33500",NA,NA,"Minot, ND","Micropolitan Statistical Area",2003,64947,-424,380,959,579,-710,-648,-62,-94
"33500",NA,38049,"McHenry County, ND","County or equivalent",2003,5668,-51,-9,51,60,-34,-4,-30,-8
"33500",NA,38075,"Renville County, ND","County or equivalent",2003,2462,-52,-8,26,34,-42,-6,-36,-2
"33500",NA,38101,"Ward County, ND","County or equivalent",2003,56817,-321,397,882,485,-634,-638,4,-84
"33580",NA,NA,"Mitchell, SD","Micropolitan Statistical Area",2003,22138,64,88,299,211,2,6,-4,-26
"33580",NA,46035,"Davison County, SD","County or equivalent",2003,18728,-8,51,245,194,-34,4,-38,-25
"33580",NA,46061,"Hanson County, SD","County or equivalent",2003,3410,72,37,54,17,36,2,34,-1
"33620",NA,NA,"Moberly, MO","Micropolitan Statistical Area",2003,25005,299,32,336,304,281,17,264,-14
"33620",NA,29175,"Randolph County, MO","County or equivalent",2003,25005,299,32,336,304,281,17,264,-14
"33820",NA,NA,"Monroe, WI","Micropolitan Statistical Area",2003,34060,31,-1,361,362,85,8,77,-53
"33820",NA,55045,"Green County, WI","County or equivalent",2003,34060,31,-1,361,362,85,8,77,-53
"33940",NA,NA,"Montrose, CO","Micropolitan Statistical Area",2003,35669,565,102,448,346,496,42,454,-33
"33940",NA,8085,"Montrose County, CO","County or equivalent",2003,35669,565,102,448,346,496,42,454,-33
"33980",NA,NA,"Morehead City, NC","Micropolitan Statistical Area",2003,60958,711,-138,574,712,784,-93,877,65
"33980",NA,37031,"Carteret County, NC","County or equivalent",2003,60958,711,-138,574,712,784,-93,877,65
"34020",NA,NA,"Morgan City, LA","Micropolitan Statistical Area",2003,51883,-296,238,747,509,-489,21,-510,-45
"34020",NA,22101,"St. Mary Parish, LA","County or equivalent",2003,51883,-296,238,747,509,-489,21,-510,-45
"34140",NA,NA,"Moscow, ID","Micropolitan Statistical Area",2003,35460,287,166,388,222,169,52,117,-48
"34140",NA,16057,"Latah County, ID","County or equivalent",2003,35460,287,166,388,222,169,52,117,-48
"34180",NA,NA,"Moses Lake, WA","Micropolitan Statistical Area",2003,78002,956,790,1393,603,261,603,-342,-95
"34180",NA,53025,"Grant County, WA","County or equivalent",2003,78002,956,790,1393,603,261,603,-342,-95
"34220",NA,NA,"Moultrie, GA","Micropolitan Statistical Area",2003,42786,100,215,661,446,-61,117,-178,-54
"34220",NA,13071,"Colquitt County, GA","County or equivalent",2003,42786,100,215,661,446,-61,117,-178,-54
"34260",NA,NA,"Mountain Home, AR","Micropolitan Statistical Area",2003,38948,303,-261,357,618,575,-2,577,-11
"34260",NA,5005,"Baxter County, AR","County or equivalent",2003,38948,303,-261,357,618,575,-2,577,-11
"34300",NA,NA,"Mountain Home, ID","Micropolitan Statistical Area",2003,28881,-425,371,514,143,-778,-414,-364,-18
"34300",NA,16039,"Elmore County, ID","County or equivalent",2003,28881,-425,371,514,143,-778,-414,-364,-18
"34340",NA,NA,"Mount Airy, NC","Micropolitan Statistical Area",2003,71991,91,162,912,750,24,185,-161,-95
"34340",NA,37171,"Surry County, NC","County or equivalent",2003,71991,91,162,912,750,24,185,-161,-95
"34380",NA,NA,"Mount Pleasant, MI","Micropolitan Statistical Area",2003,65024,797,269,698,429,584,73,511,-56
"34380",NA,26073,"Isabella County, MI","County or equivalent",2003,65024,797,269,698,429,584,73,511,-56
"34420",NA,NA,"Mount Pleasant, TX","Micropolitan Statistical Area",2003,28480,397,271,510,239,167,202,-35,-41
"34420",NA,48449,"Titus County, TX","County or equivalent",2003,28480,397,271,510,239,167,202,-35,-41
"34460",NA,NA,"Mount Sterling, KY","Micropolitan Statistical Area",2003,41569,252,125,555,430,164,-2,166,-37
"34460",NA,21011,"Bath County, KY","County or equivalent",2003,11445,27,18,152,134,23,-4,27,-14
"34460",NA,21165,"Menifee County, KY","County or equivalent",2003,6688,-49,23,82,59,-66,-2,-64,-6
"34460",NA,21173,"Montgomery County, KY","County or equivalent",2003,23436,274,84,321,237,207,4,203,-17
"34500",NA,NA,"Mount Vernon, IL","Micropolitan Statistical Area",2003,48364,-47,8,555,547,11,1,10,-66
"34500",NA,17065,"Hamilton County, IL","County or equivalent",2003,8320,-51,-10,87,97,-28,1,-29,-13
"34500",NA,17081,"Jefferson County, IL","County or equivalent",2003,40044,4,18,468,450,39,0,39,-53
"34540",NA,NA,"Mount Vernon, OH","Micropolitan Statistical Area",2003,56835,702,165,721,556,582,8,574,-45
"34540",NA,39083,"Knox County, OH","County or equivalent",2003,56835,702,165,721,556,582,8,574,-45
"34660",NA,NA,"Murray, KY","Micropolitan Statistical Area",2003,34704,311,-19,335,354,358,60,298,-28
"34660",NA,21035,"Calloway County, KY","County or equivalent",2003,34704,311,-19,335,354,358,60,298,-28
"34700",NA,NA,"Muscatine, IA","Micropolitan Statistical Area",2003,53850,-141,309,811,502,-408,94,-502,-42
"34700",NA,19115,"Louisa County, IA","County or equivalent",2003,12176,-19,65,169,104,-71,27,-98,-13
"34700",NA,19139,"Muscatine County, IA","County or equivalent",2003,41674,-122,244,642,398,-337,67,-404,-29
"34780",NA,NA,"Muskogee, OK","Micropolitan Statistical Area",2003,69938,446,196,976,780,336,60,276,-86
"34780",NA,40101,"Muskogee County, OK","County or equivalent",2003,69938,446,196,976,780,336,60,276,-86
"34860",NA,NA,"Nacogdoches, TX","Micropolitan Statistical Area",2003,59945,409,423,926,503,69,172,-103,-83
"34860",NA,48347,"Nacogdoches County, TX","County or equivalent",2003,59945,409,423,926,503,69,172,-103,-83
"35020",NA,NA,"Natchez, MS-LA","Micropolitan Statistical Area",2003,52400,-699,77,693,616,-744,0,-744,-32
"35020",NA,22029,"Concordia Parish, LA","County or equivalent",2003,19483,-255,33,225,192,-275,-2,-273,-13
"35020",NA,28001,"Adams County, MS","County or equivalent",2003,32917,-444,44,468,424,-469,2,-471,-19
"35060",NA,NA,"Natchitoches, LA","Micropolitan Statistical Area",2003,38691,-336,201,598,397,-519,25,-544,-18
"35060",NA,22069,"Natchitoches Parish, LA","County or equivalent",2003,38691,-336,201,598,397,-519,25,-544,-18
"35100",NA,NA,"New Bern, NC","Micropolitan Statistical Area",2003,116664,1116,597,1725,1128,-15,-1147,1132,534
"35100",NA,37049,"Craven County, NC","County or equivalent",2003,93973,1369,671,1535,864,143,-1151,1294,555
"35100",NA,37103,"Jones County, NC","County or equivalent",2003,10013,-154,-32,92,124,-115,0,-115,-7
"35100",NA,37137,"Pamlico County, NC","County or equivalent",2003,12678,-99,-42,98,140,-43,4,-47,-14
"35140",NA,NA,"Newberry, SC","Micropolitan Statistical Area",2003,36595,53,73,455,382,31,104,-73,-51
"35140",NA,45071,"Newberry County, SC","County or equivalent",2003,36595,53,73,455,382,31,104,-73,-51
"35220",NA,NA,"New Castle, IN","Micropolitan Statistical Area",2003,47674,-288,32,573,541,-264,-1,-263,-56
"35220",NA,18065,"Henry County, IN","County or equivalent",2003,47674,-288,32,573,541,-264,-1,-263,-56
"35260",NA,NA,"New Castle, PA","Micropolitan Statistical Area",2003,93268,-454,-175,1030,1205,-160,2,-162,-119
"35260",NA,42073,"Lawrence County, PA","County or equivalent",2003,93268,-454,-175,1030,1205,-160,2,-162,-119
"35340",NA,NA,"New Iberia, LA","Micropolitan Statistical Area",2003,73378,44,499,1145,646,-375,21,-396,-80
"35340",NA,22045,"Iberia Parish, LA","County or equivalent",2003,73378,44,499,1145,646,-375,21,-396,-80
"35420",NA,NA,"New Philadelphia-Dover, OH","Micropolitan Statistical Area",2003,91419,45,315,1234,919,-150,25,-175,-120
"35420",NA,39157,"Tuscarawas County, OH","County or equivalent",2003,91419,45,315,1234,919,-150,25,-175,-120
"35460",NA,NA,"Newport, TN","Micropolitan Statistical Area",2003,34288,307,-1,428,429,336,4,332,-28
"35460",NA,47029,"Cocke County, TN","County or equivalent",2003,34288,307,-1,428,429,336,4,332,-28
"35500",NA,NA,"Newton, IA","Micropolitan Statistical Area",2003,37406,37,121,463,342,-32,17,-49,-52
"35500",NA,19099,"Jasper County, IA","County or equivalent",2003,37406,37,121,463,342,-32,17,-49,-52
"35580",NA,NA,"New Ulm, MN","Micropolitan Statistical Area",2003,26633,-204,24,288,264,-206,4,-210,-22
"35580",NA,27015,"Brown County, MN","County or equivalent",2003,26633,-204,24,288,264,-206,4,-210,-22
"35700",NA,NA,"Nogales, AZ","Micropolitan Statistical Area",2003,39462,241,463,702,239,-189,231,-420,-33
"35700",NA,4023,"Santa Cruz County, AZ","County or equivalent",2003,39462,241,463,702,239,-189,231,-420,-33
"35740",NA,NA,"Norfolk, NE","Micropolitan Statistical Area",2003,49768,-91,281,742,461,-328,71,-399,-44
"35740",NA,31119,"Madison County, NE","County or equivalent",2003,35698,-58,237,573,336,-270,62,-332,-25
"35740",NA,31139,"Pierce County, NE","County or equivalent",2003,7592,-27,25,91,66,-43,2,-45,-9
"35740",NA,31167,"Stanton County, NE","County or equivalent",2003,6478,-6,19,78,59,-15,7,-22,-10
"35820",NA,NA,"North Platte, NE","Micropolitan Statistical Area",2003,35776,117,116,481,365,41,16,25,-40
"35820",NA,31111,"Lincoln County, NE","County or equivalent",2003,34525,163,121,467,346,83,14,69,-41
"35820",NA,31113,"Logan County, NE","County or equivalent",2003,731,-30,-2,12,14,-29,1,-30,1
"35820",NA,31117,"McPherson County, NE","County or equivalent",2003,520,-16,-3,2,5,-13,1,-14,0
"35860",NA,NA,"North Vernon, IN","Micropolitan Statistical Area",2003,27844,-184,102,364,262,-264,6,-270,-22
"35860",NA,18079,"Jennings County, IN","County or equivalent",2003,27844,-184,102,364,262,-264,6,-270,-22
"35900",NA,NA,"North Wilkesboro, NC","Micropolitan Statistical Area",2003,66590,66,203,876,673,-47,139,-186,-90
"35900",NA,37193,"Wilkes County, NC","County or equivalent",2003,66590,66,203,876,673,-47,139,-186,-90
"35940",NA,NA,"Norwalk, OH","Micropolitan Statistical Area",2003,59792,-33,342,843,501,-312,47,-359,-63
"35940",NA,39077,"Huron County, OH","County or equivalent",2003,59792,-33,342,843,501,-312,47,-359,-63
"36020",NA,NA,"Oak Harbor, WA","Micropolitan Statistical Area",2003,76596,1030,388,962,574,653,-919,1572,-11
"36020",NA,53029,"Island County, WA","County or equivalent",2003,76596,1030,388,962,574,653,-919,1572,-11
"36060",NA,NA,"Oak Hill, WV","Micropolitan Statistical Area",2003,47103,112,-19,561,580,186,8,178,-55
"36060",NA,54019,"Fayette County, WV","County or equivalent",2003,47103,112,-19,561,580,186,8,178,-55
"36180",NA,NA,"Ocean Pines, MD","Micropolitan Statistical Area",2003,48681,490,-48,479,527,573,46,527,-35
"36180",NA,24047,"Worcester County, MD","County or equivalent",2003,48681,490,-48,479,527,573,46,527,-35
"36300",NA,NA,"Ogdensburg-Massena, NY","Micropolitan Statistical Area",2003,110370,-299,167,1198,1031,-312,49,-361,-154
"36300",NA,36089,"St. Lawrence County, NY","County or equivalent",2003,110370,-299,167,1198,1031,-312,49,-361,-154
"36340",NA,NA,"Oil City, PA","Micropolitan Statistical Area",2003,56306,-331,-92,574,666,-162,-3,-159,-77
"36340",NA,42121,"Venango County, PA","County or equivalent",2003,56306,-331,-92,574,666,-162,-3,-159,-77
"36380",NA,NA,"Okeechobee, FL","Micropolitan Statistical Area",2003,37233,456,124,535,411,381,177,204,-49
"36380",NA,12093,"Okeechobee County, FL","County or equivalent",2003,37233,456,124,535,411,381,177,204,-49
"36460",NA,NA,"Olean, NY","Micropolitan Statistical Area",2003,82983,-151,191,1031,840,-225,7,-232,-117
"36460",NA,36009,"Cattaraugus County, NY","County or equivalent",2003,82983,-151,191,1031,840,-225,7,-232,-117
"36580",NA,NA,"Oneonta, NY","Micropolitan Statistical Area",2003,62139,358,-74,566,640,484,10,474,-52
"36580",NA,36077,"Otsego County, NY","County or equivalent",2003,62139,358,-74,566,640,484,10,474,-52
"36620",NA,NA,"Ontario, OR-ID","Micropolitan Statistical Area",2003,52388,4,325,761,436,-278,111,-389,-43
"36620",NA,16075,"Payette County, ID","County or equivalent",2003,21255,193,140,313,173,82,16,66,-29
"36620",NA,41045,"Malheur County, OR","County or equivalent",2003,31133,-189,185,448,263,-360,95,-455,-14
"36660",NA,NA,"Opelousas-Eunice, LA","Micropolitan Statistical Area",2003,87957,160,419,1337,918,-141,6,-147,-118
"36660",NA,22097,"St. Landry Parish, LA","County or equivalent",2003,87957,160,419,1337,918,-141,6,-147,-118
"36700",NA,NA,"Orangeburg, SC","Micropolitan Statistical Area",2003,90931,-197,274,1251,977,-357,15,-372,-114
"36700",NA,45075,"Orangeburg County, SC","County or equivalent",2003,90931,-197,274,1251,977,-357,15,-372,-114
"36820",NA,NA,"Oskaloosa, IA","Micropolitan Statistical Area",2003,22026,-285,30,246,216,-299,20,-319,-16
"36820",NA,19123,"Mahaska County, IA","County or equivalent",2003,22026,-285,30,246,216,-299,20,-319,-16
"36860",NA,NA,"Ottawa-Streator, IL","Micropolitan Statistical Area",2003,151249,-1144,205,1943,1738,-1228,90,-1318,-121
"36860",NA,17011,"Bureau County, IL","County or equivalent",2003,34977,-31,33,462,429,-15,11,-26,-49
"36860",NA,17099,"LaSalle County, IL","County or equivalent",2003,110193,-1119,163,1418,1255,-1218,78,-1296,-64
"36860",NA,17155,"Putnam County, IL","County or equivalent",2003,6079,6,9,63,54,5,1,4,-8
"36900",NA,NA,"Ottumwa, IA","Micropolitan Statistical Area",2003,35720,-82,55,457,402,-91,29,-120,-46
"36900",NA,19179,"Wapello County, IA","County or equivalent",2003,35720,-82,55,457,402,-91,29,-120,-46
"36940",NA,NA,"Owatonna, MN","Micropolitan Statistical Area",2003,34663,327,206,510,304,165,77,88,-44
"36940",NA,27147,"Steele County, MN","County or equivalent",2003,34663,327,206,510,304,165,77,88,-44
"37020",NA,NA,"Owosso, MI","Micropolitan Statistical Area",2003,72152,163,212,846,634,57,1,56,-106
"37020",NA,26155,"Shiawassee County, MI","County or equivalent",2003,72152,163,212,846,634,57,1,56,-106
"37060",NA,NA,"Oxford, MS","Micropolitan Statistical Area",2003,40649,1120,188,492,304,935,43,892,-3
"37060",NA,28071,"Lafayette County, MS","County or equivalent",2003,40649,1120,188,492,304,935,43,892,-3
"37140",NA,NA,"Paducah, KY-IL","Micropolitan Statistical Area",2003,97385,-255,-10,1164,1174,-109,6,-115,-136
"37140",NA,17127,"Massac County, IL","County or equivalent",2003,15048,-58,-34,197,231,-4,1,-5,-20
"37140",NA,21007,"Ballard County, KY","County or equivalent",2003,8234,79,13,107,94,75,2,73,-9
"37140",NA,21139,"Livingston County, KY","County or equivalent",2003,9683,-82,-21,88,109,-48,-1,-47,-13
"37140",NA,21145,"McCracken County, KY","County or equivalent",2003,64420,-194,32,772,740,-132,4,-136,-94
"37220",NA,NA,"Pahrump, NV","Micropolitan Statistical Area",2003,35624,1041,-117,311,428,1137,43,1094,21
"37220",NA,32023,"Nye County, NV","County or equivalent",2003,35624,1041,-117,311,428,1137,43,1094,21
"37260",NA,NA,"Palatka, FL","Micropolitan Statistical Area",2003,71160,221,-9,907,916,305,58,247,-75
"37260",NA,12107,"Putnam County, FL","County or equivalent",2003,71160,221,-9,907,916,305,58,247,-75
"37300",NA,NA,"Palestine, TX","Micropolitan Statistical Area",2003,55563,1206,48,640,592,1156,54,1102,2
"37300",NA,48001,"Anderson County, TX","County or equivalent",2003,55563,1206,48,640,592,1156,54,1102,2
"37420",NA,NA,"Pampa, TX","Micropolitan Statistical Area",2003,22314,-291,-21,253,274,-256,46,-302,-14
"37420",NA,48179,"Gray County, TX","County or equivalent",2003,21510,-248,-13,251,264,-218,45,-263,-17
"37420",NA,48393,"Roberts County, TX","County or equivalent",2003,804,-43,-8,2,10,-38,1,-39,3
"37500",NA,NA,"Paragould, AR","Micropolitan Statistical Area",2003,38301,273,162,550,388,159,6,153,-48
"37500",NA,5055,"Greene County, AR","County or equivalent",2003,38301,273,162,550,388,159,6,153,-48
"37540",NA,NA,"Paris, TN","Micropolitan Statistical Area",2003,31057,-205,-81,329,410,-85,4,-89,-39
"37540",NA,47079,"Henry County, TN","County or equivalent",2003,31057,-205,-81,329,410,-85,4,-89,-39
"37580",NA,NA,"Paris, TX","Micropolitan Statistical Area",2003,49072,247,68,623,555,241,47,194,-62
"37580",NA,48277,"Lamar County, TX","County or equivalent",2003,49072,247,68,623,555,241,47,194,-62
"37660",NA,NA,"Parsons, KS","Micropolitan Statistical Area",2003,22129,-119,-19,265,284,-73,0,-73,-27
"37660",NA,20099,"Labette County, KS","County or equivalent",2003,22129,-119,-19,265,284,-73,0,-73,-27
"37740",NA,NA,"Payson, AZ","Micropolitan Statistical Area",2003,50899,-327,89,721,632,-361,40,-401,-55
"37740",NA,4007,"Gila County, AZ","County or equivalent",2003,50899,-327,89,721,632,-361,40,-401,-55
"37780",NA,NA,"Pecos, TX","Micropolitan Statistical Area",2003,12016,-388,111,221,110,-513,22,-535,14
"37780",NA,48389,"Reeves County, TX","County or equivalent",2003,12016,-388,111,221,110,-513,22,-535,14
"37800",NA,NA,"Pella, IA","Micropolitan Statistical Area",2003,32279,-132,113,437,324,-214,5,-219,-31
"37800",NA,19125,"Marion County, IA","County or equivalent",2003,32279,-132,113,437,324,-214,5,-219,-31
"37820",NA,NA,"Pendleton-Hermiston, OR","Micropolitan Statistical Area",2003,83699,489,550,1222,672,58,215,-157,-119
"37820",NA,41049,"Morrow County, OR","County or equivalent",2003,11404,14,87,170,83,-64,44,-108,-9
"37820",NA,41059,"Umatilla County, OR","County or equivalent",2003,72295,475,463,1052,589,122,171,-49,-110
"37940",NA,NA,"Peru, IN","Micropolitan Statistical Area",2003,36839,75,111,422,311,15,-1,16,-51
"37940",NA,18103,"Miami County, IN","County or equivalent",2003,36839,75,111,422,311,15,-1,16,-51
"38020",NA,NA,"Phoenix Lake-Cedar Ridge, CA","Micropolitan Statistical Area",2003,56198,527,-136,466,602,684,12,672,-21
"38020",NA,6109,"Tuolumne County, CA","County or equivalent",2003,56198,527,-136,466,602,684,12,672,-21
"38100",NA,NA,"Picayune, MS","Micropolitan Statistical Area",2003,50475,425,149,638,489,328,-11,339,-52
"38100",NA,28109,"Pearl River County, MS","County or equivalent",2003,50475,425,149,638,489,328,-11,339,-52
"38180",NA,NA,"Pierre, SD","Micropolitan Statistical Area",2003,19266,28,53,224,171,2,12,-10,-27
"38180",NA,46065,"Hughes County, SD","County or equivalent",2003,16542,4,36,188,152,-8,11,-19,-24
"38180",NA,46117,"Stanley County, SD","County or equivalent",2003,2724,24,17,36,19,10,1,9,-3
"38200",NA,NA,"Pierre Part, LA","Micropolitan Statistical Area",2003,23068,-43,106,289,183,-122,5,-127,-27
"38200",NA,22007,"Assumption Parish, LA","County or equivalent",2003,23068,-43,106,289,183,-122,5,-127,-27
"38260",NA,NA,"Pittsburg, KS","Micropolitan Statistical Area",2003,38538,264,70,520,450,237,70,167,-43
"38260",NA,20037,"Crawford County, KS","County or equivalent",2003,38538,264,70,520,450,237,70,167,-43
"38380",NA,NA,"Plainview, TX","Micropolitan Statistical Area",2003,35336,-116,355,642,287,-458,75,-533,-13
"38380",NA,48189,"Hale County, TX","County or equivalent",2003,35336,-116,355,642,287,-458,75,-533,-13
"38420",NA,NA,"Platteville, WI","Micropolitan Statistical Area",2003,49243,30,80,547,467,23,6,17,-73
"38420",NA,55043,"Grant County, WI","County or equivalent",2003,49243,30,80,547,467,23,6,17,-73
"38460",NA,NA,"Plattsburgh, NY","Micropolitan Statistical Area",2003,81063,538,83,778,695,540,43,497,-85
"38460",NA,36019,"Clinton County, NY","County or equivalent",2003,81063,538,83,778,695,540,43,497,-85
"38500",NA,NA,"Plymouth, IN","Micropolitan Statistical Area",2003,45786,342,258,673,415,150,121,29,-66
"38500",NA,18099,"Marshall County, IN","County or equivalent",2003,45786,342,258,673,415,150,121,29,-66
"38580",NA,NA,"Point Pleasant, WV-OH","Micropolitan Statistical Area",2003,56934,-77,32,661,629,-32,-2,-30,-77
"38580",NA,39053,"Gallia County, OH","County or equivalent",2003,31040,-37,62,409,347,-58,0,-58,-41
"38580",NA,54053,"Mason County, WV","County or equivalent",2003,25894,-40,-30,252,282,26,-2,28,-36
"38620",NA,NA,"Ponca City, OK","Micropolitan Statistical Area",2003,47083,-432,87,700,613,-490,39,-529,-29
"38620",NA,40071,"Kay County, OK","County or equivalent",2003,47083,-432,87,700,613,-490,39,-529,-29
"38700",NA,NA,"Pontiac, IL","Micropolitan Statistical Area",2003,38580,-533,84,496,412,-607,10,-617,-10
"38700",NA,17105,"Livingston County, IL","County or equivalent",2003,38580,-533,84,496,412,-607,10,-617,-10
"38740",NA,NA,"Poplar Bluff, MO","Micropolitan Statistical Area",2003,40679,-99,-62,517,579,18,13,5,-55
"38740",NA,29023,"Butler County, MO","County or equivalent",2003,40679,-99,-62,517,579,18,13,5,-55
"38780",NA,NA,"Portales, NM","Micropolitan Statistical Area",2003,18558,37,147,315,168,-84,-10,-74,-26
"38780",NA,35041,"Roosevelt County, NM","County or equivalent",2003,18558,37,147,315,168,-84,-10,-74,-26
"38820",NA,NA,"Port Angeles, WA","Micropolitan Statistical Area",2003,66325,514,-246,589,835,809,19,790,-49
"38820",NA,53009,"Clallam County, WA","County or equivalent",2003,66325,514,-246,589,835,809,19,790,-49
"39020",NA,NA,"Portsmouth, OH","Micropolitan Statistical Area",2003,77170,-749,47,965,918,-736,9,-745,-60
"39020",NA,39145,"Scioto County, OH","County or equivalent",2003,77170,-749,47,965,918,-736,9,-745,-60
"39060",NA,NA,"Pottsville, PA","Micropolitan Statistical Area",2003,147305,-1166,-629,1444,2073,-342,2,-344,-195
"39060",NA,42107,"Schuylkill County, PA","County or equivalent",2003,147305,-1166,-629,1444,2073,-342,2,-344,-195
"39220",NA,NA,"Price, UT","Micropolitan Statistical Area",2003,19668,-77,77,305,228,-138,11,-149,-16
"39220",NA,49007,"Carbon County, UT","County or equivalent",2003,19668,-77,77,305,228,-138,11,-149,-16
"39260",NA,NA,"Prineville, OR","Micropolitan Statistical Area",2003,20401,336,25,215,190,325,26,299,-14
"39260",NA,41013,"Crook County, OR","County or equivalent",2003,20401,336,25,215,190,325,26,299,-14
"39420",NA,NA,"Pullman, WA","Micropolitan Statistical Area",2003,40659,-334,202,428,226,-524,190,-714,-12
"39420",NA,53075,"Whitman County, WA","County or equivalent",2003,40659,-334,202,428,226,-524,190,-714,-12
"39500",NA,NA,"Quincy, IL-MO","Micropolitan Statistical Area",2003,77428,-671,-62,917,979,-533,8,-541,-76
"39500",NA,17001,"Adams County, IL","County or equivalent",2003,67206,-568,-80,795,875,-420,7,-427,-68
"39500",NA,29111,"Lewis County, MO","County or equivalent",2003,10222,-103,18,122,104,-113,1,-114,-8
"39700",NA,NA,"Raymondville, TX","Micropolitan Statistical Area",2003,19845,27,282,379,97,-243,42,-285,-12
"39700",NA,48489,"Willacy County, TX","County or equivalent",2003,19845,27,282,379,97,-243,42,-285,-12
"39780",NA,NA,"Red Bluff, CA","Micropolitan Statistical Area",2003,57952,945,97,691,594,870,79,791,-22
"39780",NA,6103,"Tehama County, CA","County or equivalent",2003,57952,945,97,691,594,870,79,791,-22
"39860",NA,NA,"Red Wing, MN","Micropolitan Statistical Area",2003,44955,56,94,527,433,25,13,12,-63
"39860",NA,27049,"Goodhue County, MN","County or equivalent",2003,44955,56,94,527,433,25,13,12,-63
"39940",NA,NA,"Rexburg, ID","Micropolitan Statistical Area",2003,43228,1687,619,818,199,1025,65,960,43
"39940",NA,16043,"Fremont County, ID","County or equivalent",2003,12171,262,117,208,91,151,35,116,-6
"39940",NA,16065,"Madison County, ID","County or equivalent",2003,31057,1425,502,610,108,874,30,844,49
"39980",NA,NA,"Richmond, IN","Micropolitan Statistical Area",2003,69893,-261,114,895,781,-299,38,-337,-76
"39980",NA,18177,"Wayne County, IN","County or equivalent",2003,69893,-261,114,895,781,-299,38,-337,-76
"40080",NA,NA,"Richmond-Berea, KY","Micropolitan Statistical Area",2003,91707,1369,436,1170,734,997,28,969,-64
"40080",NA,21151,"Madison County, KY","County or equivalent",2003,75167,1389,419,962,543,1010,32,978,-40
"40080",NA,21203,"Rockcastle County, KY","County or equivalent",2003,16540,-20,17,208,191,-13,-4,-9,-24
"40100",NA,NA,"Rio Grande City-Roma, TX","Micropolitan Statistical Area",2003,57394,1497,1190,1469,279,379,427,-48,-72
"40100",NA,48427,"Starr County, TX","County or equivalent",2003,57394,1497,1190,1469,279,379,427,-48,-72
"40180",NA,NA,"Riverton, WY","Micropolitan Statistical Area",2003,35797,-3,141,518,377,-97,2,-99,-47
"40180",NA,56013,"Fremont County, WY","County or equivalent",2003,35797,-3,141,518,377,-97,2,-99,-47
"40260",NA,NA,"Roanoke Rapids, NC","Micropolitan Statistical Area",2003,77471,-514,36,961,925,-466,26,-492,-84
"40260",NA,37083,"Halifax County, NC","County or equivalent",2003,56042,-303,97,743,646,-336,23,-359,-64
"40260",NA,37131,"Northampton County, NC","County or equivalent",2003,21429,-211,-61,218,279,-130,3,-133,-20
"40300",NA,NA,"Rochelle, IL","Micropolitan Statistical Area",2003,52793,671,125,593,468,477,93,384,69
"40300",NA,17141,"Ogle County, IL","County or equivalent",2003,52793,671,125,593,468,477,93,384,69
"40460",NA,NA,"Rockingham, NC","Micropolitan Statistical Area",2003,46114,-384,68,584,516,-408,-20,-388,-44
"40460",NA,37153,"Richmond County, NC","County or equivalent",2003,46114,-384,68,584,516,-408,-20,-388,-44
"40500",NA,NA,"Rockland, ME","Micropolitan Statistical Area",2003,40642,210,-32,424,456,282,-3,285,-40
"40500",NA,23013,"Knox County, ME","County or equivalent",2003,40642,210,-32,424,456,282,-3,285,-40
"40540",NA,NA,"Rock Springs, WY","Micropolitan Statistical Area",2003,36576,-262,352,587,235,-604,10,-614,-10
"40540",NA,56037,"Sweetwater County, WY","County or equivalent",2003,36576,-262,352,587,235,-604,10,-614,-10
"40620",NA,NA,"Rolla, MO","Micropolitan Statistical Area",2003,41061,432,157,536,379,330,70,260,-55
"40620",NA,29161,"Phelps County, MO","County or equivalent",2003,41061,432,157,536,379,330,70,260,-55
"40700",NA,NA,"Roseburg, OR","Micropolitan Statistical Area",2003,101333,738,-179,1078,1257,1010,23,987,-93
"40700",NA,41019,"Douglas County, OR","County or equivalent",2003,101333,738,-179,1078,1257,1010,23,987,-93
"40740",NA,NA,"Roswell, NM","Micropolitan Statistical Area",2003,60680,247,291,941,650,48,125,-77,-92
"40740",NA,35005,"Chaves County, NM","County or equivalent",2003,60680,247,291,941,650,48,125,-77,-92
"40760",NA,NA,"Ruidoso, NM","Micropolitan Statistical Area",2003,20070,479,35,211,176,436,25,411,8
"40760",NA,35027,"Lincoln County, NM","County or equivalent",2003,20070,479,35,211,176,436,25,411,8
"40780",NA,NA,"Russellville, AR","Micropolitan Statistical Area",2003,76656,164,281,1028,747,-81,134,-215,-36
"40780",NA,5115,"Pope County, AR","County or equivalent",2003,55432,130,221,729,508,-82,22,-104,-9
"40780",NA,5149,"Yell County, AR","County or equivalent",2003,21224,34,60,299,239,1,112,-111,-27
"40820",NA,NA,"Ruston, LA","Micropolitan Statistical Area",2003,57555,358,264,784,520,165,39,126,-71
"40820",NA,22049,"Jackson Parish, LA","County or equivalent",2003,15189,-18,9,219,210,-7,-1,-6,-20
"40820",NA,22061,"Lincoln Parish, LA","County or equivalent",2003,42366,376,255,565,310,172,40,132,-51
"40860",NA,NA,"Rutland, VT","Micropolitan Statistical Area",2003,63425,188,53,629,576,221,2,219,-86
"40860",NA,50021,"Rutland County, VT","County or equivalent",2003,63425,188,53,629,576,221,2,219,-86
"40940",NA,NA,"Safford, AZ","Micropolitan Statistical Area",2003,40153,-665,245,560,315,-912,20,-932,2
"40940",NA,4009,"Graham County, AZ","County or equivalent",2003,32773,-339,201,460,259,-527,13,-540,-13
"40940",NA,4011,"Greenlee County, AZ","County or equivalent",2003,7380,-326,44,100,56,-385,7,-392,15
"41220",NA,NA,"St. Marys, GA","Micropolitan Statistical Area",2003,44448,-1139,547,762,215,-1690,-793,-897,4
"41220",NA,13039,"Camden County, GA","County or equivalent",2003,44448,-1139,547,762,215,-1690,-793,-897,4
"41260",NA,NA,"St. Marys, PA","Micropolitan Statistical Area",2003,34052,-315,-76,308,384,-201,5,-206,-38
"41260",NA,42047,"Elk County, PA","County or equivalent",2003,34052,-315,-76,308,384,-201,5,-206,-38
"41460",NA,NA,"Salina, KS","Micropolitan Statistical Area",2003,59847,-294,266,832,566,-512,72,-584,-48
"41460",NA,20143,"Ottawa County, KS","County or equivalent",2003,6097,-55,-3,74,77,-47,-1,-46,-5
"41460",NA,20169,"Saline County, KS","County or equivalent",2003,53750,-239,269,758,489,-465,73,-538,-43
"41580",NA,NA,"Salisbury, NC","Micropolitan Statistical Area",2003,133246,-72,344,1673,1329,-260,315,-575,-156
"41580",NA,37159,"Rowan County, NC","County or equivalent",2003,133246,-72,344,1673,1329,-260,315,-575,-156
"41820",NA,NA,"Sanford, NC","Micropolitan Statistical Area",2003,52872,1188,360,810,450,-564,244,-808,1392
"41820",NA,37105,"Lee County, NC","County or equivalent",2003,52872,1188,360,810,450,-564,244,-808,1392
"42300",NA,NA,"Sault Ste. Marie, MI","Micropolitan Statistical Area",2003,38581,-30,77,372,295,-50,-6,-44,-57
"42300",NA,26033,"Chippewa County, MI","County or equivalent",2003,38581,-30,77,372,295,-50,-6,-44,-57
"42380",NA,NA,"Sayre, PA","Micropolitan Statistical Area",2003,61965,-370,56,716,660,-362,1,-363,-64
"42380",NA,42015,"Bradford County, PA","County or equivalent",2003,61965,-370,56,716,660,-362,1,-363,-64
"42420",NA,NA,"Scottsbluff, NE","Micropolitan Statistical Area",2003,37205,-131,66,535,469,-157,43,-200,-40
"42420",NA,31007,"Banner County, NE","County or equivalent",2003,763,-8,0,5,5,-7,1,-8,-1
"42420",NA,31157,"Scotts Bluff County, NE","County or equivalent",2003,36442,-123,66,530,464,-150,42,-192,-39
"42460",NA,NA,"Scottsboro, AL","Micropolitan Statistical Area",2003,53491,-162,1,615,614,-94,8,-102,-69
"42460",NA,1071,"Jackson County, AL","County or equivalent",2003,53491,-162,1,615,614,-94,8,-102,-69
"42500",NA,NA,"Scottsburg, IN","Micropolitan Statistical Area",2003,23459,200,79,327,248,145,1,144,-24
"42500",NA,18143,"Scott County, IN","County or equivalent",2003,23459,200,79,327,248,145,1,144,-24
"42580",NA,NA,"Seaford, DE","Micropolitan Statistical Area",2003,167719,3992,329,2137,1808,3673,263,3410,-10
"42580",NA,10005,"Sussex County, DE","County or equivalent",2003,167719,3992,329,2137,1808,3673,263,3410,-10
"42620",NA,NA,"Searcy, AR","Micropolitan Statistical Area",2003,69389,546,213,920,707,414,27,387,-81
"42620",NA,5145,"White County, AR","County or equivalent",2003,69389,546,213,920,707,414,27,387,-81
"42700",NA,NA,"Sebring, FL","Micropolitan Statistical Area",2003,90630,845,-441,888,1329,1320,322,998,-34
"42700",NA,12055,"Highlands County, FL","County or equivalent",2003,90630,845,-441,888,1329,1320,322,998,-34
"42740",NA,NA,"Sedalia, MO","Micropolitan Statistical Area",2003,39428,50,172,597,425,-68,29,-97,-54
"42740",NA,29159,"Pettis County, MO","County or equivalent",2003,39428,50,172,597,425,-68,29,-97,-54
"42780",NA,NA,"Selinsgrove, PA","Micropolitan Statistical Area",2003,37893,97,149,474,325,5,-2,7,-57
"42780",NA,42109,"Snyder County, PA","County or equivalent",2003,37893,97,149,474,325,5,-2,7,-57
"42820",NA,NA,"Selma, AL","Micropolitan Statistical Area",2003,44517,-438,184,706,522,-593,-1,-592,-29
"42820",NA,1047,"Dallas County, AL","County or equivalent",2003,44517,-438,184,706,522,-593,-1,-592,-29
"42860",NA,NA,"Seneca, SC","Micropolitan Statistical Area",2003,68105,418,102,780,678,387,60,327,-71
"42860",NA,45073,"Oconee County, SC","County or equivalent",2003,68105,418,102,780,678,387,60,327,-71
"42900",NA,NA,"Seneca Falls, NY","Micropolitan Statistical Area",2003,34716,-14,37,391,354,0,20,-20,-51
"42900",NA,36099,"Seneca County, NY","County or equivalent",2003,34716,-14,37,391,354,0,20,-20,-51
"42940",NA,NA,"Sevierville, TN","Micropolitan Statistical Area",2003,75585,1220,301,977,676,962,38,924,-43
"42940",NA,47155,"Sevier County, TN","County or equivalent",2003,75585,1220,301,977,676,962,38,924,-43
"42980",NA,NA,"Seymour, IN","Micropolitan Statistical Area",2003,41492,86,209,619,410,-75,85,-160,-48
"42980",NA,18071,"Jackson County, IN","County or equivalent",2003,41492,86,209,619,410,-75,85,-160,-48
"43060",NA,NA,"Shawnee, OK","Micropolitan Statistical Area",2003,67544,939,148,885,737,829,5,824,-38
"43060",NA,40125,"Pottawatomie County, OK","County or equivalent",2003,67544,939,148,885,737,829,5,824,-38
"43140",NA,NA,"Shelby, NC","Micropolitan Statistical Area",2003,97611,216,215,1215,1000,144,54,90,-143
"43140",NA,37045,"Cleveland County, NC","County or equivalent",2003,97611,216,215,1215,1000,144,54,90,-143
"43180",NA,NA,"Shelbyville, TN","Micropolitan Statistical Area",2003,39851,753,171,579,408,608,202,406,-26
"43180",NA,47003,"Bedford County, TN","County or equivalent",2003,39851,753,171,579,408,608,202,406,-26
"43220",NA,NA,"Shelton, WA","Micropolitan Statistical Area",2003,51535,846,45,542,497,817,23,794,-16
"43220",NA,53045,"Mason County, WA","County or equivalent",2003,51535,846,45,542,497,817,23,794,-16
"43260",NA,NA,"Sheridan, WY","Micropolitan Statistical Area",2003,26969,97,54,336,282,80,7,73,-37
"43260",NA,56033,"Sheridan County, WY","County or equivalent",2003,26969,97,54,336,282,80,7,73,-37
"43320",NA,NA,"Show Low, AZ","Micropolitan Statistical Area",2003,103217,1853,886,1643,757,1047,49,998,-80
"43320",NA,4017,"Navajo County, AZ","County or equivalent",2003,103217,1853,886,1643,757,1047,49,998,-80
"43380",NA,NA,"Sidney, OH","Micropolitan Statistical Area",2003,48265,30,331,737,406,-248,41,-289,-53
"43380",NA,39149,"Shelby County, OH","County or equivalent",2003,48265,30,331,737,406,-248,41,-289,-53
"43420",NA,NA,"Sierra Vista-Douglas, AZ","Micropolitan Statistical Area",2003,121085,1398,668,1748,1080,801,-590,1391,-71
"43420",NA,4003,"Cochise County, AZ","County or equivalent",2003,121085,1398,668,1748,1080,801,-590,1391,-71
"43460",NA,NA,"Sikeston, MO","Micropolitan Statistical Area",2003,40404,127,139,577,438,51,8,43,-63
"43460",NA,29201,"Scott County, MO","County or equivalent",2003,40404,127,139,577,438,51,8,43,-63
"43500",NA,NA,"Silver City, NM","Micropolitan Statistical Area",2003,29482,-700,50,367,317,-766,6,-772,16
"43500",NA,35017,"Grant County, NM","County or equivalent",2003,29482,-700,50,367,317,-766,6,-772,16
"43540",NA,NA,"Silverthorne, CO","Micropolitan Statistical Area",2003,25323,354,316,349,33,69,226,-157,-31
"43540",NA,8117,"Summit County, CO","County or equivalent",2003,25323,354,316,349,33,69,226,-157,-31
"43660",NA,NA,"Snyder, TX","Micropolitan Statistical Area",2003,15717,-138,40,214,174,-164,12,-176,-14
"43660",NA,48415,"Scurry County, TX","County or equivalent",2003,15717,-138,40,214,174,-164,12,-176,-14
"43700",NA,NA,"Somerset, KY","Micropolitan Statistical Area",2003,57597,478,16,702,686,512,10,502,-50
"43700",NA,21199,"Pulaski County, KY","County or equivalent",2003,57597,478,16,702,686,512,10,502,-50
"43740",NA,NA,"Somerset, PA","Micropolitan Statistical Area",2003,79410,-32,-171,786,957,236,5,231,-97
"43740",NA,42111,"Somerset County, PA","County or equivalent",2003,79410,-32,-171,786,957,236,5,231,-97
"43860",NA,NA,"Southern Pines-Pinehurst, NC","Micropolitan Statistical Area",2003,78439,861,-23,915,938,920,61,859,-36
"43860",NA,37125,"Moore County, NC","County or equivalent",2003,78439,861,-23,915,938,920,61,859,-36
"43940",NA,NA,"Spearfish, SD","Micropolitan Statistical Area",2003,22019,323,44,225,181,289,0,289,-10
"43940",NA,46081,"Lawrence County, SD","County or equivalent",2003,22019,323,44,225,181,289,0,289,-10
"43980",NA,NA,"Spencer, IA","Micropolitan Statistical Area",2003,16949,-113,1,209,208,-94,11,-105,-20
"43980",NA,19041,"Clay County, IA","County or equivalent",2003,16949,-113,1,209,208,-94,11,-105,-20
"44020",NA,NA,"Spirit Lake, IA","Micropolitan Statistical Area",2003,16322,-26,-31,155,186,28,-1,29,-23
"44020",NA,19059,"Dickinson County, IA","County or equivalent",2003,16322,-26,-31,155,186,28,-1,29,-23
"44260",NA,NA,"Starkville, MS","Micropolitan Statistical Area",2003,42208,-159,238,540,302,-359,103,-462,-38
"44260",NA,28105,"Oktibbeha County, MS","County or equivalent",2003,42208,-159,238,540,302,-359,103,-462,-38
"44340",NA,NA,"Statesboro, GA","Micropolitan Statistical Area",2003,59658,2006,341,732,391,1633,63,1570,32
"44340",NA,13031,"Bulloch County, GA","County or equivalent",2003,59658,2006,341,732,391,1633,63,1570,32
"44380",NA,NA,"Statesville-Mooresville, NC","Micropolitan Statistical Area",2003,132833,2592,688,1859,1171,1982,277,1705,-78
"44380",NA,37097,"Iredell County, NC","County or equivalent",2003,132833,2592,688,1859,1171,1982,277,1705,-78
"44420",NA,NA,"Staunton-Waynesboro, VA","Micropolitan Statistical Area",2003,110894,338,259,1289,1030,137,34,103,-58
"44420",NA,51015,"Augusta County, VA","County or equivalent",2003,67156,678,213,719,506,521,22,499,-56
"44420",NA,51790,"Staunton city, VA","County or equivalent",2003,23257,-619,-20,277,297,-616,2,-618,17
"44420",NA,51820,"Waynesboro city, VA","County or equivalent",2003,20481,279,66,293,227,232,10,222,-19
"44500",NA,NA,"Stephenville, TX","Micropolitan Statistical Area",2003,33622,319,138,425,287,224,82,142,-43
"44500",NA,48143,"Erath County, TX","County or equivalent",2003,33622,319,138,425,287,224,82,142,-43
"44540",NA,NA,"Sterling, CO","Micropolitan Statistical Area",2003,21289,61,105,299,194,-14,40,-54,-30
"44540",NA,8075,"Logan County, CO","County or equivalent",2003,21289,61,105,299,194,-14,40,-54,-30
"44580",NA,NA,"Sterling, IL","Micropolitan Statistical Area",2003,59564,-537,136,768,632,-635,39,-674,-38
"44580",NA,17195,"Whiteside County, IL","County or equivalent",2003,59564,-537,136,768,632,-635,39,-674,-38
"44620",NA,NA,"Stevens Point, WI","Micropolitan Statistical Area",2003,67439,-48,278,745,467,-243,41,-284,-83
"44620",NA,55097,"Portage County, WI","County or equivalent",2003,67439,-48,278,745,467,-243,41,-284,-83
"44660",NA,NA,"Stillwater, OK","Micropolitan Statistical Area",2003,73382,1549,281,811,530,298,226,72,970
"44660",NA,40119,"Payne County, OK","County or equivalent",2003,73382,1549,281,811,530,298,226,72,970
"44740",NA,NA,"Storm Lake, IA","Micropolitan Statistical Area",2003,19989,-155,64,258,194,-208,122,-330,-11
"44740",NA,19021,"Buena Vista County, IA","County or equivalent",2003,19989,-155,64,258,194,-208,122,-330,-11
"44780",NA,NA,"Sturgis, MI","Micropolitan Statistical Area",2003,62413,196,382,945,563,-105,110,-215,-81
"44780",NA,26149,"St. Joseph County, MI","County or equivalent",2003,62413,196,382,945,563,-105,110,-215,-81
"44860",NA,NA,"Sulphur Springs, TX","Micropolitan Statistical Area",2003,32475,215,74,455,381,179,56,123,-38
"44860",NA,48223,"Hopkins County, TX","County or equivalent",2003,32475,215,74,455,381,179,56,123,-38
"44900",NA,NA,"Summerville, GA","Micropolitan Statistical Area",2003,26242,341,61,311,250,297,19,278,-17
"44900",NA,13055,"Chattooga County, GA","County or equivalent",2003,26242,341,61,311,250,297,19,278,-17
"44980",NA,NA,"Sunbury, PA","Micropolitan Statistical Area",2003,92570,-485,-195,975,1170,-161,9,-170,-129
"44980",NA,42097,"Northumberland County, PA","County or equivalent",2003,92570,-485,-195,975,1170,-161,9,-170,-129
"45000",NA,NA,"Susanville, CA","Micropolitan Statistical Area",2003,33709,401,124,327,203,302,0,302,-25
"45000",NA,6035,"Lassen County, CA","County or equivalent",2003,33709,401,124,327,203,302,0,302,-25
"45020",NA,NA,"Sweetwater, TX","Micropolitan Statistical Area",2003,15003,-43,39,211,172,-62,8,-70,-20
"45020",NA,48353,"Nolan County, TX","County or equivalent",2003,15003,-43,39,211,172,-62,8,-70,-20
"45140",NA,NA,"Tahlequah, OK","Micropolitan Statistical Area",2003,43850,340,200,614,414,197,77,120,-57
"45140",NA,40021,"Cherokee County, OK","County or equivalent",2003,43850,340,200,614,414,197,77,120,-57
"45180",NA,NA,"Talladega-Sylacauga, AL","Micropolitan Statistical Area",2003,79759,-481,97,986,889,-496,15,-511,-82
"45180",NA,1121,"Talladega County, AL","County or equivalent",2003,79759,-481,97,986,889,-496,15,-511,-82
"45260",NA,NA,"Tallulah, LA","Micropolitan Statistical Area",2003,12620,-408,21,178,157,-443,1,-444,14
"45260",NA,22065,"Madison Parish, LA","County or equivalent",2003,12620,-408,21,178,157,-443,1,-444,14
"45340",NA,NA,"Taos, NM","Micropolitan Statistical Area",2003,30883,311,149,370,221,198,47,151,-36
"45340",NA,35055,"Taos County, NM","County or equivalent",2003,30883,311,149,370,221,198,47,151,-36
"45380",NA,NA,"Taylorville, IL","Micropolitan Statistical Area",2003,34950,-74,-16,399,415,-7,6,-13,-51
"45380",NA,17021,"Christian County, IL","County or equivalent",2003,34950,-74,-16,399,415,-7,6,-13,-51
"45540",NA,NA,"The Villages, FL","Micropolitan Statistical Area",2003,58801,1304,-272,493,765,1513,44,1469,63
"45540",NA,12119,"Sumter County, FL","County or equivalent",2003,58801,1304,-272,493,765,1513,44,1469,63
"45580",NA,NA,"Thomaston, GA","Micropolitan Statistical Area",2003,27589,31,-39,345,384,105,37,68,-35
"45580",NA,13293,"Upson County, GA","County or equivalent",2003,27589,31,-39,345,384,105,37,68,-35
"45620",NA,NA,"Thomasville, GA","Micropolitan Statistical Area",2003,43391,497,126,585,459,415,10,405,-44
"45620",NA,13275,"Thomas County, GA","County or equivalent",2003,43391,497,126,585,459,415,10,405,-44
"45640",NA,NA,"Thomasville-Lexington, NC","Micropolitan Statistical Area",2003,151372,995,435,1874,1439,761,337,424,-201
"45640",NA,37057,"Davidson County, NC","County or equivalent",2003,151372,995,435,1874,1439,761,337,424,-201
"45660",NA,NA,"Tiffin, OH","Micropolitan Statistical Area",2003,57755,-188,193,710,517,-321,17,-338,-60
"45660",NA,39147,"Seneca County, OH","County or equivalent",2003,57755,-188,193,710,517,-321,17,-338,-60
"45700",NA,NA,"Tifton, GA","Micropolitan Statistical Area",2003,39194,300,220,591,371,139,119,20,-59
"45700",NA,13277,"Tift County, GA","County or equivalent",2003,39194,300,220,591,371,139,119,20,-59
"45740",NA,NA,"Toccoa, GA","Micropolitan Statistical Area",2003,25326,-251,39,329,290,-271,7,-278,-19
"45740",NA,13257,"Stephens County, GA","County or equivalent",2003,25326,-251,39,329,290,-271,7,-278,-19
"45860",NA,NA,"Torrington, CT","Micropolitan Statistical Area",2003,186658,1106,221,1865,1644,1097,159,938,-212
"45860",NA,9005,"Litchfield County, CT","County or equivalent",2003,186658,1106,221,1865,1644,1097,159,938,-212
"45900",NA,NA,"Traverse City, MI","Micropolitan Statistical Area",2003,137822,1678,465,1602,1137,1322,39,1283,-109
"45900",NA,26019,"Benzie County, MI","County or equivalent",2003,17116,394,55,220,165,336,3,333,3
"45900",NA,26055,"Grand Traverse County, MI","County or equivalent",2003,81756,768,307,955,648,545,29,516,-84
"45900",NA,26079,"Kalkaska County, MI","County or equivalent",2003,17129,246,77,225,148,179,0,179,-10
"45900",NA,26089,"Leelanau County, MI","County or equivalent",2003,21821,270,26,202,176,262,7,255,-18
"45980",NA,NA,"Troy, AL","Micropolitan Statistical Area",2003,29406,134,76,392,316,93,11,82,-35
"45980",NA,1109,"Pike County, AL","County or equivalent",2003,29406,134,76,392,316,93,11,82,-35
"46020",NA,NA,"Truckee-Grass Valley, CA","Micropolitan Statistical Area",2003,95203,787,-101,890,991,971,71,900,-83
"46020",NA,6057,"Nevada County, CA","County or equivalent",2003,95203,787,-101,890,991,971,71,900,-83
"46100",NA,NA,"Tullahoma, TN","Micropolitan Statistical Area",2003,95503,605,167,1180,1013,535,46,489,-97
"46100",NA,47031,"Coffee County, TN","County or equivalent",2003,49493,482,89,653,564,435,42,393,-42
"46100",NA,47051,"Franklin County, TN","County or equivalent",2003,40151,176,78,476,398,147,8,139,-49
"46100",NA,47127,"Moore County, TN","County or equivalent",2003,5859,-53,0,51,51,-47,-4,-43,-6
"46180",NA,NA,"Tupelo, MS","Micropolitan Statistical Area",2003,127950,1236,579,1830,1251,803,40,763,-146
"46180",NA,28057,"Itawamba County, MS","County or equivalent",2003,22931,164,-7,262,269,198,0,198,-27
"46180",NA,28081,"Lee County, MS","County or equivalent",2003,77340,579,425,1165,740,259,23,236,-105
"46180",NA,28115,"Pontotoc County, MS","County or equivalent",2003,27679,493,161,403,242,346,17,329,-14
"46260",NA,NA,"Tuskegee, AL","Micropolitan Statistical Area",2003,23475,-179,-19,238,257,-135,14,-149,-25
"46260",NA,1087,"Macon County, AL","County or equivalent",2003,23475,-179,-19,238,257,-135,14,-149,-25
"46300",NA,NA,"Twin Falls, ID","Micropolitan Statistical Area",2003,85379,1614,588,1345,757,1082,222,860,-56
"46300",NA,16053,"Jerome County, ID","County or equivalent",2003,18683,150,206,345,139,-33,65,-98,-23
"46300",NA,16083,"Twin Falls County, ID","County or equivalent",2003,66696,1464,382,1000,618,1115,157,958,-33
"46380",NA,NA,"Ukiah, CA","Micropolitan Statistical Area",2003,87481,541,310,1150,840,352,280,72,-121
"46380",NA,6045,"Mendocino County, CA","County or equivalent",2003,87481,541,310,1150,840,352,280,72,-121
"46420",NA,NA,"Union, SC","Micropolitan Statistical Area",2003,28916,-334,-27,341,368,-279,-7,-272,-28
"46420",NA,45087,"Union County, SC","County or equivalent",2003,28916,-334,-27,341,368,-279,-7,-272,-28
"46460",NA,NA,"Union City, TN-KY","Micropolitan Statistical Area",2003,39557,-226,-14,509,523,-167,18,-185,-45
"46460",NA,21075,"Fulton County, KY","County or equivalent",2003,7432,-138,-32,86,118,-103,-1,-102,-3
"46460",NA,47131,"Obion County, TN","County or equivalent",2003,32125,-88,18,423,405,-64,19,-83,-42
"46500",NA,NA,"Urbana, OH","Micropolitan Statistical Area",2003,39151,19,163,540,377,-85,-1,-84,-59
"46500",NA,39021,"Champaign County, OH","County or equivalent",2003,39151,19,163,540,377,-85,-1,-84,-59
"46620",NA,NA,"Uvalde, TX","Micropolitan Statistical Area",2003,26368,-36,194,463,269,-204,43,-247,-26
"46620",NA,48463,"Uvalde County, TX","County or equivalent",2003,26368,-36,194,463,269,-204,43,-247,-26
"46740",NA,NA,"Valley, AL","Micropolitan Statistical Area",2003,35594,-328,-14,446,460,-278,14,-292,-36
"46740",NA,1017,"Chambers County, AL","County or equivalent",2003,35594,-328,-14,446,460,-278,14,-292,-36
"46780",NA,NA,"Van Wert, OH","Micropolitan Statistical Area",2003,29152,-97,42,366,324,-102,5,-107,-37
"46780",NA,39161,"Van Wert County, OH","County or equivalent",2003,29152,-97,42,366,324,-102,5,-107,-37
"46820",NA,NA,"Vermillion, SD","Micropolitan Statistical Area",2003,13397,-16,73,166,93,-74,7,-81,-15
"46820",NA,46027,"Clay County, SD","County or equivalent",2003,13397,-16,73,166,93,-74,7,-81,-15
"46860",NA,NA,"Vernal, UT","Micropolitan Statistical Area",2003,26179,5,328,510,182,-304,3,-307,-19
"46860",NA,49047,"Uintah County, UT","County or equivalent",2003,26179,5,328,510,182,-304,3,-307,-19
"46900",NA,NA,"Vernon, TX","Micropolitan Statistical Area",2003,14091,-186,4,198,194,-179,14,-193,-11
"46900",NA,48487,"Wilbarger County, TX","County or equivalent",2003,14091,-186,4,198,194,-179,14,-193,-11
"46980",NA,NA,"Vicksburg, MS","Micropolitan Statistical Area",2003,48777,-240,210,771,561,-408,10,-418,-42
"46980",NA,28149,"Warren County, MS","County or equivalent",2003,48777,-240,210,771,561,-408,10,-418,-42
"47080",NA,NA,"Vidalia, GA","Micropolitan Statistical Area",2003,34924,304,170,532,362,160,103,57,-26
"47080",NA,13209,"Montgomery County, GA","County or equivalent",2003,8751,246,44,116,72,200,11,189,2
"47080",NA,13279,"Toombs County, GA","County or equivalent",2003,26173,58,126,416,290,-40,92,-132,-28
"47180",NA,NA,"Vincennes, IN","Micropolitan Statistical Area",2003,38414,-350,-22,433,455,-296,29,-325,-32
"47180",NA,18083,"Knox County, IN","County or equivalent",2003,38414,-350,-22,433,455,-296,29,-325,-32
"47340",NA,NA,"Wabash, IN","Micropolitan Statistical Area",2003,34114,-244,19,404,385,-227,-2,-225,-36
"47340",NA,18169,"Wabash County, IN","County or equivalent",2003,34114,-244,19,404,385,-227,-2,-225,-36
"47420",NA,NA,"Wahpeton, ND-MN","Micropolitan Statistical Area",2003,24405,103,41,263,222,87,-6,93,-25
"47420",NA,27167,"Wilkin County, MN","County or equivalent",2003,6867,-55,-10,66,76,-34,-2,-32,-11
"47420",NA,38077,"Richland County, ND","County or equivalent",2003,17538,158,51,197,146,121,-4,125,-14
"47460",NA,NA,"Walla Walla, WA","Micropolitan Statistical Area",2003,56364,498,146,699,553,431,151,280,-79
"47460",NA,53071,"Walla Walla County, WA","County or equivalent",2003,56364,498,146,699,553,431,151,280,-79
"47500",NA,NA,"Walterboro, SC","Micropolitan Statistical Area",2003,38700,109,90,495,405,72,3,69,-53
"47500",NA,45029,"Colleton County, SC","County or equivalent",2003,38700,109,90,495,405,72,3,69,-53
"47540",NA,NA,"Wapakoneta, OH","Micropolitan Statistical Area",2003,46304,-85,142,592,450,-175,18,-193,-52
"47540",NA,39011,"Auglaize County, OH","County or equivalent",2003,46304,-85,142,592,450,-175,18,-193,-52
"47620",NA,NA,"Warren, PA","Micropolitan Statistical Area",2003,42530,-439,-64,425,489,-335,1,-336,-40
"47620",NA,42123,"Warren County, PA","County or equivalent",2003,42530,-439,-64,425,489,-335,1,-336,-40
"47660",NA,NA,"Warrensburg, MO","Micropolitan Statistical Area",2003,50500,642,366,721,355,306,-352,658,-30
"47660",NA,29101,"Johnson County, MO","County or equivalent",2003,50500,642,366,721,355,306,-352,658,-30
"47700",NA,NA,"Warsaw, IN","Micropolitan Statistical Area",2003,74865,164,465,1068,603,-212,99,-311,-89
"47700",NA,18085,"Kosciusko County, IN","County or equivalent",2003,74865,164,465,1068,603,-212,99,-311,-89
"47780",NA,NA,"Washington, IN","Micropolitan Statistical Area",2003,29798,152,189,491,302,7,42,-35,-44
"47780",NA,18027,"Daviess County, IN","County or equivalent",2003,29798,152,189,491,302,7,42,-35,-44
"47820",NA,NA,"Washington, NC","Micropolitan Statistical Area",2003,45006,43,69,594,525,38,57,-19,-64
"47820",NA,37013,"Beaufort County, NC","County or equivalent",2003,45006,43,69,594,525,38,57,-19,-64
"47920",NA,NA,"Washington Court House, OH","Micropolitan Statistical Area",2003,28135,-18,7,365,358,16,8,8,-41
"47920",NA,39047,"Fayette County, OH","County or equivalent",2003,28135,-18,7,365,358,16,8,8,-41
"47980",NA,NA,"Watertown, SD","Micropolitan Statistical Area",2003,31383,-40,169,442,273,-175,10,-185,-34
"47980",NA,46029,"Codington County, SD","County or equivalent",2003,25863,-17,141,342,201,-129,10,-139,-29
"47980",NA,46057,"Hamlin County, SD","County or equivalent",2003,5520,-23,28,100,72,-46,0,-46,-5
"48020",NA,NA,"Watertown-Fort Atkinson, WI","Micropolitan Statistical Area",2003,77091,411,289,919,630,223,85,138,-101
"48020",NA,55055,"Jefferson County, WI","County or equivalent",2003,77091,411,289,919,630,223,85,138,-101
"48060",NA,NA,"Watertown-Fort Drum, NY","Micropolitan Statistical Area",2003,113360,-576,730,1598,868,-946,-1400,454,-360
"48060",NA,36045,"Jefferson County, NY","County or equivalent",2003,113360,-576,730,1598,868,-946,-1400,454,-360
"48100",NA,NA,"Wauchula, FL","Micropolitan Statistical Area",2003,27376,110,322,506,184,-195,203,-398,-17
"48100",NA,12049,"Hardee County, FL","County or equivalent",2003,27376,110,322,506,184,-195,203,-398,-17
"48180",NA,NA,"Waycross, GA","Micropolitan Statistical Area",2003,51395,262,98,693,595,224,60,164,-60
"48180",NA,13229,"Pierce County, GA","County or equivalent",2003,16248,252,71,229,158,193,15,178,-12
"48180",NA,13299,"Ware County, GA","County or equivalent",2003,35147,10,27,464,437,31,45,-14,-48
"48460",NA,NA,"West Plains, MO","Micropolitan Statistical Area",2003,37325,161,61,496,435,149,14,135,-49
"48460",NA,29091,"Howell County, MO","County or equivalent",2003,37325,161,61,496,435,149,14,135,-49
"48500",NA,NA,"West Point, MS","Micropolitan Statistical Area",2003,21363,-475,69,296,227,-556,-5,-551,12
"48500",NA,28025,"Clay County, MS","County or equivalent",2003,21363,-475,69,296,227,-556,-5,-551,12
"48580",NA,NA,"Whitewater, WI","Micropolitan Statistical Area",2003,96604,1474,420,1219,799,1140,158,982,-86
"48580",NA,55127,"Walworth County, WI","County or equivalent",2003,96604,1474,420,1219,799,1140,158,982,-86
"48740",NA,NA,"Willimantic, CT","Micropolitan Statistical Area",2003,112326,1430,296,1330,1034,1220,149,1071,-86
"48740",NA,9015,"Windham County, CT","County or equivalent",2003,112326,1430,296,1330,1034,1220,149,1071,-86
"48780",NA,NA,"Williston, ND","Micropolitan Statistical Area",2003,19252,-163,10,220,210,-157,3,-160,-16
"48780",NA,38105,"Williams County, ND","County or equivalent",2003,19252,-163,10,220,210,-157,3,-160,-16
"48820",NA,NA,"Willmar, MN","Micropolitan Statistical Area",2003,41043,150,200,581,381,12,47,-35,-62
"48820",NA,27067,"Kandiyohi County, MN","County or equivalent",2003,41043,150,200,581,381,12,47,-35,-62
"48940",NA,NA,"Wilmington, OH","Micropolitan Statistical Area",2003,41445,224,216,564,348,72,35,37,-64
"48940",NA,39027,"Clinton County, OH","County or equivalent",2003,41445,224,216,564,348,72,35,37,-64
"48980",NA,NA,"Wilson, NC","Micropolitan Statistical Area",2003,74841,187,344,1071,727,-54,218,-272,-103
"48980",NA,37195,"Wilson County, NC","County or equivalent",2003,74841,187,344,1071,727,-54,218,-272,-103
"49060",NA,NA,"Winfield, KS","Micropolitan Statistical Area",2003,35396,-665,-1,454,455,-658,20,-678,-6
"49060",NA,20035,"Cowley County, KS","County or equivalent",2003,35396,-665,-1,454,455,-658,20,-678,-6
"49100",NA,NA,"Winona, MN","Micropolitan Statistical Area",2003,49469,-34,92,499,407,-61,49,-110,-65
"49100",NA,27169,"Winona County, MN","County or equivalent",2003,49469,-34,92,499,407,-61,49,-110,-65
"49260",NA,NA,"Woodward, OK","Micropolitan Statistical Area",2003,18424,36,83,262,179,-23,9,-32,-24
"49260",NA,40153,"Woodward County, OK","County or equivalent",2003,18424,36,83,262,179,-23,9,-32,-24
"49300",NA,NA,"Wooster, OH","Micropolitan Statistical Area",2003,112784,242,672,1621,949,-289,76,-365,-141
"49300",NA,39169,"Wayne County, OH","County or equivalent",2003,112784,242,672,1621,949,-289,76,-365,-141
"49380",NA,NA,"Worthington, MN","Micropolitan Statistical Area",2003,20367,-102,116,303,187,-205,60,-265,-13
"49380",NA,27105,"Nobles County, MN","County or equivalent",2003,20367,-102,116,303,187,-205,60,-265,-13
"49460",NA,NA,"Yankton, SD","Micropolitan Statistical Area",2003,21525,49,42,248,206,36,3,33,-29
"49460",NA,46135,"Yankton County, SD","County or equivalent",2003,21525,49,42,248,206,36,3,33,-29
"49540",NA,NA,"Yazoo City, MS","Micropolitan Statistical Area",2003,27795,123,149,432,283,14,8,6,-40
"49540",NA,28163,"Yazoo County, MS","County or equivalent",2003,27795,123,149,432,283,14,8,6,-40
"49780",NA,NA,"Zanesville, OH","Micropolitan Statistical Area",2003,85092,18,225,1081,856,-90,2,-92,-117
"49780",NA,39119,"Muskingum County, OH","County or equivalent",2003,85092,18,225,1081,856,-90,2,-92,-117
"10180",NA,48059,"Callahan County, TX","County or equivalent",2004,13107,218,-7,147,154,242,6,236,-17
"10180",NA,48253,"Jones County, TX","County or equivalent",2004,19726,-185,-5,170,175,-166,7,-173,-14
"10180",NA,48441,"Taylor County, TX","County or equivalent",2004,125714,485,820,2064,1244,-236,428,-664,-99
"10420",NA,NA,"Akron, OH","Metropolitan Statistical Area",2004,700382,272,1651,8320,6669,-1399,521,-1920,20
"10420",NA,39133,"Portage County, OH","County or equivalent",2004,154837,364,479,1651,1172,-18,93,-111,-97
"10420",NA,39153,"Summit County, OH","County or equivalent",2004,545545,-92,1172,6669,5497,-1381,428,-1809,117
"10500",NA,NA,"Albany, GA","Metropolitan Statistical Area",2004,161404,276,749,2228,1479,-341,196,-537,-132
"10500",NA,13007,"Baker County, GA","County or equivalent",2004,4051,-100,-10,32,42,-85,2,-87,-5
"10500",NA,13095,"Dougherty County, GA","County or equivalent",2004,94978,-540,508,1457,949,-961,162,-1123,-87
"10500",NA,13177,"Lee County, GA","County or equivalent",2004,29919,1082,193,341,148,905,22,883,-16
"10500",NA,13273,"Terrell County, GA","County or equivalent",2004,10798,-105,20,153,133,-116,2,-118,-9
"10500",NA,13321,"Worth County, GA","County or equivalent",2004,21658,-61,38,245,207,-84,8,-92,-15
"10580",NA,NA,"Albany-Schenectady-Troy, NY","Metropolitan Statistical Area",2004,843811,4266,1784,9467,7683,3086,1134,1952,-604
"10580",NA,36001,"Albany County, NY","County or equivalent",2004,298758,370,319,3166,2847,244,544,-300,-193
"10580",NA,36083,"Rensselaer County, NY","County or equivalent",2004,153846,943,291,1739,1448,763,210,553,-111
"10580",NA,36091,"Saratoga County, NY","County or equivalent",2004,211724,2046,914,2385,1471,1295,184,1111,-163
"10580",NA,36093,"Schenectady County, NY","County or equivalent",2004,147601,729,262,1881,1619,576,194,382,-109
"10580",NA,36095,"Schoharie County, NY","County or equivalent",2004,31882,178,-2,296,298,208,2,206,-28
"10740",NA,NA,"Albuquerque, NM","Metropolitan Statistical Area",2004,779751,14370,5317,11180,5863,9831,1889,7942,-778
"10740",NA,35001,"Bernalillo County, NM","County or equivalent",2004,593734,11356,4216,8779,4563,7704,1696,6008,-564
"10740",NA,35043,"Sandoval County, NM","County or equivalent",2004,101206,2871,572,1248,676,2433,73,2360,-134
"10740",NA,35057,"Torrance County, NM","County or equivalent",2004,17200,317,83,198,115,253,10,243,-19
"10740",NA,35061,"Valencia County, NM","County or equivalent",2004,67611,-174,446,955,509,-559,110,-669,-61
"10780",NA,NA,"Alexandria, LA","Metropolitan Statistical Area",2004,146308,790,624,2170,1546,149,78,71,17
"10780",NA,22043,"Grant Parish, LA","County or equivalent",2004,18986,246,54,254,200,210,4,206,-18
"10780",NA,22079,"Rapides Parish, LA","County or equivalent",2004,127322,544,570,1916,1346,-61,74,-135,35
"10900",NA,NA,"Allentown-Bethlehem-Easton, PA-NJ","Metropolitan Statistical Area",2004,775143,9866,1598,9137,7539,8732,1245,7487,-464
"10900",NA,34041,"Warren County, NJ","County or equivalent",2004,108607,375,318,1275,957,128,170,-42,-71
"10900",NA,42025,"Carbon County, PA","County or equivalent",2004,60653,655,-100,648,748,824,14,810,-69
"10900",NA,42077,"Lehigh County, PA","County or equivalent",2004,324103,3961,836,4017,3181,3414,653,2761,-289
"10900",NA,42095,"Northampton County, PA","County or equivalent",2004,281780,4875,544,3197,2653,4366,408,3958,-35
"11020",NA,NA,"Altoona, PA","Metropolitan Statistical Area",2004,126529,-308,-150,1441,1591,-72,28,-100,-86
"11020",NA,42013,"Blair County, PA","County or equivalent",2004,126529,-308,-150,1441,1591,-72,28,-100,-86
"11100",NA,NA,"Amarillo, TX","Metropolitan Statistical Area",2004,235015,2308,1823,3873,2050,717,430,287,-232
"11100",NA,48011,"Armstrong County, TX","County or equivalent",2004,2094,41,-5,24,29,49,0,49,-3
"11100",NA,48065,"Carson County, TX","County or equivalent",2004,6341,-26,19,76,57,-39,2,-41,-6
"11100",NA,48375,"Potter County, TX","County or equivalent",2004,118217,759,1229,2394,1165,-364,327,-691,-106
"11100",NA,48381,"Randall County, TX","County or equivalent",2004,108363,1534,580,1379,799,1071,101,970,-117
"11180",NA,NA,"Ames, IA","Metropolitan Statistical Area",2004,81957,476,450,900,450,88,413,-325,-62
"11180",NA,19169,"Story County, IA","County or equivalent",2004,81957,476,450,900,450,88,413,-325,-62
"11260",NA,NA,"Anchorage, AK","Metropolitan Statistical Area",2004,345498,6833,3975,5435,1460,3198,1144,2054,-340
"11260",NA,2020,"Anchorage Municipality, AK","County or equivalent",2004,274317,3142,3265,4403,1138,72,1082,-1010,-195
"11260",NA,2170,"Matanuska-Susitna Borough, AK","County or equivalent",2004,71181,3691,710,1032,322,3126,62,3064,-145
"11300",NA,NA,"Anderson, IN","Metropolitan Statistical Area",2004,131198,-429,201,1659,1458,-528,69,-597,-102
"11300",NA,18095,"Madison County, IN","County or equivalent",2004,131198,-429,201,1659,1458,-528,69,-597,-102
"11340",NA,NA,"Anderson, SC","Metropolitan Statistical Area",2004,172588,1456,376,2210,1834,1220,108,1112,-140
"11340",NA,45007,"Anderson County, SC","County or equivalent",2004,172588,1456,376,2210,1834,1220,108,1112,-140
"11460",NA,NA,"Ann Arbor, MI","Metropolitan Statistical Area",2004,340725,3632,2391,4268,1877,1463,1653,-190,-222
"11460",NA,26161,"Washtenaw County, MI","County or equivalent",2004,340725,3632,2391,4268,1877,1463,1653,-190,-222
"11500",NA,NA,"Anniston-Oxford, AL","Metropolitan Statistical Area",2004,111520,212,208,1521,1313,79,55,24,-75
"11500",NA,1015,"Calhoun County, AL","County or equivalent",2004,111520,212,208,1521,1313,79,55,24,-75
"11540",NA,NA,"Appleton, WI","Metropolitan Statistical Area",2004,212161,1935,1601,2995,1394,472,181,291,-138
"11540",NA,55015,"Calumet County, WI","County or equivalent",2004,43735,398,421,673,252,6,28,-22,-29
"11540",NA,55087,"Outagamie County, WI","County or equivalent",2004,168426,1537,1180,2322,1142,466,153,313,-109
"11700",NA,NA,"Asheville, NC","Metropolitan Statistical Area",2004,386320,4551,309,4526,4217,4615,668,3947,-373
"11700",NA,37021,"Buncombe County, NC","County or equivalent",2004,215777,2663,451,2591,2140,2413,382,2031,-201
"11700",NA,37087,"Haywood County, NC","County or equivalent",2004,55814,467,-110,559,669,636,21,615,-59
"11700",NA,37089,"Henderson County, NC","County or equivalent",2004,94833,1319,-38,1148,1186,1454,252,1202,-97
"11700",NA,37115,"Madison County, NC","County or equivalent",2004,19896,102,6,228,222,112,13,99,-16
"12020",NA,NA,"Athens-Clarke County, GA","Metropolitan Statistical Area",2004,178022,4199,990,2255,1265,3416,640,2776,-207
"12020",NA,13059,"Clarke County, GA","County or equivalent",2004,109170,3430,719,1418,699,2853,583,2270,-142
"12020",NA,13195,"Madison County, GA","County or equivalent",2004,26934,6,64,338,274,-40,19,-59,-18
"12020",NA,13219,"Oconee County, GA","County or equivalent",2004,28537,604,161,342,181,475,35,440,-32
"12020",NA,13221,"Oglethorpe County, GA","County or equivalent",2004,13381,159,46,157,111,128,3,125,-15
"12060",NA,NA,"Atlanta-Sandy Springs-Marietta, GA","Metropolitan Statistical Area",2004,4801265,128931,48242,76606,28364,53460,21163,32297,27229
"12060",NA,13013,"Barrow County, GA","County or equivalent",2004,56167,3120,590,998,408,2647,48,2599,-117
"12060",NA,13015,"Bartow County, GA","County or equivalent",2004,86148,1709,826,1509,683,961,101,860,-78
"12060",NA,13035,"Butts County, GA","County or equivalent",2004,22025,213,96,287,191,134,5,129,-17
"12060",NA,13045,"Carroll County, GA","County or equivalent",2004,101258,2782,730,1541,811,2175,160,2015,-123
"12060",NA,13057,"Cherokee County, GA","County or equivalent",2004,173568,7714,2032,2972,940,5961,404,5557,-279
"12060",NA,13063,"Clayton County, GA","County or equivalent",2004,262119,4299,3359,4743,1384,1102,1238,-136,-162
"12060",NA,13067,"Cobb County, GA","County or equivalent",2004,652157,8524,7221,10547,3326,1777,3497,-1720,-474
"12060",NA,13077,"Coweta County, GA","County or equivalent",2004,104387,3773,899,1604,705,3021,201,2820,-147
"12060",NA,13085,"Dawson County, GA","County or equivalent",2004,18797,408,145,277,132,283,9,274,-20
"12060",NA,13089,"DeKalb County, GA","County or equivalent",2004,704074,7260,6929,11051,4122,-6171,5593,-11764,6502
"12060",NA,13097,"Douglas County, GA","County or equivalent",2004,106541,5127,880,1585,705,4460,148,4312,-213
"12060",NA,13113,"Fayette County, GA","County or equivalent",2004,99888,1912,287,934,647,1731,194,1537,-106
"12060",NA,13117,"Forsyth County, GA","County or equivalent",2004,130233,7115,1620,2293,673,5747,292,5455,-252
"12060",NA,13121,"Fulton County, GA","County or equivalent",2004,905802,23874,6995,12817,5822,-7751,4245,-11996,24630
"12060",NA,13135,"Gwinnett County, GA","County or equivalent",2004,692302,25324,10009,12810,2801,16125,4346,11779,-810
"12060",NA,13143,"Haralson County, GA","County or equivalent",2004,27731,422,85,366,281,365,9,356,-28
"12060",NA,13149,"Heard County, GA","County or equivalent",2004,11177,72,25,141,116,54,2,52,-7
"12060",NA,13151,"Henry County, GA","County or equivalent",2004,157954,8499,1712,2559,847,7130,103,7027,-343
"12060",NA,13159,"Jasper County, GA","County or equivalent",2004,12604,171,44,176,132,140,9,131,-13
"12060",NA,13171,"Lamar County, GA","County or equivalent",2004,16299,52,20,193,173,43,5,38,-11
"12060",NA,13199,"Meriwether County, GA","County or equivalent",2004,22805,65,26,307,281,54,1,53,-15
"12060",NA,13217,"Newton County, GA","County or equivalent",2004,80675,4962,881,1427,546,4268,57,4211,-187
"12060",NA,13223,"Paulding County, GA","County or equivalent",2004,104798,5628,1238,1816,578,4602,55,4547,-212
"12060",NA,13227,"Pickens County, GA","County or equivalent",2004,27487,796,111,323,212,725,17,708,-40
"12060",NA,13231,"Pike County, GA","County or equivalent",2004,15573,554,53,185,132,528,1,527,-27
"12060",NA,13247,"Rockdale County, GA","County or equivalent",2004,76284,1664,574,1100,526,1169,307,862,-79
"12060",NA,13255,"Spalding County, GA","County or equivalent",2004,60698,366,337,970,633,68,78,-10,-39
"12060",NA,13297,"Walton County, GA","County or equivalent",2004,71714,2526,518,1075,557,2112,38,2074,-104
"12100",NA,NA,"Atlantic City-Hammonton, NJ","Metropolitan Statistical Area",2004,265820,4199,810,3493,2683,3634,1047,2587,-245
"12100",NA,34001,"Atlantic County, NJ","County or equivalent",2004,265820,4199,810,3493,2683,3634,1047,2587,-245
"12220",NA,NA,"Auburn-Opelika, AL","Metropolitan Statistical Area",2004,121542,2022,593,1419,826,1547,166,1381,-118
"12220",NA,1081,"Lee County, AL","County or equivalent",2004,121542,2022,593,1419,826,1547,166,1381,-118
"12260",NA,NA,"Augusta-Richmond County, GA-SC","Metropolitan Statistical Area",2004,514118,4833,2591,7252,4661,2742,962,1780,-500
"12260",NA,13033,"Burke County, GA","County or equivalent",2004,22825,135,160,411,251,-9,7,-16,-16
"12260",NA,13073,"Columbia County, GA","County or equivalent",2004,99571,3197,734,1350,616,2598,155,2443,-135
"12260",NA,13189,"McDuffie County, GA","County or equivalent",2004,21264,83,101,339,238,-4,6,-10,-14
"12260",NA,13245,"Richmond County, GA","County or equivalent",2004,197805,-453,1173,3131,1958,-1440,630,-2070,-186
"12260",NA,45003,"Aiken County, SC","County or equivalent",2004,147488,1622,407,1780,1373,1339,154,1185,-124
"12260",NA,45037,"Edgefield County, SC","County or equivalent",2004,25165,249,16,241,225,258,10,248,-25
"12420",NA,NA,"Austin-Round Rock, TX","Metropolitan Statistical Area",2004,1419137,36462,16304,23284,6980,21473,6849,14624,-1315
"12420",NA,48021,"Bastrop County, TX","County or equivalent",2004,67536,1408,334,852,518,1145,126,1019,-71
"12420",NA,48055,"Caldwell County, TX","County or equivalent",2004,36044,813,240,539,299,615,36,579,-42
"12420",NA,48209,"Hays County, TX","County or equivalent",2004,120244,3961,1074,1697,623,3048,147,2901,-161
"12420",NA,48453,"Travis County, TX","County or equivalent",2004,879247,16606,10884,14993,4109,6271,5935,336,-549
"12420",NA,48491,"Williamson County, TX","County or equivalent",2004,316066,13674,3772,5203,1431,10394,605,9789,-492
"12540",NA,NA,"Bakersfield, CA","Metropolitan Statistical Area",2004,727068,19395,7717,13169,5452,12452,2634,9818,-774
"12540",NA,6029,"Kern County, CA","County or equivalent",2004,727068,19395,7717,13169,5452,12452,2634,9818,-774
"12580",NA,NA,"Baltimore-Towson, MD","Metropolitan Statistical Area",2004,2636172,15753,11184,34513,23329,-1610,4824,-6434,6179
"12580",NA,24003,"Anne Arundel County, MD","County or equivalent",2004,508132,3132,3367,6934,3567,121,1206,-1085,-356
"12580",NA,24005,"Baltimore County, MD","County or equivalent",2004,778810,4889,1779,9368,7589,3660,1503,2157,-550
"12580",NA,24013,"Carroll County, MD","County or equivalent",2004,165000,2771,655,1938,1283,2279,63,2216,-163
"12580",NA,24025,"Harford County, MD","County or equivalent",2004,233784,3130,1248,2968,1720,2084,241,1843,-202
"12580",NA,24027,"Howard County, MD","County or equivalent",2004,264915,2398,2315,3556,1241,274,904,-630,-191
"12580",NA,24035,"Queen Anne's County, MD","County or equivalent",2004,44527,753,162,521,359,637,35,602,-46
"12580",NA,24510,"Baltimore city, MD","County or equivalent",2004,641004,-1320,1658,9228,7570,-10665,872,-11537,7687
"12620",NA,NA,"Bangor, ME","Metropolitan Statistical Area",2004,146566,-495,233,1573,1340,-615,112,-727,-113
"12620",NA,23019,"Penobscot County, ME","County or equivalent",2004,146566,-495,233,1573,1340,-615,112,-727,-113
"12700",NA,NA,"Barnstable Town, MA","Metropolitan Statistical Area",2004,226829,-1306,-927,1940,2867,-222,360,-582,-157
"12700",NA,25001,"Barnstable County, MA","County or equivalent",2004,226829,-1306,-927,1940,2867,-222,360,-582,-157
"12940",NA,NA,"Baton Rouge, LA","Metropolitan Statistical Area",2004,725212,6362,4536,10406,5870,2484,740,1744,-658
"12940",NA,22005,"Ascension Parish, LA","County or equivalent",2004,85888,2279,905,1468,563,1472,71,1401,-98
"12940",NA,22033,"East Baton Rouge Parish, LA","County or equivalent",2004,412595,1251,2400,5791,3391,-850,635,-1485,-299
"12940",NA,22037,"East Feliciana Parish, LA","County or equivalent",2004,20689,-226,67,282,215,-271,0,-271,-22
"12940",NA,22047,"Iberville Parish, LA","County or equivalent",2004,32349,-397,70,440,370,-432,4,-436,-35
"12940",NA,22063,"Livingston Parish, LA","County or equivalent",2004,104612,3561,883,1578,695,2830,21,2809,-152
"12940",NA,22077,"Pointe Coupee Parish, LA","County or equivalent",2004,22119,-87,52,301,249,-122,1,-123,-17
"12940",NA,22091,"St. Helena Parish, LA","County or equivalent",2004,10259,-63,-11,94,105,-44,1,-45,-8
"12940",NA,22121,"West Baton Rouge Parish, LA","County or equivalent",2004,21723,150,137,323,186,29,5,24,-16
"12940",NA,22125,"West Feliciana Parish, LA","County or equivalent",2004,14978,-106,33,129,96,-128,2,-130,-11
"12980",NA,NA,"Battle Creek, MI","Metropolitan Statistical Area",2004,138754,336,489,1888,1399,-55,155,-210,-98
"12980",NA,26025,"Calhoun County, MI","County or equivalent",2004,138754,336,489,1888,1399,-55,155,-210,-98
"13020",NA,NA,"Bay City, MI","Metropolitan Statistical Area",2004,108929,-193,187,1309,1122,-301,28,-329,-79
"13020",NA,26017,"Bay County, MI","County or equivalent",2004,108929,-193,187,1309,1122,-301,28,-329,-79
"13140",NA,NA,"Beaumont-Port Arthur, TX","Metropolitan Statistical Area",2004,380342,355,1224,5147,3923,-574,472,-1046,-295
"13140",NA,48199,"Hardin County, TX","County or equivalent",2004,49826,659,206,686,480,501,8,493,-48
"13140",NA,48245,"Jefferson County, TX","County or equivalent",2004,246882,-355,817,3381,2564,-980,420,-1400,-192
"13140",NA,48361,"Orange County, TX","County or equivalent",2004,83634,51,201,1080,879,-95,44,-139,-55
"13380",NA,NA,"Bellingham, WA","Metropolitan Statistical Area",2004,181575,3876,758,2070,1312,3311,501,2810,-193
"13380",NA,53073,"Whatcom County, WA","County or equivalent",2004,181575,3876,758,2070,1312,3311,501,2810,-193
"13460",NA,NA,"Bend, OR","Metropolitan Statistical Area",2004,134056,4764,650,1589,939,4331,76,4255,-217
"13460",NA,41017,"Deschutes County, OR","County or equivalent",2004,134056,4764,650,1589,939,4331,76,4255,-217
"13740",NA,NA,"Billings, MT","Metropolitan Statistical Area",2004,144189,1515,699,1932,1233,932,34,898,-116
"13740",NA,30009,"Carbon County, MT","County or equivalent",2004,9662,16,19,96,77,3,4,-1,-6
"13740",NA,30111,"Yellowstone County, MT","County or equivalent",2004,134527,1499,680,1836,1156,929,30,899,-110
"13780",NA,NA,"Binghamton, NY","Metropolitan Statistical Area",2004,248352,-1270,162,2695,2533,-1237,309,-1546,-195
"13780",NA,36007,"Broome County, NY","County or equivalent",2004,197453,-873,27,2108,2081,-749,293,-1042,-151
"13780",NA,36107,"Tioga County, NY","County or equivalent",2004,50899,-397,135,587,452,-488,16,-504,-44
"13820",NA,NA,"Birmingham-Hoover, AL","Metropolitan Statistical Area",2004,1080206,7791,3509,14796,11287,4420,1079,3341,-138
"13820",NA,1007,"Bibb County, AL","County or equivalent",2004,21209,171,40,275,235,148,7,141,-17
"13820",NA,1009,"Blount County, AL","County or equivalent",2004,54381,721,175,689,514,596,79,517,-50
"13820",NA,1021,"Chilton County, AL","County or equivalent",2004,41117,374,73,530,457,337,31,306,-36
"13820",NA,1073,"Jefferson County, AL","County or equivalent",2004,658907,-834,1768,9035,7267,-2701,767,-3468,99
"13820",NA,1115,"St. Clair County, AL","County or equivalent",2004,69940,1666,100,819,719,1659,15,1644,-93
"13820",NA,1117,"Shelby County, AL","County or equivalent",2004,165497,6054,1486,2572,1086,4561,155,4406,7
"13820",NA,1127,"Walker County, AL","County or equivalent",2004,69155,-361,-133,876,1009,-180,25,-205,-48
"13900",NA,NA,"Bismarck, ND","Metropolitan Statistical Area",2004,97744,893,491,1240,749,478,50,428,-76
"13900",NA,38015,"Burleigh County, ND","County or equivalent",2004,72626,775,383,912,529,451,39,412,-59
"13900",NA,38059,"Morton County, ND","County or equivalent",2004,25118,118,108,328,220,27,11,16,-17
"13980",NA,NA,"Blacksburg-Christiansburg-Radford, VA","Metropolitan Statistical Area",2004,153159,341,258,1530,1272,190,326,-136,-107
"13980",NA,51071,"Giles County, VA","County or equivalent",2004,16805,-22,-42,188,230,31,0,31,-11
"13980",NA,51121,"Montgomery County, VA","County or equivalent",2004,85938,284,344,865,521,2,305,-303,-62
"13980",NA,51155,"Pulaski County, VA","County or equivalent",2004,34784,36,-64,359,423,125,6,119,-25
"13980",NA,51750,"Radford city, VA","County or equivalent",2004,15632,43,20,118,98,32,15,17,-9
"14020",NA,NA,"Bloomington, IN","Metropolitan Statistical Area",2004,179243,1145,618,1947,1329,651,386,265,-124
"14020",NA,18055,"Greene County, IN","County or equivalent",2004,33172,42,44,398,354,22,4,18,-24
"14020",NA,18105,"Monroe County, IN","County or equivalent",2004,123554,1159,564,1298,734,680,379,301,-85
"14020",NA,18119,"Owen County, IN","County or equivalent",2004,22517,-56,10,251,241,-51,3,-54,-15
"14060",NA,NA,"Bloomington-Normal, IL","Metropolitan Statistical Area",2004,158369,1142,1111,2179,1068,138,226,-88,-107
"14060",NA,17113,"McLean County, IL","County or equivalent",2004,158369,1142,1111,2179,1068,138,226,-88,-107
"14260",NA,NA,"Boise City-Nampa, ID","Metropolitan Statistical Area",2004,523597,12868,5273,8670,3397,8144,1028,7116,-549
"14260",NA,16001,"Ada County, ID","County or equivalent",2004,333322,7126,3131,5140,2009,4301,645,3656,-306
"14260",NA,16015,"Boise County, ID","County or equivalent",2004,7215,64,41,70,29,29,7,22,-6
"14260",NA,16027,"Canyon County, ID","County or equivalent",2004,156605,5610,1969,3078,1109,3849,313,3536,-208
"14260",NA,16045,"Gem County, ID","County or equivalent",2004,15696,172,24,198,174,162,23,139,-14
"14260",NA,16073,"Owyhee County, ID","County or equivalent",2004,10759,-104,108,184,76,-197,40,-237,-15
"14460",NA,NA,"Boston-Cambridge-Quincy, MA-NH","Metropolitan Statistical Area",2004,4453964,-2415,20543,56202,35659,-27826,18995,-46821,4868
"14460",14484,NA,"Boston-Quincy, MA","Metropolitan Division",2004,1848954,-684,8918,23821,14903,-15039,8848,-23887,5437
"14460",14484,25021,"Norfolk County, MA","County or equivalent",2004,652805,-457,2660,8222,5562,-2581,1899,-4480,-536
"14460",14484,25023,"Plymouth County, MA","County or equivalent",2004,486180,1151,2158,6321,4163,-650,648,-1298,-357
"14460",14484,25025,"Suffolk County, MA","County or equivalent",2004,709969,-1378,4100,9278,5178,-11808,6301,-18109,6330
"14460",15764,NA,"Cambridge-Newton-Framingham, MA","Metropolitan Division",2004,1465147,-3169,6892,18217,11325,-10400,7618,-18018,339
"14460",15764,25017,"Middlesex County, MA","County or equivalent",2004,1465147,-3169,6892,18217,11325,-10400,7618,-18018,339
"14460",37764,NA,"Peabody, MA","Metropolitan Division",2004,731206,-1290,2889,9490,6601,-3544,2198,-5742,-635
"14460",37764,25009,"Essex County, MA","County or equivalent",2004,731206,-1290,2889,9490,6601,-3544,2198,-5742,-635
"14460",40484,NA,"Rockingham County-Strafford County, NH","Metropolitan Division",2004,408657,2728,1844,4674,2830,1157,331,826,-273
"14460",40484,33015,"Rockingham County, NH","County or equivalent",2004,290471,1580,1342,3284,1942,423,209,214,-185
"14460",40484,33017,"Strafford County, NH","County or equivalent",2004,118186,1148,502,1390,888,734,122,612,-88
"14500",NA,NA,"Boulder, CO /1","Metropolitan Statistical Area",2004,281049,1731,2129,3572,1443,-180,1234,-1414,-218
"14500",NA,8013,"Boulder County, CO /1","County or equivalent",2004,281049,1731,2129,3572,1443,-180,1234,-1414,-218
"14540",NA,NA,"Bowling Green, KY","Metropolitan Statistical Area",2004,109205,1470,538,1432,894,1023,294,729,-91
"14540",NA,21061,"Edmonson County, KY","County or equivalent",2004,11752,-20,10,123,113,-22,3,-25,-8
"14540",NA,21227,"Warren County, KY","County or equivalent",2004,97453,1490,528,1309,781,1045,291,754,-83
"14600",NA,NA,"Bradenton-Sarasota-Venice, FL","Metropolitan Statistical Area",2004,648554,17507,-1523,6507,8030,20054,1630,18424,-1024
"14600",NA,12081,"Manatee County, FL","County or equivalent",2004,294367,8568,168,3493,3325,8856,804,8052,-456
"14600",NA,12115,"Sarasota County, FL","County or equivalent",2004,354187,8939,-1691,3014,4705,11198,826,10372,-568
"14740",NA,NA,"Bremerton-Silverdale, WA","Metropolitan Statistical Area",2004,239179,295,1157,2969,1812,-653,846,-1499,-209
"14740",NA,53035,"Kitsap County, WA","County or equivalent",2004,239179,295,1157,2969,1812,-653,846,-1499,-209
"14860",NA,NA,"Bridgeport-Stamford-Norwalk, CT","Metropolitan Statistical Area",2004,892946,170,5260,12047,6787,-4270,5177,-9447,-820
"14860",NA,9001,"Fairfield County, CT","County or equivalent",2004,892946,170,5260,12047,6787,-4270,5177,-9447,-820
"15180",NA,NA,"Brownsville-Harlingen, TX","Metropolitan Statistical Area",2004,364809,7214,6604,8634,2030,848,1657,-809,-238
"15180",NA,48061,"Cameron County, TX","County or equivalent",2004,364809,7214,6604,8634,2030,848,1657,-809,-238
"15260",NA,NA,"Brunswick, GA","Metropolitan Statistical Area",2004,96677,735,274,1326,1052,541,116,425,-80
"15260",NA,13025,"Brantley County, GA","County or equivalent",2004,15227,64,26,189,163,48,4,44,-10
"15260",NA,13127,"Glynn County, GA","County or equivalent",2004,70480,635,227,1008,781,470,110,360,-62
"15260",NA,13191,"McIntosh County, GA","County or equivalent",2004,10970,36,21,129,108,23,2,21,-8
"15380",NA,NA,"Buffalo-Niagara Falls, NY","Metropolitan Statistical Area",2004,1149369,-5200,599,12817,12218,-4914,1157,-6071,-885
"15380",NA,36029,"Erie County, NY","County or equivalent",2004,932637,-4661,575,10417,9842,-4506,1004,-5510,-730
"15380",NA,36063,"Niagara County, NY","County or equivalent",2004,216732,-539,24,2400,2376,-408,153,-561,-155
"15500",NA,NA,"Burlington, NC","Metropolitan Statistical Area",2004,137747,1697,520,1834,1314,1289,516,773,-112
"15500",NA,37001,"Alamance County, NC","County or equivalent",2004,137747,1697,520,1834,1314,1289,516,773,-112
"15540",NA,NA,"Burlington-South Burlington, VT","Metropolitan Statistical Area",2004,204590,1239,1001,2414,1413,382,389,-7,-144
"15540",NA,50007,"Chittenden County, VT","County or equivalent",2004,149889,706,703,1675,972,107,366,-259,-104
"15540",NA,50011,"Franklin County, VT","County or equivalent",2004,47200,417,270,650,380,180,23,157,-33
"15540",NA,50013,"Grand Isle County, VT","County or equivalent",2004,7501,116,28,89,61,95,0,95,-7
"15940",NA,NA,"Canton-Massillon, OH","Metropolitan Statistical Area",2004,408380,63,612,4781,4169,-615,70,-685,66
"15940",NA,39019,"Carroll County, OH","County or equivalent",2004,29115,-70,50,310,260,-100,2,-102,-20
"15940",NA,39151,"Stark County, OH","County or equivalent",2004,379265,133,562,4471,3909,-515,68,-583,86
"15980",NA,NA,"Cape Coral-Fort Myers, FL","Metropolitan Statistical Area",2004,511959,21936,300,5737,5437,22674,1468,21206,-1038
"15980",NA,12071,"Lee County, FL","County or equivalent",2004,511959,21936,300,5737,5437,22674,1468,21206,-1038
"16180",NA,NA,"Carson City, NV","Metropolitan Statistical Area",2004,55670,677,113,746,633,610,163,447,-46
"16180",NA,32510,"Carson City, NV","County or equivalent",2004,55670,677,113,746,633,610,163,447,-46
"16220",NA,NA,"Casper, WY","Metropolitan Statistical Area",2004,68637,698,451,994,543,300,34,266,-53
"16220",NA,56025,"Natrona County, WY","County or equivalent",2004,68637,698,451,994,543,300,34,266,-53
"16300",NA,NA,"Cedar Rapids, IA","Metropolitan Statistical Area",2004,245006,1908,1383,3323,1940,454,225,229,71
"16300",NA,19011,"Benton County, IA","County or equivalent",2004,26494,320,91,319,228,223,4,219,6
"16300",NA,19105,"Jones County, IA","County or equivalent",2004,20373,156,9,217,208,166,1,165,-19
"16300",NA,19113,"Linn County, IA","County or equivalent",2004,198139,1432,1283,2787,1504,65,220,-155,84
"16580",NA,NA,"Champaign-Urbana, IL","Metropolitan Statistical Area",2004,216860,1211,1112,2648,1536,256,813,-557,-157
"16580",NA,17019,"Champaign County, IL","County or equivalent",2004,186459,1136,1103,2288,1185,168,805,-637,-135
"16580",NA,17053,"Ford County, IL","County or equivalent",2004,14057,16,-42,168,210,68,5,63,-10
"16580",NA,17147,"Piatt County, IL","County or equivalent",2004,16344,59,51,192,141,20,3,17,-12
"16620",NA,NA,"Charleston, WV","Metropolitan Statistical Area",2004,305941,-221,166,3888,3722,-162,86,-248,-225
"16620",NA,54005,"Boone County, WV","County or equivalent",2004,25463,-88,13,322,309,-82,6,-88,-19
"16620",NA,54015,"Clay County, WV","County or equivalent",2004,10289,52,18,141,123,42,0,42,-8
"16620",NA,54039,"Kanawha County, WV","County or equivalent",2004,194543,-750,-79,2445,2524,-535,70,-605,-136
"16620",NA,54043,"Lincoln County, WV","County or equivalent",2004,22304,-14,13,295,282,-13,0,-13,-14
"16620",NA,54079,"Putnam County, WV","County or equivalent",2004,53342,579,201,685,484,426,10,416,-48
"16700",NA,NA,"Charleston-North Charleston-Summerville, SC","Metropolitan Statistical Area",2004,590119,13468,3901,8313,4412,9574,1403,8171,-7
"16700",NA,45015,"Berkeley County, SC","County or equivalent",2004,151397,3005,1281,2223,942,1859,506,1353,-135
"16700",NA,45019,"Charleston County, SC","County or equivalent",2004,332561,7661,2000,4715,2715,5402,749,4653,259
"16700",NA,45035,"Dorchester County, SC","County or equivalent",2004,106161,2802,620,1375,755,2313,148,2165,-131
"16740",NA,NA,"Charlotte-Gastonia-Concord, NC-SC","Metropolitan Statistical Area",2004,1470342,34432,12075,22674,10599,23907,4915,18992,-1550
"16740",NA,37007,"Anson County, NC","County or equivalent",2004,25482,404,34,329,295,398,6,392,-28
"16740",NA,37025,"Cabarrus County, NC","County or equivalent",2004,145050,2525,989,2200,1211,1667,330,1337,-131
"16740",NA,37071,"Gaston County, NC","County or equivalent",2004,192571,365,518,2528,2010,-22,432,-454,-131
"16740",NA,37119,"Mecklenburg County, NC","County or equivalent",2004,773362,19025,8026,12770,4744,11744,3540,8204,-745
"16740",NA,37179,"Union County, NC","County or equivalent",2004,151132,7197,1448,2395,947,6026,434,5592,-277
"16740",NA,45091,"York County, SC","County or equivalent",2004,182745,4916,1060,2452,1392,4094,173,3921,-238
"16820",NA,NA,"Charlottesville, VA","Metropolitan Statistical Area",2004,184691,2251,912,2291,1379,884,452,432,455
"16820",NA,51003,"Albemarle County, VA","County or equivalent",2004,88650,1373,388,1009,621,1063,295,768,-78
"16820",NA,51065,"Fluvanna County, VA","County or equivalent",2004,23588,632,180,344,164,483,7,476,-31
"16820",NA,51079,"Greene County, VA","County or equivalent",2004,16905,232,141,259,118,104,3,101,-13
"16820",NA,51125,"Nelson County, VA","County or equivalent",2004,14803,-1,-6,162,168,15,2,13,-10
"16820",NA,51540,"Charlottesville city, VA","County or equivalent",2004,40745,15,209,517,308,-781,145,-926,587
"16860",NA,NA,"Chattanooga, TN-GA","Metropolitan Statistical Area",2004,496817,4758,1301,6266,4965,1448,448,1000,2009
"16860",NA,13047,"Catoosa County, GA","County or equivalent",2004,58847,1239,243,753,510,1068,23,1045,-72
"16860",NA,13083,"Dade County, GA","County or equivalent",2004,15793,73,35,184,149,49,9,40,-11
"16860",NA,13295,"Walker County, GA","County or equivalent",2004,62612,416,98,747,649,370,28,342,-52
"16860",NA,47065,"Hamilton County, TN","County or equivalent",2004,319463,2904,770,4030,3260,-49,379,-428,2183
"16860",NA,47115,"Marion County, TN","County or equivalent",2004,27752,-192,86,379,293,-255,3,-258,-23
"16860",NA,47153,"Sequatchie County, TN","County or equivalent",2004,12350,318,69,173,104,265,6,259,-16
"16940",NA,NA,"Cheyenne, WY","Metropolitan Statistical Area",2004,85210,921,558,1261,703,423,250,173,-60
"16940",NA,56021,"Laramie County, WY","County or equivalent",2004,85210,921,558,1261,703,423,250,173,-60
"16980",NA,NA,"Chicago-Naperville-Joliet, IL-IN-WI","Metropolitan Statistical Area",2004,9351947,52946,73470,142929,69459,-19882,45673,-65555,-642
"16980",16974,NA,"Chicago-Naperville-Joliet, IL","Metropolitan Division",2004,7823029,38299,62994,120760,57766,-24501,40687,-65188,-194
"16980",16974,17031,"Cook County, IL","County or equivalent",2004,5316484,-23162,38873,82171,43298,-62583,32249,-94832,548
"16980",16974,17037,"DeKalb County, IL","County or equivalent",2004,97015,2274,554,1177,623,1772,245,1527,-52
"16980",16974,17043,"DuPage County, IL","County or equivalent",2004,924777,3120,7247,12851,5604,-4175,4278,-8453,48
"16980",16974,17063,"Grundy County, IL","County or equivalent",2004,40870,1453,223,584,361,1297,31,1266,-67
"16980",16974,17089,"Kane County, IL","County or equivalent",2004,468212,13551,6127,8696,2569,7397,2340,5057,27
"16980",16974,17093,"Kendall County, IL","County or equivalent",2004,72308,5472,871,1223,352,4716,61,4655,-115
"16980",16974,17111,"McHenry County, IL","County or equivalent",2004,294596,7538,2626,4295,1669,4914,605,4309,-2
"16980",16974,17197,"Will County, IL","County or equivalent",2004,608767,28053,6473,9763,3290,22161,878,21283,-581
"16980",23844,NA,"Gary, IN","Metropolitan Division",2004,684640,3653,3014,9535,6521,1127,634,493,-488
"16980",23844,18073,"Jasper County, IN","County or equivalent",2004,31088,305,148,412,264,182,10,172,-25
"16980",23844,18089,"Lake County, IN","County or equivalent",2004,485972,1567,2208,7072,4864,-319,493,-812,-322
"16980",23844,18111,"Newton County, IN","County or equivalent",2004,14161,-117,-10,144,154,-95,11,-106,-12
"16980",23844,18127,"Porter County, IN","County or equivalent",2004,153419,1898,668,1907,1239,1359,120,1239,-129
"16980",29404,NA,"Lake County-Kenosha County, IL-WI","Metropolitan Division",2004,844278,10994,7462,12634,5172,3492,4352,-860,40
"16980",29404,17097,"Lake County, IL","County or equivalent",2004,686580,9019,6603,10498,3895,2248,4151,-1903,168
"16980",29404,55059,"Kenosha County, WI","County or equivalent",2004,157698,1975,859,2136,1277,1244,201,1043,-128
"17020",NA,NA,"Chico, CA","Metropolitan Statistical Area",2004,213193,1609,237,2401,2164,1544,367,1177,-172
"17020",NA,6007,"Butte County, CA","County or equivalent",2004,213193,1609,237,2401,2164,1544,367,1177,-172
"17140",NA,NA,"Cincinnati-Middletown, OH-KY-IN","Metropolitan Statistical Area",2004,2082796,17265,11857,29568,17711,-61,2014,-2075,5469
"17140",NA,18029,"Dearborn County, IN","County or equivalent",2004,48299,552,275,637,362,318,11,307,-41
"17140",NA,18047,"Franklin County, IN","County or equivalent",2004,22756,138,134,311,177,19,2,17,-15
"17140",NA,18115,"Ohio County, IN","County or equivalent",2004,5806,56,-3,66,69,65,0,65,-6
"17140",NA,21015,"Boone County, KY","County or equivalent",2004,100791,4184,1027,1632,605,3319,152,3167,-162
"17140",NA,21023,"Bracken County, KY","County or equivalent",2004,8664,224,33,119,86,203,0,203,-12
"17140",NA,21037,"Campbell County, KY","County or equivalent",2004,87057,-596,288,1129,841,-803,59,-862,-81
"17140",NA,21077,"Gallatin County, KY","County or equivalent",2004,7979,-13,51,142,91,-56,0,-56,-8
"17140",NA,21081,"Grant County, KY","County or equivalent",2004,24214,319,221,396,175,116,8,108,-18
"17140",NA,21117,"Kenton County, KY","County or equivalent",2004,152833,488,1072,2405,1333,-471,95,-566,-113
"17140",NA,21191,"Pendleton County, KY","County or equivalent",2004,14846,0,43,169,126,-34,7,-41,-9
"17140",NA,39015,"Brown County, OH","County or equivalent",2004,43623,112,157,569,412,-16,6,-22,-29
"17140",NA,39017,"Butler County, OH","County or equivalent",2004,344784,3117,2046,4803,2757,1315,285,1030,-244
"17140",NA,39025,"Clermont County, OH","County or equivalent",2004,187297,2707,1492,2790,1298,1368,84,1284,-153
"17140",NA,39061,"Hamilton County, OH","County or equivalent",2004,846254,-907,3603,11736,8133,-11160,1176,-12336,6650
"17140",NA,39165,"Warren County, OH","County or equivalent",2004,187593,6884,1418,2664,1246,5756,129,5627,-290
"17300",NA,NA,"Clarksville, TN-KY","Metropolitan Statistical Area",2004,244656,3290,1948,3767,1819,298,1588,-1290,1044
"17300",NA,21047,"Christian County, KY","County or equivalent",2004,77703,543,697,1315,618,-1333,680,-2013,1179
"17300",NA,21221,"Trigg County, KY","County or equivalent",2004,13032,298,1,153,152,317,13,304,-20
"17300",NA,47125,"Montgomery County, TN","County or equivalent",2004,141247,2495,1250,2161,911,1350,883,467,-105
"17300",NA,47161,"Stewart County, TN","County or equivalent",2004,12674,-46,0,138,138,-36,12,-48,-10
"17420",NA,NA,"Cleveland, TN","Metropolitan Statistical Area",2004,106889,872,407,1437,1030,556,91,465,-91
"17420",NA,47011,"Bradley County, TN","County or equivalent",2004,91105,1061,393,1232,839,746,88,658,-78
"17420",NA,47139,"Polk County, TN","County or equivalent",2004,15784,-189,14,205,191,-190,3,-193,-13
"17460",NA,NA,"Cleveland-Elyria-Mentor, OH","Metropolitan Statistical Area",2004,2127333,-7356,5027,26728,21701,-11699,2898,-14597,-684
"17460",NA,39035,"Cuyahoga County, OH","County or equivalent",2004,1342569,-13827,2331,17326,14995,-14836,2250,-17086,-1322
"17460",NA,39055,"Geauga County, OH","County or equivalent",2004,93791,337,369,1083,714,30,25,5,-62
"17460",NA,39085,"Lake County, OH","County or equivalent",2004,232004,910,395,2576,2181,446,347,99,69
"17460",NA,39093,"Lorain County, OH","County or equivalent",2004,295327,2336,1040,3685,2645,501,190,311,795
"17460",NA,39103,"Medina County, OH","County or equivalent",2004,163642,2888,892,2058,1166,2160,86,2074,-164
"17660",NA,NA,"Coeur d'Alene, ID","Metropolitan Statistical Area",2004,121621,4669,623,1569,946,4247,46,4201,-201
"17660",NA,16055,"Kootenai County, ID","County or equivalent",2004,121621,4669,623,1569,946,4247,46,4201,-201
"17780",NA,NA,"College Station-Bryan, TX","Metropolitan Statistical Area",2004,193717,1747,1634,2786,1152,264,949,-685,-151
"17780",NA,48041,"Brazos County, TX","County or equivalent",2004,161204,1654,1522,2328,806,257,923,-666,-125
"17780",NA,48051,"Burleson County, TX","County or equivalent",2004,16713,23,78,236,158,-41,9,-50,-14
"17780",NA,48395,"Robertson County, TX","County or equivalent",2004,15800,70,34,222,188,48,17,31,-12
"17820",NA,NA,"Colorado Springs, CO","Metropolitan Statistical Area",2004,580040,7509,4987,8463,3476,1602,2379,-777,920
"17820",NA,8041,"El Paso County, CO","County or equivalent",2004,558896,7644,4864,8247,3383,1842,2373,-531,938
"17820",NA,8119,"Teller County, CO","County or equivalent",2004,21144,-135,123,216,93,-240,6,-246,-18
"17860",NA,NA,"Columbia, MO","Metropolitan Statistical Area",2004,153177,1764,1026,2027,1001,852,339,513,-114
"17860",NA,29019,"Boone County, MO","County or equivalent",2004,143307,1841,1029,1920,891,918,338,580,-106
"17860",NA,29089,"Howard County, MO","County or equivalent",2004,9870,-77,-3,107,110,-66,1,-67,-8
"17900",NA,NA,"Columbia, SC","Metropolitan Statistical Area",2004,684239,11616,3532,9135,5603,8763,1591,7172,-679
"17900",NA,45017,"Calhoun County, SC","County or equivalent",2004,14974,-143,4,176,172,-136,6,-142,-11
"17900",NA,45039,"Fairfield County, SC","County or equivalent",2004,23921,263,-8,288,296,296,2,294,-25
"17900",NA,45055,"Kershaw County, SC","County or equivalent",2004,54856,665,143,704,561,572,20,552,-50
"17900",NA,45063,"Lexington County, SC","County or equivalent",2004,229233,3468,1304,3151,1847,2364,329,2035,-200
"17900",NA,45079,"Richland County, SC","County or equivalent",2004,342699,7644,2084,4601,2517,5931,1138,4793,-371
"17900",NA,45081,"Saluda County, SC","County or equivalent",2004,18556,-281,5,215,210,-264,96,-360,-22
"17980",NA,NA,"Columbus, GA-AL","Metropolitan Statistical Area",2004,286513,4964,1620,4320,2700,3645,1378,2267,-301
"17980",NA,1113,"Russell County, AL","County or equivalent",2004,48917,289,34,610,576,293,68,225,-38
"17980",NA,13053,"Chattahoochee County, GA","County or equivalent",2004,17481,42,178,216,38,-108,432,-540,-28
"17980",NA,13145,"Harris County, GA","County or equivalent",2004,26520,780,116,310,194,703,17,686,-39
"17980",NA,13197,"Marion County, GA","County or equivalent",2004,6991,-30,33,113,80,-56,19,-75,-7
"17980",NA,13215,"Muscogee County, GA","County or equivalent",2004,186604,3883,1259,3071,1812,2813,842,1971,-189
"18020",NA,NA,"Columbus, IN","Metropolitan Statistical Area",2004,72420,494,352,1043,691,193,187,6,-51
"18020",NA,18005,"Bartholomew County, IN","County or equivalent",2004,72420,494,352,1043,691,193,187,6,-51
"18140",NA,NA,"Columbus, OH","Metropolitan Statistical Area",2004,1694729,16938,12622,25612,12990,5803,3515,2288,-1487
"18140",NA,39041,"Delaware County, OH","County or equivalent",2004,141936,7062,1583,2369,786,5595,55,5540,-116
"18140",NA,39045,"Fairfield County, OH","County or equivalent",2004,135094,3088,556,1667,1111,2702,21,2681,-170
"18140",NA,39049,"Franklin County, OH","County or equivalent",2004,1094588,3199,8936,17344,8408,-4815,3340,-8155,-922
"18140",NA,39089,"Licking County, OH","County or equivalent",2004,152125,1931,736,2057,1321,1329,52,1277,-134
"18140",NA,39097,"Madison County, OH","County or equivalent",2004,40736,144,87,449,362,84,28,56,-27
"18140",NA,39117,"Morrow County, OH","County or equivalent",2004,33832,459,158,421,263,335,3,332,-34
"18140",NA,39129,"Pickaway County, OH","County or equivalent",2004,51774,130,227,646,419,-61,4,-65,-36
"18140",NA,39159,"Union County, OH","County or equivalent",2004,44644,925,339,659,320,634,12,622,-48
"18580",NA,NA,"Corpus Christi, TX","Metropolitan Statistical Area",2004,407021,3442,3094,6401,3307,628,842,-214,-280
"18580",NA,48007,"Aransas County, TX","County or equivalent",2004,23730,359,-18,263,281,403,36,367,-26
"18580",NA,48355,"Nueces County, TX","County or equivalent",2004,315640,2458,2465,4964,2499,198,586,-388,-205
"18580",NA,48409,"San Patricio County, TX","County or equivalent",2004,67651,625,647,1174,527,27,220,-193,-49
"18700",NA,NA,"Corvallis, OR","Metropolitan Statistical Area",2004,78949,-449,256,752,496,-624,284,-908,-81
"18700",NA,41003,"Benton County, OR","County or equivalent",2004,78949,-449,256,752,496,-624,284,-908,-81
"19060",NA,NA,"Cumberland, MD-WV","Metropolitan Statistical Area",2004,100354,-129,-319,941,1260,268,16,252,-78
"19060",NA,24001,"Allegany County, MD","County or equivalent",2004,73398,71,-278,665,943,407,12,395,-58
"19060",NA,54057,"Mineral County, WV","County or equivalent",2004,26956,-200,-41,276,317,-139,4,-143,-20
"19100",NA,NA,"Dallas-Fort Worth-Arlington, TX","Metropolitan Statistical Area",2004,5691024,108325,65368,98193,32825,42317,33813,8504,640
"19100",19124,NA,"Dallas-Plano-Irving, TX","Metropolitan Division",2004,3815353,73819,45837,66720,20883,25909,26053,-144,2073
"19100",19124,48085,"Collin County, TX","County or equivalent",2004,628010,31171,8146,10301,2155,23253,2648,20605,-228
"19100",19124,48113,"Dallas County, TX","County or equivalent",2004,2297946,10540,28488,42389,13901,-20672,21208,-41880,2724
"19100",19124,48119,"Delta County, TX","County or equivalent",2004,5510,120,-19,65,84,146,0,146,-7
"19100",19124,48121,"Denton County, TX","County or equivalent",2004,533151,21070,6862,8815,1953,14305,1491,12814,-97
"19100",19124,48139,"Ellis County, TX","County or equivalent",2004,127216,3512,990,1961,971,2672,299,2373,-150
"19100",19124,48231,"Hunt County, TX","County or equivalent",2004,81038,848,326,1095,769,588,169,419,-66
"19100",19124,48257,"Kaufman County, TX","County or equivalent",2004,84566,3076,530,1253,723,2585,159,2426,-39
"19100",19124,48397,"Rockwall County, TX","County or equivalent",2004,57916,3482,514,841,327,3032,79,2953,-64
"19100",23104,NA,"Fort Worth-Arlington, TX","Metropolitan Division",2004,1875671,34506,19531,31473,11942,16408,7760,8648,-1433
"19100",23104,48251,"Johnson County, TX","County or equivalent",2004,141398,3180,915,1989,1074,2421,210,2211,-156
"19100",23104,48367,"Parker County, TX","County or equivalent",2004,98877,2164,372,1124,752,1913,76,1837,-121
"19100",23104,48439,"Tarrant County, TX","County or equivalent",2004,1580804,28323,18007,27694,9687,11419,7382,4037,-1103
"19100",23104,48497,"Wise County, TX","County or equivalent",2004,54592,839,237,666,429,655,92,563,-53
"19140",NA,NA,"Dalton, GA","Metropolitan Statistical Area",2004,128354,2097,1423,2415,992,770,776,-6,-96
"19140",NA,13213,"Murray County, GA","County or equivalent",2004,39798,550,292,584,292,291,50,241,-33
"19140",NA,13313,"Whitfield County, GA","County or equivalent",2004,88556,1547,1131,1831,700,479,726,-247,-63
"19180",NA,NA,"Danville, IL","Metropolitan Statistical Area",2004,82170,-216,107,1112,1005,-262,43,-305,-61
"19180",NA,17183,"Vermilion County, IL","County or equivalent",2004,82170,-216,107,1112,1005,-262,43,-305,-61
"19260",NA,NA,"Danville, VA","Metropolitan Statistical Area",2004,107330,-764,-39,1261,1300,-632,76,-708,-93
"19260",NA,51143,"Pittsylvania County, VA","County or equivalent",2004,61067,-105,77,678,601,-141,36,-177,-41
"19260",NA,51590,"Danville city, VA","County or equivalent",2004,46263,-659,-116,583,699,-491,40,-531,-52
"19340",NA,NA,"Davenport-Moline-Rock Island, IA-IL","Metropolitan Statistical Area",2004,372805,-42,1492,4897,3405,-1386,454,-1840,-148
"19340",NA,17073,"Henry County, IL","County or equivalent",2004,49940,-333,20,566,546,-311,22,-333,-42
"19340",NA,17131,"Mercer County, IL","County or equivalent",2004,16701,-59,19,170,151,-65,2,-67,-13
"19340",NA,17161,"Rock Island County, IL","County or equivalent",2004,146857,-199,541,1922,1381,-616,236,-852,-124
"19340",NA,19163,"Scott County, IA","County or equivalent",2004,159307,549,912,2239,1327,-394,194,-588,31
"19380",NA,NA,"Dayton, OH","Metropolitan Statistical Area",2004,845234,-86,2747,10848,8101,-2795,818,-3613,-38
"19380",NA,39057,"Greene County, OH","County or equivalent",2004,155412,2230,631,1778,1147,1063,324,739,536
"19380",NA,39109,"Miami County, OH","County or equivalent",2004,100010,491,271,1222,951,288,47,241,-68
"19380",NA,39113,"Montgomery County, OH","County or equivalent",2004,547760,-2651,1778,7356,5578,-3953,437,-4390,-476
"19380",NA,39135,"Preble County, OH","County or equivalent",2004,42052,-156,67,492,425,-193,10,-203,-30
"19460",NA,NA,"Decatur, AL","Metropolitan Statistical Area",2004,146196,-320,458,1896,1438,-661,156,-817,-117
"19460",NA,1079,"Lawrence County, AL","County or equivalent",2004,34203,-188,40,386,346,-202,8,-210,-26
"19460",NA,1103,"Morgan County, AL","County or equivalent",2004,111993,-132,418,1510,1092,-459,148,-607,-91
"19500",NA,NA,"Decatur, IL","Metropolitan Statistical Area",2004,110027,-656,104,1349,1245,-670,49,-719,-90
"19500",NA,17115,"Macon County, IL","County or equivalent",2004,110027,-656,104,1349,1245,-670,49,-719,-90
"19660",NA,NA,"Deltona-Daytona Beach-Ormond Beach, FL","Metropolitan Statistical Area",2004,476511,10693,-1151,4882,6033,12533,655,11878,-689
"19660",NA,12127,"Volusia County, FL","County or equivalent",2004,476511,10693,-1151,4882,6033,12533,655,11878,-689
"19740",NA,NA,"Denver-Aurora, CO /1","Metropolitan Statistical Area",2004,2324842,25533,23296,37184,13888,3727,10854,-7127,-1490
"19740",NA,8001,"Adams County, CO /1","County or equivalent",2004,387393,8173,5163,7377,2214,3297,2062,1235,-287
"19740",NA,8005,"Arapahoe County, CO /1","County or equivalent",2004,520427,5619,5158,8042,2884,850,2249,-1399,-389
"19740",NA,8014,"Broomfield County, CO /1","County or equivalent",2004,46626,1499,396,615,219,224,94,130,879
"19740",NA,8019,"Clear Creek County, CO /1","County or equivalent",2004,9053,-286,57,103,46,-330,0,-330,-13
"19740",NA,8031,"Denver County, CO /1","County or equivalent",2004,559871,679,5970,10316,4346,-4631,5160,-9791,-660
"19740",NA,8035,"Douglas County, CO /1","County or equivalent",2004,234781,12860,3392,3982,590,9920,343,9577,-452
"19740",NA,8039,"Elbert County, CO /1","County or equivalent",2004,22150,189,109,213,104,95,6,89,-15
"19740",NA,8047,"Gilpin County, CO /1","County or equivalent",2004,4858,-6,32,56,24,-34,1,-35,-4
"19740",NA,8059,"Jefferson County, CO /1","County or equivalent",2004,523261,-3372,2944,6333,3389,-5782,933,-6715,-534
"19740",NA,8093,"Park County, CO /1","County or equivalent",2004,16422,178,75,147,72,118,6,112,-15
"19780",NA,NA,"Des Moines-West Des Moines, IA","Metropolitan Statistical Area",2004,512100,7736,3913,7772,3859,4170,1170,3000,-347
"19780",NA,19049,"Dallas County, IA","County or equivalent",2004,49400,3083,288,627,339,2801,66,2735,-6
"19780",NA,19077,"Guthrie County, IA","County or equivalent",2004,11361,42,-34,133,167,88,2,86,-12
"19780",NA,19121,"Madison County, IA","County or equivalent",2004,14693,236,76,212,136,175,2,173,-15
"19780",NA,19153,"Polk County, IA","County or equivalent",2004,394352,4044,3442,6309,2867,884,1089,-205,-282
"19780",NA,19181,"Warren County, IA","County or equivalent",2004,42294,331,141,491,350,222,11,211,-32
"19820",NA,NA,"Detroit-Warren-Livonia, MI","Metropolitan Statistical Area",2004,4499091,6628,20937,59554,38617,-20492,10521,-31013,6183
"19820",19804,NA,"Detroit-Livonia-Dearborn, MI","Metropolitan Division",2004,2035701,-9131,9432,28548,19116,-25890,4785,-30675,7327
"19820",19804,26163,"Wayne County, MI","County or equivalent",2004,2035701,-9131,9432,28548,19116,-25890,4785,-30675,7327
"19820",47644,NA,"Warren-Troy-Farmington Hills, MI","Metropolitan Division",2004,2463390,15759,11505,31006,19501,5398,5736,-338,-1144
"19820",47644,26087,"Lapeer County, MI","County or equivalent",2004,91534,675,412,1050,638,325,35,290,-62
"19820",47644,26093,"Livingston County, MI","County or equivalent",2004,175739,4095,1045,2086,1041,3253,130,3123,-203
"19820",47644,26099,"Macomb County, MI","County or equivalent",2004,820633,6900,3011,10274,7263,3687,1629,2058,202
"19820",47644,26125,"Oakland County, MI","County or equivalent",2004,1205936,2900,6399,15478,9079,-2535,3863,-6398,-964
"19820",47644,26147,"St. Clair County, MI","County or equivalent",2004,169548,1189,638,2118,1480,668,79,589,-117
"20020",NA,NA,"Dothan, AL","Metropolitan Statistical Area",2004,134207,1249,425,1856,1431,937,67,870,-113
"20020",NA,1061,"Geneva County, AL","County or equivalent",2004,25458,-20,-12,306,318,9,11,-2,-17
"20020",NA,1067,"Henry County, AL","County or equivalent",2004,16432,62,-18,205,223,93,7,86,-13
"20020",NA,1069,"Houston County, AL","County or equivalent",2004,92317,1207,455,1345,890,835,49,786,-83
"20100",NA,NA,"Dover, DE","Metropolitan Statistical Area",2004,138319,4146,896,2023,1127,3425,326,3099,-175
"20100",NA,10001,"Kent County, DE","County or equivalent",2004,138319,4146,896,2023,1127,3425,326,3099,-175
"20220",NA,NA,"Dubuque, IA","Metropolitan Statistical Area",2004,90633,524,382,1177,795,111,91,20,31
"20220",NA,19061,"Dubuque County, IA","County or equivalent",2004,90633,524,382,1177,795,111,91,20,31
"20260",NA,NA,"Duluth, MN-WI","Metropolitan Statistical Area",2004,274979,-599,158,3101,2943,-540,127,-667,-217
"20260",NA,27017,"Carlton County, MN","County or equivalent",2004,33362,457,85,410,325,405,11,394,-33
"20260",NA,27137,"St. Louis County, MN","County or equivalent",2004,197739,-1119,23,2188,2165,-986,87,-1073,-156
"20260",NA,55031,"Douglas County, WI","County or equivalent",2004,43878,63,50,503,453,41,29,12,-28
"20500",NA,NA,"Durham, NC","Metropolitan Statistical Area",2004,451132,4923,3068,6362,3294,2215,2526,-311,-360
"20500",NA,37037,"Chatham County, NC","County or equivalent",2004,56932,1371,192,693,501,1247,293,954,-68
"20500",NA,37063,"Durham County, NC","County or equivalent",2004,239798,3166,2192,3864,1672,1142,1615,-473,-168
"20500",NA,37135,"Orange County, NC","County or equivalent",2004,117781,289,600,1330,730,-212,597,-809,-99
"20500",NA,37145,"Person County, NC","County or equivalent",2004,36621,97,84,475,391,38,21,17,-25
"20740",NA,NA,"Eau Claire, WI","Metropolitan Statistical Area",2004,153404,1691,624,1792,1168,1220,70,1150,-153
"20740",NA,55017,"Chippewa County, WI","County or equivalent",2004,58343,1582,249,691,442,1419,16,1403,-86
"20740",NA,55035,"Eau Claire County, WI","County or equivalent",2004,95061,109,375,1101,726,-199,54,-253,-67
"20940",NA,NA,"El Centro, CA","Metropolitan Statistical Area",2004,150078,2719,2000,2923,923,818,916,-98,-99
"20940",NA,6025,"Imperial County, CA","County or equivalent",2004,150078,2719,2000,2923,923,818,916,-98,-99
"21060",NA,NA,"Elizabethtown, KY","Metropolitan Statistical Area",2004,108864,319,758,1595,837,-337,487,-824,-102
"21060",NA,21093,"Hardin County, KY","County or equivalent",2004,95489,218,757,1433,676,-448,487,-935,-91
"21060",NA,21123,"Larue County, KY","County or equivalent",2004,13375,101,1,162,161,111,0,111,-11
"21140",NA,NA,"Elkhart-Goshen, IN","Metropolitan Statistical Area",2004,189948,2293,1801,3252,1451,619,693,-74,-127
"21140",NA,18039,"Elkhart County, IN","County or equivalent",2004,189948,2293,1801,3252,1451,619,693,-74,-127
"21300",NA,NA,"Elmira, NY","Metropolitan Statistical Area",2004,89386,-436,110,1041,931,-473,35,-508,-73
"21300",NA,36015,"Chemung County, NY","County or equivalent",2004,89386,-436,110,1041,931,-473,35,-508,-73
"21340",NA,NA,"El Paso, TX","Metropolitan Statistical Area",2004,703437,8061,10261,14606,4345,-1572,4227,-5799,-628
"21340",NA,48141,"El Paso County, TX","County or equivalent",2004,703437,8061,10261,14606,4345,-1572,4227,-5799,-628
"21500",NA,NA,"Erie, PA","Metropolitan Statistical Area",2004,279668,-2430,641,3310,2669,-3046,338,-3384,-25
"21500",NA,42049,"Erie County, PA","County or equivalent",2004,279668,-2430,641,3310,2669,-3046,338,-3384,-25
"21660",NA,NA,"Eugene-Springfield, OR","Metropolitan Statistical Area",2004,331990,1486,643,3644,3001,1059,562,497,-216
"21660",NA,41039,"Lane County, OR","County or equivalent",2004,331990,1486,643,3644,3001,1059,562,497,-216
"21780",NA,NA,"Evansville, IN-KY","Metropolitan Statistical Area",2004,346838,1514,1101,4647,3546,656,175,481,-243
"21780",NA,18051,"Gibson County, IN","County or equivalent",2004,32932,193,58,440,382,161,11,150,-26
"21780",NA,18129,"Posey County, IN","County or equivalent",2004,26673,-62,56,292,236,-98,8,-106,-20
"21780",NA,18163,"Vanderburgh County, IN","County or equivalent",2004,173438,599,497,2361,1864,214,105,109,-112
"21780",NA,18173,"Warrick County, IN","County or equivalent",2004,54811,654,254,699,445,444,14,430,-44
"21780",NA,21101,"Henderson County, KY","County or equivalent",2004,45033,81,193,657,464,-81,18,-99,-31
"21780",NA,21233,"Webster County, KY","County or equivalent",2004,13951,49,43,198,155,16,19,-3,-10
"21820",NA,NA,"Fairbanks, AK","Metropolitan Statistical Area",2004,92414,3120,1221,1566,345,731,541,190,1168
"21820",NA,2090,"Fairbanks North Star Borough, AK","County or equivalent",2004,92414,3120,1221,1566,345,731,541,190,1168
"22020",NA,NA,"Fargo, ND-MN","Metropolitan Statistical Area",2004,183592,4251,1392,2600,1208,3064,298,2766,-205
"22020",NA,27027,"Clay County, MN","County or equivalent",2004,52621,906,325,708,383,634,34,600,-53
"22020",NA,38017,"Cass County, ND","County or equivalent",2004,130971,3345,1067,1892,825,2430,264,2166,-152
"22140",NA,NA,"Farmington, NM","Metropolitan Statistical Area",2004,120817,1075,1224,1980,756,-68,101,-169,-81
"22140",NA,35045,"San Juan County, NM","County or equivalent",2004,120817,1075,1224,1980,756,-68,101,-169,-81
"22180",NA,NA,"Fayetteville, NC","Metropolitan Statistical Area",2004,348997,2176,3565,5952,2387,-994,3076,-4070,-395
"22180",NA,37051,"Cumberland County, NC","County or equivalent",2004,310976,753,3095,5215,2120,-1997,2865,-4862,-345
"22180",NA,37093,"Hoke County, NC","County or equivalent",2004,38021,1423,470,737,267,1003,211,792,-50
"22220",NA,NA,"Fayetteville-Springdale-Rogers, AR-MO","Metropolitan Statistical Area",2004,392169,13161,3367,6293,2926,10015,1174,8841,-221
"22220",NA,5007,"Benton County, AR","County or equivalent",2004,178598,7169,1473,2768,1295,5937,404,5533,-241
"22220",NA,5087,"Madison County, AR","County or equivalent",2004,14548,275,40,177,137,252,9,243,-17
"22220",NA,5143,"Washington County, AR","County or equivalent",2004,176733,5441,1686,2974,1288,3701,693,3008,54
"22220",NA,29119,"McDonald County, MO","County or equivalent",2004,22290,276,168,374,206,125,68,57,-17
"22380",NA,NA,"Flagstaff, AZ","Metropolitan Statistical Area",2004,123235,1775,1297,1946,649,570,161,409,-92
"22380",NA,4005,"Coconino County, AZ","County or equivalent",2004,123235,1775,1297,1946,649,570,161,409,-92
"22420",NA,NA,"Flint, MI","Metropolitan Statistical Area",2004,439778,330,2283,6296,4013,-1635,134,-1769,-318
"22420",NA,26049,"Genesee County, MI","County or equivalent",2004,439778,330,2283,6296,4013,-1635,134,-1769,-318
"22500",NA,NA,"Florence, SC","Metropolitan Statistical Area",2004,196035,496,706,2779,2073,-65,90,-155,-145
"22500",NA,45031,"Darlington County, SC","County or equivalent",2004,67096,-459,100,831,731,-501,21,-522,-58
"22500",NA,45041,"Florence County, SC","County or equivalent",2004,128939,955,606,1948,1342,436,69,367,-87
"22520",NA,NA,"Florence-Muscle Shoals, AL","Metropolitan Statistical Area",2004,141596,360,53,1567,1514,412,53,359,-105
"22520",NA,1033,"Colbert County, AL","County or equivalent",2004,54411,105,-36,560,596,184,13,171,-43
"22520",NA,1077,"Lauderdale County, AL","County or equivalent",2004,87185,255,89,1007,918,228,40,188,-62
"22540",NA,NA,"Fond du Lac, WI","Metropolitan Statistical Area",2004,98223,267,263,1178,915,70,89,-19,-66
"22540",NA,55039,"Fond du Lac County, WI","County or equivalent",2004,98223,267,263,1178,915,70,89,-19,-66
"22660",NA,NA,"Fort Collins-Loveland, CO","Metropolitan Statistical Area",2004,271871,3204,1950,3509,1559,1439,521,918,-185
"22660",NA,8069,"Larimer County, CO","County or equivalent",2004,271871,3204,1950,3509,1559,1439,521,918,-185
"22900",NA,NA,"Fort Smith, AR-OK","Metropolitan Statistical Area",2004,280020,1714,1249,4029,2780,693,467,226,-228
"22900",NA,5033,"Crawford County, AR","County or equivalent",2004,56143,829,245,734,489,636,23,613,-52
"22900",NA,5047,"Franklin County, AR","County or equivalent",2004,17885,26,5,213,208,33,8,25,-12
"22900",NA,5131,"Sebastian County, AR","County or equivalent",2004,117321,245,640,1810,1170,-301,349,-650,-94
"22900",NA,40079,"Le Flore County, OK","County or equivalent",2004,48579,177,221,747,526,-10,74,-84,-34
"22900",NA,40135,"Sequoyah County, OK","County or equivalent",2004,40092,437,138,525,387,335,13,322,-36
"23020",NA,NA,"Fort Walton Beach-Crestview-Destin, FL","Metropolitan Statistical Area",2004,182076,3558,1114,2583,1469,2623,960,1663,-179
"23020",NA,12091,"Okaloosa County, FL","County or equivalent",2004,182076,3558,1114,2583,1469,2623,960,1663,-179
"23060",NA,NA,"Fort Wayne, IN","Metropolitan Statistical Area",2004,399778,1504,2894,6060,3166,-1080,643,-1723,-310
"23060",NA,18003,"Allen County, IN","County or equivalent",2004,340291,1318,2655,5264,2609,-1068,632,-1700,-269
"23060",NA,18179,"Wells County, IN","County or equivalent",2004,27778,18,89,360,271,-50,3,-53,-21
"23060",NA,18183,"Whitley County, IN","County or equivalent",2004,31709,168,150,436,286,38,8,30,-20
"23420",NA,NA,"Fresno, CA","Metropolitan Statistical Area",2004,859729,13519,9583,15596,6013,4501,3844,657,-565
"23420",NA,6019,"Fresno County, CA","County or equivalent",2004,859729,13519,9583,15596,6013,4501,3844,657,-565
"23460",NA,NA,"Gadsden, AL","Metropolitan Statistical Area",2004,102525,-72,-107,1240,1347,102,71,31,-67
"23460",NA,1055,"Etowah County, AL","County or equivalent",2004,102525,-72,-107,1240,1347,102,71,31,-67
"23540",NA,NA,"Gainesville, FL","Metropolitan Statistical Area",2004,243701,2647,946,2731,1785,1884,667,1217,-183
"23540",NA,12001,"Alachua County, FL","County or equivalent",2004,227982,2381,936,2552,1616,1608,664,944,-163
"23540",NA,12041,"Gilchrist County, FL","County or equivalent",2004,15719,266,10,179,169,276,3,273,-20
"23580",NA,NA,"Gainesville, GA","Metropolitan Statistical Area",2004,159499,3812,1795,2935,1140,1978,1335,643,39
"23580",NA,13139,"Hall County, GA","County or equivalent",2004,159499,3812,1795,2935,1140,1978,1335,643,39
"24020",NA,NA,"Glens Falls, NY","Metropolitan Statistical Area",2004,126742,870,40,1283,1243,936,40,896,-106
"24020",NA,36113,"Warren County, NY","County or equivalent",2004,64757,263,43,637,594,266,29,237,-46
"24020",NA,36115,"Washington County, NY","County or equivalent",2004,61985,607,-3,646,649,670,11,659,-60
"24140",NA,NA,"Goldsboro, NC","Metropolitan Statistical Area",2004,113529,813,646,1739,1093,242,441,-199,-75
"24140",NA,37191,"Wayne County, NC","County or equivalent",2004,113529,813,646,1739,1093,242,441,-199,-75
"24220",NA,NA,"Grand Forks, ND-MN","Metropolitan Statistical Area",2004,97787,1709,491,1302,811,1314,263,1051,-96
"24220",NA,27119,"Polk County, MN","County or equivalent",2004,30772,21,37,404,367,4,14,-10,-20
"24220",NA,38035,"Grand Forks County, ND","County or equivalent",2004,67015,1688,454,898,444,1310,249,1061,-76
"24300",NA,NA,"Grand Junction, CO","Metropolitan Statistical Area",2004,127131,2608,514,1717,1203,2237,100,2137,-143
"24300",NA,8077,"Mesa County, CO","County or equivalent",2004,127131,2608,514,1717,1203,2237,100,2137,-143
"24340",NA,NA,"Grand Rapids-Wyoming, MI","Metropolitan Statistical Area",2004,763844,3595,6100,11670,5570,-1893,1757,-3650,-612
"24340",NA,26015,"Barry County, MI","County or equivalent",2004,58488,190,228,714,486,-2,10,-12,-36
"24340",NA,26067,"Ionia County, MI","County or equivalent",2004,63862,632,442,861,419,236,14,222,-46
"24340",NA,26081,"Kent County, MI","County or equivalent",2004,592287,2592,5258,9479,4221,-2167,1706,-3873,-499
"24340",NA,26123,"Newaygo County, MI","County or equivalent",2004,49207,181,172,616,444,40,27,13,-31
"24500",NA,NA,"Great Falls, MT","Metropolitan Statistical Area",2004,81690,631,368,1119,751,-128,225,-353,391
"24500",NA,30013,"Cascade County, MT","County or equivalent",2004,81690,631,368,1119,751,-128,225,-353,391
"24540",NA,NA,"Greeley, CO /1","Metropolitan Statistical Area",2004,218040,7204,2684,3904,1220,4792,729,4063,-272
"24540",NA,8123,"Weld County, CO /1","County or equivalent",2004,218040,7204,2684,3904,1220,4792,729,4063,-272
"24580",NA,NA,"Green Bay, WI","Metropolitan Statistical Area",2004,294317,3387,1926,4056,2130,1684,401,1283,-223
"24580",NA,55009,"Brown County, WI","County or equivalent",2004,236793,2843,1771,3386,1615,1242,394,848,-170
"24580",NA,55061,"Kewaunee County, WI","County or equivalent",2004,20431,143,80,265,185,78,5,73,-15
"24580",NA,55083,"Oconto County, WI","County or equivalent",2004,37093,401,75,405,330,364,2,362,-38
"24660",NA,NA,"Greensboro-High Point, NC","Metropolitan Statistical Area",2004,664643,3872,2928,8694,5766,1390,2246,-856,-446
"24660",NA,37081,"Guilford County, NC","County or equivalent",2004,438004,3619,2289,5837,3548,1607,1585,22,-277
"24660",NA,37151,"Randolph County, NC","County or equivalent",2004,134982,782,622,1781,1159,256,506,-250,-96
"24660",NA,37157,"Rockingham County, NC","County or equivalent",2004,91657,-529,17,1076,1059,-473,155,-628,-73
"24780",NA,NA,"Greenville, NC","Metropolitan Statistical Area",2004,161359,2349,1020,2312,1292,1471,321,1150,-142
"24780",NA,37079,"Greene County, NC","County or equivalent",2004,19785,198,67,263,196,149,66,83,-18
"24780",NA,37147,"Pitt County, NC","County or equivalent",2004,141574,2151,953,2049,1096,1322,255,1067,-124
"24860",NA,NA,"Greenville-Mauldin-Easley, SC","Metropolitan Statistical Area",2004,581807,5470,2879,7684,4805,3032,1285,1747,-441
"24860",NA,45045,"Greenville County, SC","County or equivalent",2004,399649,5138,2390,5637,3247,3057,1037,2020,-309
"24860",NA,45059,"Laurens County, SC","County or equivalent",2004,69208,-379,85,788,703,-409,70,-479,-55
"24860",NA,45077,"Pickens County, SC","County or equivalent",2004,112950,711,404,1259,855,384,178,206,-77
"25060",NA,NA,"Gulfport-Biloxi, MS","Metropolitan Statistical Area",2004,254286,4379,1283,3694,2411,3340,712,2628,-244
"25060",NA,28045,"Hancock County, MS","County or equivalent",2004,45445,610,79,535,456,580,20,560,-49
"25060",NA,28047,"Harrison County, MS","County or equivalent",2004,194544,3611,1141,2949,1808,2654,688,1966,-184
"25060",NA,28131,"Stone County, MS","County or equivalent",2004,14297,158,63,210,147,106,4,102,-11
"25180",NA,NA,"Hagerstown-Martinsburg, MD-WV","Metropolitan Statistical Area",2004,242965,6409,828,3134,2306,5920,106,5814,-339
"25180",NA,24043,"Washington County, MD","County or equivalent",2004,138707,2376,376,1738,1362,2155,72,2083,-155
"25180",NA,54003,"Berkeley County, WV","County or equivalent",2004,88619,3811,457,1237,780,3520,25,3495,-166
"25180",NA,54065,"Morgan County, WV","County or equivalent",2004,15639,222,-5,159,164,245,9,236,-18
"25260",NA,NA,"Hanford-Corcoran, CA","Metropolitan Statistical Area",2004,142390,3511,1562,2408,846,2082,692,1390,-133
"25260",NA,6031,"Kings County, CA","County or equivalent",2004,142390,3511,1562,2408,846,2082,692,1390,-133
"25420",NA,NA,"Harrisburg-Carlisle, PA","Metropolitan Statistical Area",2004,517254,1495,1090,6091,5001,798,693,105,-393
"25420",NA,42041,"Cumberland County, PA","County or equivalent",2004,220661,1611,226,2304,2078,1557,303,1254,-172
"25420",NA,42043,"Dauphin County, PA","County or equivalent",2004,252329,-325,721,3240,2519,-856,387,-1243,-190
"25420",NA,42099,"Perry County, PA","County or equivalent",2004,44264,209,143,547,404,97,3,94,-31
"25500",NA,NA,"Harrisonburg, VA","Metropolitan Statistical Area",2004,112386,883,571,1415,844,340,328,12,-28
"25500",NA,51165,"Rockingham County, VA","County or equivalent",2004,70135,658,274,868,594,374,101,273,10
"25500",NA,51660,"Harrisonburg city, VA","County or equivalent",2004,42251,225,297,547,250,-34,227,-261,-38
"25540",NA,NA,"Hartford-West Hartford-East Hartford, CT","Metropolitan Statistical Area",2004,1175431,1860,3690,13862,10172,-929,3027,-3956,-901
"25540",NA,9003,"Hartford County, CT","County or equivalent",2004,868418,-72,2758,10669,7911,-2150,2608,-4758,-680
"25540",NA,9007,"Middlesex County, CT","County or equivalent",2004,161299,592,420,1778,1358,278,216,62,-106
"25540",NA,9013,"Tolland County, CT","County or equivalent",2004,145714,1340,512,1415,903,943,203,740,-115
"25620",NA,NA,"Hattiesburg, MS","Metropolitan Statistical Area",2004,129768,1716,794,1938,1144,1041,141,900,-119
"25620",NA,28035,"Forrest County, MS","County or equivalent",2004,74734,494,386,1113,727,160,121,39,-52
"25620",NA,28073,"Lamar County, MS","County or equivalent",2004,42865,1256,368,671,303,946,19,927,-58
"25620",NA,28111,"Perry County, MS","County or equivalent",2004,12169,-34,40,154,114,-65,1,-66,-9
"25860",NA,NA,"Hickory-Lenoir-Morganton, NC","Metropolitan Statistical Area",2004,350779,1963,988,4291,3303,1187,775,412,-212
"25860",NA,37003,"Alexander County, NC","County or equivalent",2004,35177,603,131,435,304,508,30,478,-36
"25860",NA,37023,"Burke County, NC","County or equivalent",2004,88658,-234,123,1008,885,-287,166,-453,-70
"25860",NA,37027,"Caldwell County, NC","County or equivalent",2004,78362,-233,129,926,797,-375,79,-454,13
"25860",NA,37035,"Catawba County, NC","County or equivalent",2004,148582,1827,605,1922,1317,1341,500,841,-119
"25980",NA,NA,"Hinesville-Fort Stewart, GA","Metropolitan Statistical Area",2004,72782,1652,1068,1434,366,647,936,-289,-63
"25980",NA,13179,"Liberty County, GA","County or equivalent",2004,62047,1385,987,1281,294,450,856,-406,-52
"25980",NA,13183,"Long County, GA","County or equivalent",2004,10735,267,81,153,72,197,80,117,-11
"26100",NA,NA,"Holland-Grand Haven, MI","Metropolitan Statistical Area",2004,252229,3100,2083,3613,1530,1199,280,919,-182
"26100",NA,26139,"Ottawa County, MI","County or equivalent",2004,252229,3100,2083,3613,1530,1199,280,919,-182
"26180",NA,NA,"Honolulu, HI","Metropolitan Statistical Area",2004,893879,6303,7107,13500,6393,-40,5902,-5942,-764
"26180",NA,15003,"Honolulu County, HI","County or equivalent",2004,893879,6303,7107,13500,6393,-40,5902,-5942,-764
"26300",NA,NA,"Hot Springs, AR","Metropolitan Statistical Area",2004,91987,826,-167,1114,1281,1087,61,1026,-94
"26300",NA,5051,"Garland County, AR","County or equivalent",2004,91987,826,-167,1114,1281,1087,61,1026,-94
"26380",NA,NA,"Houma-Bayou Cane-Thibodaux, LA","Metropolitan Statistical Area",2004,197043,665,1360,2907,1547,-548,99,-647,-147
"26380",NA,22057,"Lafourche Parish, LA","County or equivalent",2004,91608,387,482,1206,724,-34,49,-83,-61
"26380",NA,22109,"Terrebonne Parish, LA","County or equivalent",2004,105435,278,878,1701,823,-514,50,-564,-86
"26420",NA,NA,"Houston-Sugar Land-Baytown, TX","Metropolitan Statistical Area",2004,5193029,107017,59109,89031,29922,37132,30705,6427,10776
"26420",NA,48015,"Austin County, TX","County or equivalent",2004,25501,482,46,330,284,463,49,414,-27
"26420",NA,48039,"Brazoria County, TX","County or equivalent",2004,267923,6774,2605,4333,1728,4453,578,3875,-284
"26420",NA,48071,"Chambers County, TX","County or equivalent",2004,27654,447,137,343,206,336,45,291,-26
"26420",NA,48157,"Fort Bend County, TX","County or equivalent",2004,437884,21477,4331,6020,1689,17250,1499,15751,-104
"26420",NA,48167,"Galveston County, TX","County or equivalent",2004,269670,4462,1703,3933,2230,2997,686,2311,-238
"26420",NA,48201,"Harris County, TX","County or equivalent",2004,3672691,55841,46661,67071,20410,-2634,26695,-29329,11814
"26420",NA,48291,"Liberty County, TX","County or equivalent",2004,74383,639,428,1118,690,261,88,173,-50
"26420",NA,48339,"Montgomery County, TX","County or equivalent",2004,358360,16386,2974,5161,2187,13657,961,12696,-245
"26420",NA,48407,"San Jacinto County, TX","County or equivalent",2004,24217,517,-6,229,235,557,21,536,-34
"26420",NA,48473,"Waller County, TX","County or equivalent",2004,34746,-8,230,493,263,-208,83,-291,-30
"26580",NA,NA,"Huntington-Ashland, WV-KY-OH","Metropolitan Statistical Area",2004,285156,-906,-65,3410,3475,-643,73,-716,-198
"26580",NA,21019,"Boyd County, KY","County or equivalent",2004,49057,-324,-9,637,646,-277,11,-288,-38
"26580",NA,21089,"Greenup County, KY","County or equivalent",2004,36926,-10,22,432,410,-7,1,-8,-25
"26580",NA,39087,"Lawrence County, OH","County or equivalent",2004,62153,-24,-6,735,741,22,11,11,-40
"26580",NA,54011,"Cabell County, WV","County or equivalent",2004,94838,-393,-63,1169,1232,-262,42,-304,-68
"26580",NA,54099,"Wayne County, WV","County or equivalent",2004,42182,-155,-9,437,446,-119,8,-127,-27
"26620",NA,NA,"Huntsville, AL","Metropolitan Statistical Area",2004,362563,4579,1460,4407,2947,3037,491,2546,82
"26620",NA,1083,"Limestone County, AL","County or equivalent",2004,68373,720,215,808,593,566,37,529,-61
"26620",NA,1089,"Madison County, AL","County or equivalent",2004,294190,3859,1245,3599,2354,2471,454,2017,143
"26820",NA,NA,"Idaho Falls, ID","Metropolitan Statistical Area",2004,109217,3001,1322,2100,778,1796,126,1670,-117
"26820",NA,16019,"Bonneville County, ID","County or equivalent",2004,88716,2506,1057,1703,646,1547,92,1455,-98
"26820",NA,16051,"Jefferson County, ID","County or equivalent",2004,20501,495,265,397,132,249,34,215,-19
"26900",NA,NA,"Indianapolis-Carmel, IN","Metropolitan Statistical Area",2004,1621479,22411,12809,25487,12678,9542,2440,7102,60
"26900",NA,18011,"Boone County, IN","County or equivalent",2004,50281,1142,258,670,412,944,17,927,-60
"26900",NA,18013,"Brown County, IN","County or equivalent",2004,15079,-56,1,142,141,-48,6,-54,-9
"26900",NA,18057,"Hamilton County, IN","County or equivalent",2004,231568,11937,2752,3733,981,8139,239,7900,1046
"26900",NA,18059,"Hancock County, IN","County or equivalent",2004,60427,1207,362,817,455,910,8,902,-65
"26900",NA,18063,"Hendricks County, IN","County or equivalent",2004,122746,4414,861,1556,695,3747,57,3690,-194
"26900",NA,18081,"Johnson County, IN","County or equivalent",2004,126360,2392,678,1730,1052,1497,78,1419,217
"26900",NA,18097,"Marion County, IN","County or equivalent",2004,865929,758,7323,14978,7655,-5797,1957,-7754,-768
"26900",NA,18109,"Morgan County, IN","County or equivalent",2004,68740,319,318,881,563,45,12,33,-44
"26900",NA,18133,"Putnam County, IN","County or equivalent",2004,36880,232,94,427,333,168,13,155,-30
"26900",NA,18145,"Shelby County, IN","County or equivalent",2004,43469,66,162,553,391,-63,53,-116,-33
"26980",NA,NA,"Iowa City, IA","Metropolitan Statistical Area",2004,140793,2325,1170,1906,736,1152,422,730,3
"26980",NA,19103,"Johnson County, IA","County or equivalent",2004,119764,2304,1089,1597,508,1196,411,785,19
"26980",NA,19183,"Washington County, IA","County or equivalent",2004,21029,21,81,309,228,-44,11,-55,-16
"27060",NA,NA,"Ithaca, NY","Metropolitan Statistical Area",2004,99870,598,398,954,556,270,559,-289,-70
"27060",NA,36109,"Tompkins County, NY","County or equivalent",2004,99870,598,398,954,556,270,559,-289,-70
"27100",NA,NA,"Jackson, MI","Metropolitan Statistical Area",2004,161790,-49,547,2154,1607,-475,83,-558,-121
"27100",NA,26075,"Jackson County, MI","County or equivalent",2004,161790,-49,547,2154,1607,-475,83,-558,-121
"27140",NA,NA,"Jackson, MS","Metropolitan Statistical Area",2004,515879,6894,3470,7890,4420,3902,275,3627,-478
"27140",NA,28029,"Copiah County, MS","County or equivalent",2004,28994,37,158,438,280,-100,15,-115,-21
"27140",NA,28049,"Hinds County, MS","County or equivalent",2004,249438,1009,1876,3930,2054,-699,112,-811,-168
"27140",NA,28089,"Madison County, MS","County or equivalent",2004,81964,2199,245,1207,962,2058,43,2015,-104
"27140",NA,28121,"Rankin County, MS","County or equivalent",2004,127970,3629,1088,1907,819,2707,86,2621,-166
"27140",NA,28127,"Simpson County, MS","County or equivalent",2004,27513,20,103,408,305,-64,19,-83,-19
"27180",NA,NA,"Jackson, TN","Metropolitan Statistical Area",2004,109915,714,546,1545,999,248,113,135,-80
"27180",NA,47023,"Chester County, TN","County or equivalent",2004,15776,244,46,182,136,215,1,214,-17
"27180",NA,47113,"Madison County, TN","County or equivalent",2004,94139,470,500,1363,863,33,112,-79,-63
"27260",NA,NA,"Jacksonville, FL","Metropolitan Statistical Area",2004,1222154,27901,6590,17397,10807,22678,2945,19733,-1367
"27260",NA,12003,"Baker County, FL","County or equivalent",2004,23822,511,151,370,219,386,8,378,-26
"27260",NA,12019,"Clay County, FL","County or equivalent",2004,162348,7094,916,2119,1203,6476,317,6159,-298
"27260",NA,12031,"Duval County, FL","County or equivalent",2004,821311,9336,5090,12642,7552,4812,2434,2378,-566
"27260",NA,12089,"Nassau County, FL","County or equivalent",2004,62897,1391,116,731,615,1355,45,1310,-80
"27260",NA,12109,"St. Johns County, FL","County or equivalent",2004,151776,9569,317,1535,1218,9649,141,9508,-397
"27340",NA,NA,"Jacksonville, NC","Metropolitan Statistical Area",2004,161244,5205,2522,3285,763,2810,2297,513,-127
"27340",NA,37133,"Onslow County, NC","County or equivalent",2004,161244,5205,2522,3285,763,2810,2297,513,-127
"27500",NA,NA,"Janesville, WI","Metropolitan Statistical Area",2004,155382,1393,706,2040,1334,802,217,585,-115
"27500",NA,55105,"Rock County, WI","County or equivalent",2004,155382,1393,706,2040,1334,802,217,585,-115
"27620",NA,NA,"Jefferson City, MO","Metropolitan Statistical Area",2004,141807,-835,639,1886,1247,-1335,123,-1458,-139
"27620",NA,29027,"Callaway County, MO","County or equivalent",2004,41578,-353,122,501,379,-433,28,-461,-42
"27620",NA,29051,"Cole County, MO","County or equivalent",2004,72128,-406,390,999,609,-722,92,-814,-74
"27620",NA,29135,"Moniteau County, MO","County or equivalent",2004,14878,-74,52,202,150,-114,3,-117,-12
"27620",NA,29151,"Osage County, MO","County or equivalent",2004,13223,-2,75,184,109,-66,0,-66,-11
"27740",NA,NA,"Johnson City, TN","Metropolitan Statistical Area",2004,187109,1041,31,2201,2170,1158,113,1045,-148
"27740",NA,47019,"Carter County, TN","County or equivalent",2004,58383,144,-42,645,687,228,17,211,-42
"27740",NA,47171,"Unicoi County, TN","County or equivalent",2004,17633,-53,-86,181,267,47,1,46,-14
"27740",NA,47179,"Washington County, TN","County or equivalent",2004,111093,950,159,1375,1216,883,95,788,-92
"27780",NA,NA,"Johnstown, PA","Metropolitan Statistical Area",2004,147728,-982,-340,1529,1869,-534,45,-579,-108
"27780",NA,42021,"Cambria County, PA","County or equivalent",2004,147728,-982,-340,1529,1869,-534,45,-579,-108
"27860",NA,NA,"Jonesboro, AR","Metropolitan Statistical Area",2004,111341,1202,436,1613,1177,865,109,756,-99
"27860",NA,5031,"Craighead County, AR","County or equivalent",2004,86274,1334,421,1263,842,994,94,900,-81
"27860",NA,5111,"Poinsett County, AR","County or equivalent",2004,25067,-132,15,350,335,-129,15,-144,-18
"27900",NA,NA,"Joplin, MO","Metropolitan Statistical Area",2004,163800,1915,783,2422,1639,1269,161,1108,-137
"27900",NA,29097,"Jasper County, MO","County or equivalent",2004,109482,1361,581,1712,1131,870,132,738,-90
"27900",NA,29145,"Newton County, MO","County or equivalent",2004,54318,554,202,710,508,399,29,370,-47
"28020",NA,NA,"Kalamazoo-Portage, MI","Metropolitan Statistical Area",2004,319959,-1042,1691,4239,2548,-2436,469,-2905,-297
"28020",NA,26077,"Kalamazoo County, MI","County or equivalent",2004,241948,-1434,1311,3212,1901,-2499,421,-2920,-246
"28020",NA,26159,"Van Buren County, MI","County or equivalent",2004,78011,392,380,1027,647,63,48,15,-51
"28100",NA,NA,"Kankakee-Bradley, IL","Metropolitan Statistical Area",2004,107399,1331,411,1522,1111,422,112,310,498
"28100",NA,17091,"Kankakee County, IL","County or equivalent",2004,107399,1331,411,1522,1111,422,112,310,498
"28140",NA,NA,"Kansas City, MO-KS","Metropolitan Statistical Area",2004,1920385,17845,13747,28978,15231,4664,3617,1047,-566
"28140",NA,20059,"Franklin County, KS","County or equivalent",2004,25962,258,122,363,241,131,16,115,5
"28140",NA,20091,"Johnson County, KS","County or equivalent",2004,496152,9992,4661,7535,2874,5773,1015,4758,-442
"28140",NA,20103,"Leavenworth County, KS","County or equivalent",2004,71401,206,376,908,532,-109,216,-325,-61
"28140",NA,20107,"Linn County, KS","County or equivalent",2004,9689,12,21,122,101,-1,0,-1,-8
"28140",NA,20121,"Miami County, KS","County or equivalent",2004,29489,555,200,453,253,384,6,378,-29
"28140",NA,20209,"Wyandotte County, KS","County or equivalent",2004,154474,-1439,1230,2751,1521,-2480,788,-3268,-189
"28140",NA,29013,"Bates County, MO","County or equivalent",2004,16955,-51,29,230,201,-67,6,-73,-13
"28140",NA,29025,"Caldwell County, MO","County or equivalent",2004,9141,58,38,122,84,26,0,26,-6
"28140",NA,29037,"Cass County, MO","County or equivalent",2004,90966,2772,486,1223,737,2411,73,2338,-125
"28140",NA,29047,"Clay County, MO","County or equivalent",2004,196995,3370,1511,2923,1412,2038,213,1825,-179
"28140",NA,29049,"Clinton County, MO","County or equivalent",2004,20529,411,22,262,240,414,2,412,-25
"28140",NA,29095,"Jackson County, MO","County or equivalent",2004,661507,351,4410,10339,5929,-4677,1146,-5823,618
"28140",NA,29107,"Lafayette County, MO","County or equivalent",2004,32789,-95,20,377,357,-93,7,-100,-22
"28140",NA,29165,"Platte County, MO","County or equivalent",2004,80707,1429,542,1055,513,962,127,835,-75
"28140",NA,29177,"Ray County, MO","County or equivalent",2004,23629,16,79,315,236,-48,2,-50,-15
"28420",NA,NA,"Kennewick-Pasco-Richland, WA","Metropolitan Statistical Area",2004,213297,4715,2218,3511,1293,2684,874,1810,-187
"28420",NA,53005,"Benton County, WA","County or equivalent",2004,154276,1763,1200,2220,1020,661,403,258,-98
"28420",NA,53021,"Franklin County, WA","County or equivalent",2004,59021,2952,1018,1291,273,2023,471,1552,-89
"28660",NA,NA,"Killeen-Temple-Fort Hood, TX","Metropolitan Statistical Area",2004,348275,1891,4324,6431,2107,-2209,3153,-5362,-224
"28660",NA,48027,"Bell County, TX","County or equivalent",2004,255455,1613,3771,5356,1585,-2101,2114,-4215,-57
"28660",NA,48099,"Coryell County, TX","County or equivalent",2004,72619,-919,520,860,340,-1323,988,-2311,-116
"28660",NA,48281,"Lampasas County, TX","County or equivalent",2004,20201,1197,33,215,182,1215,51,1164,-51
"28700",NA,NA,"Kingsport-Bristol-Bristol, TN-VA","Metropolitan Statistical Area",2004,298771,-154,-455,3200,3655,529,117,412,-228
"28700",NA,47073,"Hawkins County, TN","County or equivalent",2004,55379,379,72,660,588,351,15,336,-44
"28700",NA,47163,"Sullivan County, TN","County or equivalent",2004,151592,-785,-271,1617,1888,-406,82,-488,-108
"28700",NA,51169,"Scott County, VA","County or equivalent",2004,22750,-75,-98,214,312,38,3,35,-15
"28700",NA,51191,"Washington County, VA","County or equivalent",2004,51572,278,-77,513,590,402,12,390,-47
"28700",NA,51520,"Bristol city, VA","County or equivalent",2004,17478,49,-81,196,277,144,5,139,-14
"28740",NA,NA,"Kingston, NY","Metropolitan Statistical Area",2004,181034,752,401,1921,1520,477,178,299,-126
"28740",NA,36111,"Ulster County, NY","County or equivalent",2004,181034,752,401,1921,1520,477,178,299,-126
"28940",NA,NA,"Knoxville, TN","Metropolitan Statistical Area",2004,647872,6891,1455,7964,6509,5619,541,5078,-183
"28940",NA,47001,"Anderson County, TN","County or equivalent",2004,71319,-46,-75,829,904,76,73,3,-47
"28940",NA,47009,"Blount County, TN","County or equivalent",2004,113033,1960,126,1348,1222,1963,91,1872,-129
"28940",NA,47093,"Knox County, TN","County or equivalent",2004,402830,4259,1305,5060,3755,2903,349,2554,51
"28940",NA,47105,"Loudon County, TN","County or equivalent",2004,42115,726,23,493,470,749,27,722,-46
"28940",NA,47173,"Union County, TN","County or equivalent",2004,18575,-8,76,234,158,-72,1,-73,-12
"29020",NA,NA,"Kokomo, IN","Metropolitan Statistical Area",2004,100620,-274,277,1377,1100,-470,51,-521,-81
"29020",NA,18067,"Howard County, IN","County or equivalent",2004,84253,-250,245,1177,932,-424,49,-473,-71
"29020",NA,18159,"Tipton County, IN","County or equivalent",2004,16367,-24,32,200,168,-46,2,-48,-10
"29100",NA,NA,"La Crosse, WI-MN","Metropolitan Statistical Area",2004,128790,173,443,1512,1069,-178,62,-240,-92
"29100",NA,27055,"Houston County, MN","County or equivalent",2004,19655,-117,33,226,193,-134,2,-136,-16
"29100",NA,55063,"La Crosse County, WI","County or equivalent",2004,109135,290,410,1286,876,-44,60,-104,-76
"29140",NA,NA,"Lafayette, IN","Metropolitan Statistical Area",2004,182543,788,1173,2453,1280,-233,768,-1001,-152
"29140",NA,18007,"Benton County, IN","County or equivalent",2004,8957,-145,38,133,95,-172,2,-174,-11
"29140",NA,18015,"Carroll County, IN","County or equivalent",2004,19979,-322,70,249,179,-370,19,-389,-22
"29140",NA,18157,"Tippecanoe County, IN","County or equivalent",2004,153607,1255,1065,2071,1006,309,747,-438,-119
"29180",NA,NA,"Lafayette, LA","Metropolitan Statistical Area",2004,245381,1986,1816,3666,1850,325,207,118,-155
"29180",NA,22055,"Lafayette Parish, LA","County or equivalent",2004,195514,1694,1521,2966,1445,294,200,94,-121
"29180",NA,22099,"St. Martin Parish, LA","County or equivalent",2004,49867,292,295,700,405,31,7,24,-34
"29340",NA,NA,"Lake Charles, LA","Metropolitan Statistical Area",2004,193708,436,923,2796,1873,-352,76,-428,-135
"29340",NA,22019,"Calcasieu Parish, LA","County or equivalent",2004,184082,492,902,2697,1795,-283,69,-352,-127
"29340",NA,22023,"Cameron Parish, LA","County or equivalent",2004,9626,-56,21,99,78,-69,7,-76,-8
"29420",NA,NA,"Lake Havasu City-Kingman, AZ","Metropolitan Statistical Area",2004,178244,7273,-24,2309,2333,7648,246,7402,-351
"29420",NA,4015,"Mohave County, AZ","County or equivalent",2004,178244,7273,-24,2309,2333,7648,246,7402,-351
"29460",NA,NA,"Lakeland-Winter Haven, FL","Metropolitan Statistical Area",2004,520450,12758,1697,7192,5495,11742,999,10743,-681
"29460",NA,12105,"Polk County, FL","County or equivalent",2004,520450,12758,1697,7192,5495,11742,999,10743,-681
"29540",NA,NA,"Lancaster, PA","Metropolitan Statistical Area",2004,485401,3806,2252,6840,4588,1891,424,1467,-337
"29540",NA,42071,"Lancaster County, PA","County or equivalent",2004,485401,3806,2252,6840,4588,1891,424,1467,-337
"29620",NA,NA,"Lansing-East Lansing, MI","Metropolitan Statistical Area",2004,456627,2159,2478,5731,3253,32,1018,-986,-351
"29620",NA,26037,"Clinton County, MI","County or equivalent",2004,68346,938,379,836,457,621,15,606,-62
"29620",NA,26045,"Eaton County, MI","County or equivalent",2004,106794,283,332,1205,873,19,76,-57,-68
"29620",NA,26065,"Ingham County, MI","County or equivalent",2004,281487,938,1767,3690,1923,-608,927,-1535,-221
"29700",NA,NA,"Laredo, TX","Metropolitan Statistical Area",2004,215909,5597,5027,6033,1006,728,1339,-611,-158
"29700",NA,48479,"Webb County, TX","County or equivalent",2004,215909,5597,5027,6033,1006,728,1339,-611,-158
"29740",NA,NA,"Las Cruces, NM","Metropolitan Statistical Area",2004,185045,2781,1895,3164,1269,1013,633,380,-127
"29740",NA,35013,"Dona Ana County, NM","County or equivalent",2004,185045,2781,1895,3164,1269,1013,633,380,-127
"29820",NA,NA,"Las Vegas-Paradise, NV","Metropolitan Statistical Area",2004,1642884,72543,13400,25438,12038,61968,8120,53848,-2825
"29820",NA,32003,"Clark County, NV","County or equivalent",2004,1642884,72543,13400,25438,12038,61968,8120,53848,-2825
"29940",NA,NA,"Lawrence, KS","Metropolitan Statistical Area",2004,108509,2182,694,1231,537,708,275,433,780
"29940",NA,20045,"Douglas County, KS","County or equivalent",2004,108509,2182,694,1231,537,708,275,433,780
"30020",NA,NA,"Lawton, OK","Metropolitan Statistical Area",2004,113623,3156,959,1841,882,2319,895,1424,-122
"30020",NA,40031,"Comanche County, OK","County or equivalent",2004,113623,3156,959,1841,882,2319,895,1424,-122
"30140",NA,NA,"Lebanon, PA","Metropolitan Statistical Area",2004,123624,1187,149,1480,1331,1145,121,1024,-107
"30140",NA,42075,"Lebanon County, PA","County or equivalent",2004,123624,1187,149,1480,1331,1145,121,1024,-107
"30300",NA,NA,"Lewiston, ID-WA","Metropolitan Statistical Area",2004,58590,391,122,765,643,316,21,295,-47
"30300",NA,16069,"Nez Perce County, ID","County or equivalent",2004,37792,100,42,485,443,84,19,65,-26
"30300",NA,53003,"Asotin County, WA","County or equivalent",2004,20798,291,80,280,200,232,2,230,-21
"30340",NA,NA,"Lewiston-Auburn, ME","Metropolitan Statistical Area",2004,106362,616,258,1303,1045,436,68,368,-78
"30340",NA,23001,"Androscoggin County, ME","County or equivalent",2004,106362,616,258,1303,1045,436,68,368,-78
"30460",NA,NA,"Lexington-Fayette, KY","Metropolitan Statistical Area",2004,426496,4450,2910,6099,3189,1899,1057,842,-359
"30460",NA,21017,"Bourbon County, KY","County or equivalent",2004,19590,133,18,230,212,132,29,103,-17
"30460",NA,21049,"Clark County, KY","County or equivalent",2004,34223,414,152,450,298,293,15,278,-31
"30460",NA,21067,"Fayette County, KY","County or equivalent",2004,269058,1695,1953,3883,1930,-54,902,-956,-204
"30460",NA,21113,"Jessamine County, KY","County or equivalent",2004,42128,793,303,620,317,529,28,501,-39
"30460",NA,21209,"Scott County, KY","County or equivalent",2004,37790,1272,385,622,237,940,35,905,-53
"30460",NA,21239,"Woodford County, KY","County or equivalent",2004,23707,143,99,294,195,59,48,11,-15
"30620",NA,NA,"Lima, OH","Metropolitan Statistical Area",2004,105793,-741,438,1491,1053,-1079,28,-1107,-100
"30620",NA,39003,"Allen County, OH","County or equivalent",2004,105793,-741,438,1491,1053,-1079,28,-1107,-100
"30700",NA,NA,"Lincoln, NE","Metropolitan Statistical Area",2004,281047,2476,2393,4278,1885,288,801,-513,-205
"30700",NA,31109,"Lancaster County, NE","County or equivalent",2004,264351,2319,2353,4068,1715,157,791,-634,-191
"30700",NA,31159,"Seward County, NE","County or equivalent",2004,16696,157,40,210,170,131,10,121,-14
"30780",NA,NA,"Little Rock-North Little Rock-Conway, AR","Metropolitan Statistical Area",2004,636911,7559,3505,9249,5744,4198,800,3398,-144
"30780",NA,5045,"Faulkner County, AR","County or equivalent",2004,95631,2390,607,1312,705,1825,72,1753,-42
"30780",NA,5053,"Grant County, AR","County or equivalent",2004,17046,299,-7,163,170,327,1,326,-21
"30780",NA,5085,"Lonoke County, AR","County or equivalent",2004,58047,1849,364,858,494,1586,55,1531,-101
"30780",NA,5105,"Perry County, AR","County or equivalent",2004,10284,-13,0,111,111,-7,0,-7,-6
"30780",NA,5119,"Pulaski County, AR","County or equivalent",2004,367477,1324,2303,5805,3502,-1114,641,-1755,135
"30780",NA,5125,"Saline County, AR","County or equivalent",2004,88426,1710,238,1000,762,1581,31,1550,-109
"30860",NA,NA,"Logan, UT-ID","Metropolitan Statistical Area",2004,114161,2314,2166,2708,542,-137,327,-464,285
"30860",NA,16041,"Franklin County, ID","County or equivalent",2004,11906,229,127,229,102,112,22,90,-10
"30860",NA,49005,"Cache County, UT","County or equivalent",2004,102255,2085,2039,2479,440,-249,305,-554,295
"30980",NA,NA,"Longview, TX","Metropolitan Statistical Area",2004,198316,1004,834,2966,2132,318,312,6,-148
"30980",NA,48183,"Gregg County, TX","County or equivalent",2004,113740,590,713,1906,1193,-40,214,-254,-83
"30980",NA,48401,"Rusk County, TX","County or equivalent",2004,47485,226,53,587,534,209,82,127,-36
"30980",NA,48459,"Upshur County, TX","County or equivalent",2004,37091,188,68,473,405,149,16,133,-29
"31020",NA,NA,"Longview, WA","Metropolitan Statistical Area",2004,95328,973,230,1199,969,820,120,700,-77
"31020",NA,53015,"Cowlitz County, WA","County or equivalent",2004,95328,973,230,1199,969,820,120,700,-77
"31100",NA,NA,"Los Angeles-Long Beach-Santa Ana, CA","Metropolitan Statistical Area",2004,12806778,58245,117618,196470,78852,-47122,93827,-140949,-12251
"31100",31084,NA,"Los Angeles-Long Beach-Glendale, CA","Metropolitan Division",2004,9841217,39839,90161,151461,61300,-40789,73352,-114141,-9533
"31100",31084,6037,"Los Angeles County, CA","County or equivalent",2004,9841217,39839,90161,151461,61300,-40789,73352,-114141,-9533
"31100",42044,NA,"Santa Ana-Anaheim-Irvine, CA","Metropolitan Division",2004,2965561,18406,27457,45009,17552,-6333,20475,-26808,-2718
"31100",42044,6059,"Orange County, CA","County or equivalent",2004,2965561,18406,27457,45009,17552,-6333,20475,-26808,-2718
"31140",NA,NA,"Louisville/Jefferson County, KY-IN","Metropolitan Statistical Area",2004,1198135,9664,5102,16138,11036,4882,1483,3399,-320
"31140",NA,18019,"Clark County, IN","County or equivalent",2004,100163,1049,343,1320,977,789,82,707,-83
"31140",NA,18043,"Floyd County, IN","County or equivalent",2004,71381,224,175,845,670,93,13,80,-44
"31140",NA,18061,"Harrison County, IN","County or equivalent",2004,36011,627,181,475,294,483,13,470,-37
"31140",NA,18175,"Washington County, IN","County or equivalent",2004,27632,57,67,343,276,8,5,3,-18
"31140",NA,21029,"Bullitt County, KY","County or equivalent",2004,68914,2361,404,767,363,1366,20,1346,591
"31140",NA,21103,"Henry County, KY","County or equivalent",2004,15517,97,57,192,135,52,11,41,-12
"31140",NA,21111,"Jefferson County, KY","County or equivalent",2004,698822,1039,2884,9991,7107,-1340,1111,-2451,-505
"31140",NA,21163,"Meade County, KY","County or equivalent",2004,27796,489,116,287,171,401,75,326,-28
"31140",NA,21179,"Nelson County, KY","County or equivalent",2004,40145,690,244,564,320,487,28,459,-41
"31140",NA,21185,"Oldham County, KY","County or equivalent",2004,51511,1284,304,553,249,1043,26,1017,-63
"31140",NA,21211,"Shelby County, KY","County or equivalent",2004,36762,1019,197,492,295,869,95,774,-47
"31140",NA,21215,"Spencer County, KY","County or equivalent",2004,14635,520,87,186,99,454,4,450,-21
"31140",NA,21223,"Trimble County, KY","County or equivalent",2004,8846,208,43,123,80,177,0,177,-12
"31180",NA,NA,"Lubbock, TX","Metropolitan Statistical Area",2004,260963,1908,2114,4174,2060,-271,234,-505,65
"31180",NA,48107,"Crosby County, TX","County or equivalent",2004,6634,-92,55,125,70,-140,2,-142,-7
"31180",NA,48303,"Lubbock County, TX","County or equivalent",2004,254329,2000,2059,4049,1990,-131,232,-363,72
"31340",NA,NA,"Lynchburg, VA","Metropolitan Statistical Area",2004,232663,1532,250,2610,2360,1468,171,1297,-186
"31340",NA,51009,"Amherst County, VA","County or equivalent",2004,31732,-30,7,307,300,-16,17,-33,-21
"31340",NA,51011,"Appomattox County, VA","County or equivalent",2004,13782,123,21,152,131,114,7,107,-12
"31340",NA,51019,"Bedford County, VA","County or equivalent",2004,63025,985,97,630,533,961,23,938,-73
"31340",NA,51031,"Campbell County, VA","County or equivalent",2004,51432,32,72,576,504,-8,19,-27,-32
"31340",NA,51515,"Bedford city, VA","County or equivalent",2004,6233,-8,-50,52,102,46,2,44,-4
"31340",NA,51680,"Lynchburg city, VA","County or equivalent",2004,66459,430,103,893,790,371,103,268,-44
"31420",NA,NA,"Macon, GA","Metropolitan Statistical Area",2004,226986,1304,1055,3294,2239,432,158,274,-183
"31420",NA,13021,"Bibb County, GA","County or equivalent",2004,154386,518,833,2442,1609,-206,131,-337,-109
"31420",NA,13079,"Crawford County, GA","County or equivalent",2004,12576,136,15,142,127,134,0,134,-13
"31420",NA,13169,"Jones County, GA","County or equivalent",2004,26105,706,131,321,190,610,11,599,-35
"31420",NA,13207,"Monroe County, GA","County or equivalent",2004,23244,48,50,252,202,13,14,-1,-15
"31420",NA,13289,"Twiggs County, GA","County or equivalent",2004,10675,-104,26,137,111,-119,2,-121,-11
"31460",NA,NA,"Madera, CA","Metropolitan Statistical Area",2004,136783,4583,1387,2318,931,3371,671,2700,-175
"31460",NA,6039,"Madera County, CA","County or equivalent",2004,136783,4583,1387,2318,931,3371,671,2700,-175
"31540",NA,NA,"Madison, WI","Metropolitan Statistical Area",2004,533347,7101,3495,6876,3381,4021,1445,2576,-415
"31540",NA,55021,"Columbia County, WI","County or equivalent",2004,54363,714,170,674,504,596,22,574,-52
"31540",NA,55025,"Dane County, WI","County or equivalent",2004,455821,6362,3213,5892,2679,3496,1423,2073,-347
"31540",NA,55049,"Iowa County, WI","County or equivalent",2004,23163,25,112,310,198,-71,0,-71,-16
"31700",NA,NA,"Manchester-Nashua, NH","Metropolitan Statistical Area",2004,396020,3379,2233,5008,2775,1397,982,415,-251
"31700",NA,33011,"Hillsborough County, NH","County or equivalent",2004,396020,3379,2233,5008,2775,1397,982,415,-251
"31900",NA,NA,"Mansfield, OH","Metropolitan Statistical Area",2004,127451,-366,337,1594,1257,-604,53,-657,-99
"31900",NA,39139,"Richland County, OH","County or equivalent",2004,127451,-366,337,1594,1257,-604,53,-657,-99
"32580",NA,NA,"McAllen-Edinburg-Mission, TX","Metropolitan Statistical Area",2004,647771,19728,13281,16425,3144,6981,3836,3145,-534
"32580",NA,48215,"Hidalgo County, TX","County or equivalent",2004,647771,19728,13281,16425,3144,6981,3836,3145,-534
"32780",NA,NA,"Medford, OR","Metropolitan Statistical Area",2004,191816,2283,199,2140,1941,2260,218,2042,-176
"32780",NA,41029,"Jackson County, OR","County or equivalent",2004,191816,2283,199,2140,1941,2260,218,2042,-176
"32820",NA,NA,"Memphis, TN-MS-AR","Metropolitan Statistical Area",2004,1242362,9102,8753,19361,10608,1444,1646,-202,-1095
"32820",NA,5035,"Crittenden County, AR","County or equivalent",2004,51239,264,403,891,488,-187,25,-212,48
"32820",NA,28033,"DeSoto County, MS","County or equivalent",2004,130048,6245,1039,1917,878,5457,97,5360,-251
"32820",NA,28093,"Marshall County, MS","County or equivalent",2004,35530,-79,114,486,372,-164,6,-170,-29
"32820",NA,28137,"Tate County, MS","County or equivalent",2004,26075,349,140,413,273,233,5,228,-24
"32820",NA,28143,"Tunica County, MS","County or equivalent",2004,10019,32,98,194,96,-58,6,-64,-8
"32820",NA,47047,"Fayette County, TN","County or equivalent",2004,33140,1114,53,384,331,1120,6,1114,-59
"32820",NA,47157,"Shelby County, TN","County or equivalent",2004,902404,819,6640,14328,7688,-5085,1468,-6553,-736
"32820",NA,47167,"Tipton County, TN","County or equivalent",2004,53907,358,266,748,482,128,33,95,-36
"32900",NA,NA,"Merced, CA","Metropolitan Statistical Area",2004,233471,4708,2777,4224,1447,2121,1035,1086,-190
"32900",NA,6047,"Merced County, CA","County or equivalent",2004,233471,4708,2777,4224,1447,2121,1035,1086,-190
"33100",NA,NA,"Miami-Fort Lauderdale-Pompano Beach, FL","Metropolitan Statistical Area",2004,5311255,67508,21903,69694,47791,45158,48357,-3199,447
"33100",22744,NA,"Fort Lauderdale-Pompano Beach-Deerfield Beach, FL","Metropolitan Division",2004,1739670,21399,6958,22633,15675,13848,12040,1808,593
"33100",22744,12011,"Broward County, FL","County or equivalent",2004,1739670,21399,6958,22633,15675,13848,12040,1808,593
"33100",33124,NA,"Miami-Miami Beach-Kendall, FL","Metropolitan Division",2004,2337381,16732,13622,32240,18618,1673,30341,-28668,1437
"33100",33124,12086,"Miami-Dade County, FL","County or equivalent",2004,2337381,16732,13622,32240,18618,1673,30341,-28668,1437
"33100",48424,NA,"West Palm Beach-Boca Raton-Boynton Beach, FL","Metropolitan Division",2004,1234204,29377,1323,14821,13498,29637,5976,23661,-1583
"33100",48424,12099,"Palm Beach County, FL","County or equivalent",2004,1234204,29377,1323,14821,13498,29637,5976,23661,-1583
"33140",NA,NA,"Michigan City-La Porte, IN","Metropolitan Statistical Area",2004,108581,-162,284,1351,1067,-363,77,-440,-83
"33140",NA,18091,"LaPorte County, IN","County or equivalent",2004,108581,-162,284,1351,1067,-363,77,-440,-83
"33260",NA,NA,"Midland, TX","Metropolitan Statistical Area",2004,119145,1204,892,1892,1000,398,157,241,-86
"33260",NA,48329,"Midland County, TX","County or equivalent",2004,119145,1204,892,1892,1000,398,157,241,-86
"33340",NA,NA,"Milwaukee-Waukesha-West Allis, WI","Metropolitan Statistical Area",2004,1531756,5345,8467,21649,13182,-7361,2679,-10040,4239
"33340",NA,55079,"Milwaukee County, WI","County or equivalent",2004,950238,1029,6119,14917,8798,-9742,2303,-12045,4652
"33340",NA,55089,"Ozaukee County, WI","County or equivalent",2004,84905,741,261,896,635,548,64,484,-68
"33340",NA,55131,"Washington County, WI","County or equivalent",2004,123476,1782,582,1488,906,1311,60,1251,-111
"33340",NA,55133,"Waukesha County, WI","County or equivalent",2004,373137,1793,1505,4348,2843,522,252,270,-234
"33460",NA,NA,"Minneapolis-St. Paul-Bloomington, MN-WI","Metropolitan Statistical Area",2004,3105621,28207,27147,46167,19020,4189,8373,-4184,-3129
"33460",NA,27003,"Anoka County, MN","County or equivalent",2004,316941,4971,3051,4461,1410,2175,341,1834,-255
"33460",NA,27019,"Carver County, MN","County or equivalent",2004,80963,2620,899,1224,325,1826,112,1714,-105
"33460",NA,27025,"Chisago County, MN","County or equivalent",2004,47734,1394,365,704,339,1092,4,1088,-63
"33460",NA,27037,"Dakota County, MN","County or equivalent",2004,376537,4778,3719,5498,1779,1308,579,729,-249
"33460",NA,27053,"Hennepin County, MN","County or equivalent",2004,1122435,378,9059,16713,7654,-7590,5149,-12739,-1091
"33460",NA,27059,"Isanti County, MN","County or equivalent",2004,36237,1005,188,461,273,865,10,855,-48
"33460",NA,27123,"Ramsey County, MN","County or equivalent",2004,500750,-4831,3490,7402,3912,-7697,1811,-9508,-624
"33460",NA,27139,"Scott County, MN","County or equivalent",2004,113645,5706,1670,2141,471,4238,111,4127,-202
"33460",NA,27141,"Sherburne County, MN","County or equivalent",2004,78158,3243,775,1230,455,2512,18,2494,-44
"33460",NA,27163,"Washington County, MN","County or equivalent",2004,213838,1553,1763,2868,1105,-72,180,-252,-138
"33460",NA,27171,"Wright County, MN","County or equivalent",2004,106186,3948,1307,1918,611,2796,30,2766,-155
"33460",NA,55093,"Pierce County, WI","County or equivalent",2004,38552,620,262,501,239,394,9,385,-36
"33460",NA,55109,"St. Croix County, WI","County or equivalent",2004,73645,2822,599,1046,447,2342,19,2323,-119
"33540",NA,NA,"Missoula, MT","Metropolitan Statistical Area",2004,100810,956,485,1196,711,544,65,479,-73
"33540",NA,30063,"Missoula County, MT","County or equivalent",2004,100810,956,485,1196,711,544,65,479,-73
"33660",NA,NA,"Mobile, AL","Metropolitan Statistical Area",2004,397174,-268,1742,5780,4038,-1699,435,-2134,-311
"33660",NA,1097,"Mobile County, AL","County or equivalent",2004,397174,-268,1742,5780,4038,-1699,435,-2134,-311
"33700",NA,NA,"Modesto, CA","Metropolitan Statistical Area",2004,492442,5338,4258,7880,3622,1402,1718,-316,-322
"33700",NA,6099,"Stanislaus County, CA","County or equivalent",2004,492442,5338,4258,7880,3622,1402,1718,-316,-322
"33740",NA,NA,"Monroe, LA","Metropolitan Statistical Area",2004,171119,477,1091,2662,1571,-492,57,-549,-122
"33740",NA,22073,"Ouachita Parish, LA","County or equivalent",2004,148461,574,1012,2346,1334,-335,44,-379,-103
"33740",NA,22111,"Union Parish, LA","County or equivalent",2004,22658,-97,79,316,237,-157,13,-170,-19
"33780",NA,NA,"Monroe, MI","Metropolitan Statistical Area",2004,151041,1392,601,1773,1172,913,91,822,-122
"33780",NA,26115,"Monroe County, MI","County or equivalent",2004,151041,1392,601,1773,1172,913,91,822,-122
"33860",NA,NA,"Montgomery, AL","Metropolitan Statistical Area",2004,353250,1593,1742,4961,3219,179,374,-195,-328
"33860",NA,1001,"Autauga County, AL","County or equivalent",2004,46941,1175,239,635,396,995,39,956,-59
"33860",NA,1051,"Elmore County, AL","County or equivalent",2004,71286,1129,322,948,626,877,46,831,-70
"33860",NA,1085,"Lowndes County, AL","County or equivalent",2004,13038,-281,48,182,134,-313,1,-314,-16
"33860",NA,1101,"Montgomery County, AL","County or equivalent",2004,221985,-430,1133,3196,2063,-1380,288,-1668,-183
"34060",NA,NA,"Morgantown, WV","Metropolitan Statistical Area",2004,114864,795,382,1305,923,495,189,306,-82
"34060",NA,54061,"Monongalia County, WV","County or equivalent",2004,85278,657,354,954,600,360,187,173,-57
"34060",NA,54077,"Preston County, WV","County or equivalent",2004,29586,138,28,351,323,135,2,133,-25
"34100",NA,NA,"Morristown, TN","Metropolitan Statistical Area",2004,128044,1324,246,1584,1338,1188,306,882,-110
"34100",NA,47057,"Grainger County, TN","County or equivalent",2004,21699,287,32,251,219,277,14,263,-22
"34100",NA,47063,"Hamblen County, TN","County or equivalent",2004,59091,469,139,807,668,375,245,130,-45
"34100",NA,47089,"Jefferson County, TN","County or equivalent",2004,47254,568,75,526,451,536,47,489,-43
"34580",NA,NA,"Mount Vernon-Anacortes, WA","Metropolitan Statistical Area",2004,110076,1871,361,1395,1034,1613,337,1276,-103
"34580",NA,53057,"Skagit County, WA","County or equivalent",2004,110076,1871,361,1395,1034,1613,337,1276,-103
"34620",NA,NA,"Muncie, IN","Metropolitan Statistical Area",2004,117698,-1254,178,1345,1167,-1314,104,-1418,-118
"34620",NA,18035,"Delaware County, IN","County or equivalent",2004,117698,-1254,178,1345,1167,-1314,104,-1418,-118
"34740",NA,NA,"Muskegon-Norton Shores, MI","Metropolitan Statistical Area",2004,173060,581,807,2426,1619,-110,89,-199,-116
"34740",NA,26121,"Muskegon County, MI","County or equivalent",2004,173060,581,807,2426,1619,-110,89,-199,-116
"34820",NA,NA,"Myrtle Beach-North Myrtle Beach-Conway, SC","Metropolitan Statistical Area",2004,217890,7050,779,2753,1974,6615,339,6276,-344
"34820",NA,45051,"Horry County, SC","County or equivalent",2004,217890,7050,779,2753,1974,6615,339,6276,-344
"34900",NA,NA,"Napa, CA","Metropolitan Statistical Area",2004,130149,245,366,1642,1276,-11,643,-654,-110
"34900",NA,6055,"Napa County, CA","County or equivalent",2004,130149,245,366,1642,1276,-11,643,-654,-110
"34940",NA,NA,"Naples-Marco Island, FL","Metropolitan Statistical Area",2004,294632,10278,1329,3795,2466,9398,1861,7537,-449
"34940",NA,12021,"Collier County, FL","County or equivalent",2004,294632,10278,1329,3795,2466,9398,1861,7537,-449
"34980",NA,NA,"Nashville-Davidson--Murfreesboro--Franklin, TN","Metropolitan Statistical Area",2004,1415924,29380,9225,20423,11198,16434,2976,13458,3721
"34980",NA,47015,"Cannon County, TN","County or equivalent",2004,13111,95,-6,138,144,113,5,108,-12
"34980",NA,47021,"Cheatham County, TN","County or equivalent",2004,37573,413,189,487,298,253,11,242,-29
"34980",NA,47037,"Davidson County, TN","County or equivalent",2004,597263,8751,3975,9032,5057,64,2141,-2077,4712
"34980",NA,47043,"Dickson County, TN","County or equivalent",2004,45187,359,164,611,447,230,7,223,-35
"34980",NA,47081,"Hickman County, TN","County or equivalent",2004,23385,314,48,274,226,289,2,287,-23
"34980",NA,47111,"Macon County, TN","County or equivalent",2004,21110,228,32,257,225,216,27,189,-20
"34980",NA,47147,"Robertson County, TN","County or equivalent",2004,58749,958,391,941,550,620,111,509,-53
"34980",NA,47149,"Rutherford County, TN","County or equivalent",2004,210468,8010,1941,3222,1281,6392,282,6110,-323
"34980",NA,47159,"Smith County, TN","County or equivalent",2004,18259,55,21,218,197,47,9,38,-13
"34980",NA,47165,"Sumner County, TN","County or equivalent",2004,140802,2892,739,1912,1173,2307,141,2166,-154
"34980",NA,47169,"Trousdale County, TN","County or equivalent",2004,7288,31,2,94,92,34,6,28,-5
"34980",NA,47187,"Williamson County, TN","County or equivalent",2004,145775,5114,1216,1944,728,4109,191,3918,-211
"34980",NA,47189,"Wilson County, TN","County or equivalent",2004,96954,2160,513,1293,780,1760,43,1717,-113
"35300",NA,NA,"New Haven-Milford, CT","Metropolitan Statistical Area",2004,838814,1362,2308,10185,7877,-342,2347,-2689,-604
"35300",NA,9009,"New Haven County, CT","County or equivalent",2004,838814,1362,2308,10185,7877,-342,2347,-2689,-604
"35380",NA,NA,"New Orleans-Metairie-Kenner, LA","Metropolitan Statistical Area",2004,1313742,2442,6525,18994,12469,-3686,1537,-5223,-397
"35380",NA,22051,"Jefferson Parish, LA","County or equivalent",2004,452116,972,2118,6308,4190,-1227,734,-1961,81
"35380",NA,22071,"Orleans Parish, LA","County or equivalent",2004,461600,-5915,2014,6961,4947,-7828,537,-8365,-101
"35380",NA,22075,"Plaquemines Parish, LA","County or equivalent",2004,28615,963,238,464,226,769,21,748,-44
"35380",NA,22087,"St. Bernard Parish, LA","County or equivalent",2004,65376,-308,113,926,813,-427,30,-457,6
"35380",NA,22089,"St. Charles Parish, LA","County or equivalent",2004,49522,485,333,679,346,187,38,149,-35
"35380",NA,22095,"St. John the Baptist Parish, LA","County or equivalent",2004,45025,590,392,713,321,231,24,207,-33
"35380",NA,22103,"St. Tammany Parish, LA","County or equivalent",2004,211488,5655,1317,2943,1626,4609,153,4456,-271
"35620",NA,NA,"New York-Northern New Jersey-Long Island, NY-NJ-PA","Metropolitan Statistical Area",2004,18757341,81078,119098,261953,142855,-122218,125810,-248028,84198
"35620",20764,NA,"Edison-New Brunswick, NJ","Metropolitan Division",2004,2280766,17856,10503,30821,20318,5935,10288,-4353,1418
"35620",20764,34023,"Middlesex County, NJ","County or equivalent",2004,776135,4391,5092,10799,5707,-30,6311,-6341,-671
"35620",20764,34025,"Monmouth County, NJ","County or equivalent",2004,639930,3880,2731,8026,5295,-1150,1715,-2865,2299
"35620",20764,34029,"Ocean County, NJ","County or equivalent",2004,551904,6378,448,7638,7190,5911,552,5359,19
"35620",20764,34035,"Somerset County, NJ","County or equivalent",2004,312797,3207,2232,4358,2126,1204,1710,-506,-229
"35620",35004,NA,"Nassau-Suffolk, NY","Metropolitan Division",2004,2856273,16431,13343,35906,22563,-11177,7218,-18395,14265
"35620",35004,36059,"Nassau County, NY","County or equivalent",2004,1356867,3281,5029,16044,11015,-7966,3778,-11744,6218
"35620",35004,36103,"Suffolk County, NY","County or equivalent",2004,1499406,13150,8314,19862,11548,-3211,3440,-6651,8047
"35620",35084,NA,"Newark-Union, NJ-PA","Metropolitan Division",2004,2125510,181,12707,29443,16736,-10477,10848,-21325,-2049
"35620",35084,34013,"Essex County, NJ","County or equivalent",2004,786346,-4857,5351,12114,6763,-9327,4879,-14206,-881
"35620",35084,34019,"Hunterdon County, NJ","County or equivalent",2004,128061,813,554,1364,810,348,176,172,-89
"35620",35084,34027,"Morris County, NJ","County or equivalent",2004,482762,2818,2861,6292,3431,322,2135,-1813,-365
"35620",35084,34037,"Sussex County, NJ","County or equivalent",2004,150318,812,643,1663,1020,261,132,129,-92
"35620",35084,34039,"Union County, NJ","County or equivalent",2004,524617,-1109,3236,7596,4360,-3817,3515,-7332,-528
"35620",35084,42103,"Pike County, PA","County or equivalent",2004,53406,1704,62,414,352,1736,11,1725,-94
"35620",35644,NA,"New York-White Plains-Wayne, NY-NJ","Metropolitan Division",2004,11494792,46610,82545,165783,83238,-106499,97456,-203955,70564
"35620",35644,34003,"Bergen County, NJ","County or equivalent",2004,892429,1112,3333,10792,7459,-1484,5635,-7119,-737
"35620",35644,34017,"Hudson County, NJ","County or equivalent",2004,601430,-3096,4548,8932,4384,-6870,7176,-14046,-774
"35620",35644,34031,"Passaic County, NJ","County or equivalent",2004,491696,-1370,3639,7712,4073,-4467,3480,-7947,-542
"35620",35644,36005,"Bronx County, NY","County or equivalent",2004,1359751,4816,12671,22599,9928,-18690,10194,-28884,10835
"35620",35644,36047,"Kings County, NY","County or equivalent",2004,2497859,14695,22027,39779,17752,-37161,23300,-60461,29829
"35620",35644,36061,"New York County, NY","County or equivalent",2004,1590911,14290,9962,20717,10755,1124,12956,-11832,3204
"35620",35644,36079,"Putnam County, NY","County or equivalent",2004,99223,483,554,1189,635,-9,179,-188,-62
"35620",35644,36081,"Queens County, NY","County or equivalent",2004,2250718,6480,15516,30786,15270,-30623,26351,-56974,21587
"35620",35644,36085,"Richmond County, NY","County or equivalent",2004,471112,4573,2408,5969,3561,-605,1568,-2173,2770
"35620",35644,36087,"Rockland County, NY","County or equivalent",2004,292793,1845,2473,4554,2081,-2506,1182,-3688,1878
"35620",35644,36119,"Westchester County, NY","County or equivalent",2004,946870,2782,5414,12754,7340,-5208,5435,-10643,2576
"35660",NA,NA,"Niles-Benton Harbor, MI","Metropolitan Statistical Area",2004,161066,-286,415,2086,1671,-571,275,-846,-130
"35660",NA,26021,"Berrien County, MI","County or equivalent",2004,161066,-286,415,2086,1671,-571,275,-846,-130
"35980",NA,NA,"Norwich-New London, CT","Metropolitan Statistical Area",2004,266672,1523,982,3241,2259,712,763,-51,-171
"35980",NA,9011,"New London County, CT","County or equivalent",2004,266672,1523,982,3241,2259,712,763,-51,-171
"36100",NA,NA,"Ocala, FL","Metropolitan Statistical Area",2004,289612,10589,-737,3066,3803,11870,287,11583,-544
"36100",NA,12083,"Marion County, FL","County or equivalent",2004,289612,10589,-737,3066,3803,11870,287,11583,-544
"36140",NA,NA,"Ocean City, NJ","Metropolitan Statistical Area",2004,99915,-1414,-392,963,1355,-932,97,-1029,-90
"36140",NA,34009,"Cape May County, NJ","County or equivalent",2004,99915,-1414,-392,963,1355,-932,97,-1029,-90
"36220",NA,NA,"Odessa, TX","Metropolitan Statistical Area",2004,123360,1264,1245,2331,1086,98,172,-74,-79
"36220",NA,48135,"Ector County, TX","County or equivalent",2004,123360,1264,1245,2331,1086,98,172,-74,-79
"36260",NA,NA,"Ogden-Clearfield, UT","Metropolitan Statistical Area",2004,481056,9889,7092,9756,2664,1655,1041,614,1142
"36260",NA,49011,"Davis County, UT","County or equivalent",2004,262682,6562,4431,5626,1195,1679,471,1208,452
"36260",NA,49029,"Morgan County, UT","County or equivalent",2004,7557,108,72,111,39,42,5,37,-6
"36260",NA,49057,"Weber County, UT","County or equivalent",2004,210817,3219,2589,4019,1430,-66,565,-631,696
"36420",NA,NA,"Oklahoma City, OK","Metropolitan Statistical Area",2004,1140289,9245,7420,17402,9982,2825,2848,-23,-1000
"36420",NA,40017,"Canadian County, OK","County or equivalent",2004,94433,2260,517,1222,705,1857,79,1778,-114
"36420",NA,40027,"Cleveland County, OK","County or equivalent",2004,222144,2838,1240,2680,1440,1780,463,1317,-182
"36420",NA,40051,"Grady County, OK","County or equivalent",2004,47950,857,141,658,517,770,9,761,-54
"36420",NA,40081,"Lincoln County, OK","County or equivalent",2004,32076,3,20,401,381,5,11,-6,-22
"36420",NA,40083,"Logan County, OK","County or equivalent",2004,34972,-423,141,445,304,-526,12,-538,-38
"36420",NA,40087,"McClain County, OK","County or equivalent",2004,29014,458,115,396,281,371,27,344,-28
"36420",NA,40109,"Oklahoma County, OK","County or equivalent",2004,679700,3252,5246,11600,6354,-1432,2247,-3679,-562
"36500",NA,NA,"Olympia, WA","Metropolitan Statistical Area",2004,223417,3424,950,2645,1695,2674,389,2285,-200
"36500",NA,53067,"Thurston County, WA","County or equivalent",2004,223417,3424,950,2645,1695,2674,389,2285,-200
"36540",NA,NA,"Omaha-Council Bluffs, NE-IA","Metropolitan Statistical Area",2004,800155,9903,6896,12890,5994,3605,1838,1767,-598
"36540",NA,19085,"Harrison County, IA","County or equivalent",2004,15549,0,-23,145,168,35,4,31,-12
"36540",NA,19129,"Mills County, IA","County or equivalent",2004,14701,101,22,163,141,92,4,88,-13
"36540",NA,19155,"Pottawattamie County, IA","County or equivalent",2004,88784,740,373,1237,864,440,48,392,-73
"36540",NA,31025,"Cass County, NE","County or equivalent",2004,25248,232,74,304,230,180,17,163,-22
"36540",NA,31055,"Douglas County, NE","County or equivalent",2004,480904,5105,4584,8209,3625,836,1266,-430,-315
"36540",NA,31153,"Sarpy County, NE","County or equivalent",2004,135522,3589,1762,2372,610,1961,475,1486,-134
"36540",NA,31155,"Saunders County, NE","County or equivalent",2004,20045,93,45,238,193,63,11,52,-15
"36540",NA,31177,"Washington County, NE","County or equivalent",2004,19402,43,59,222,163,-2,13,-15,-14
"36740",NA,NA,"Orlando-Kissimmee, FL","Metropolitan Statistical Area",2004,1863559,62198,12315,25990,13675,52163,7798,44365,-2280
"36740",NA,12069,"Lake County, FL","County or equivalent",2004,260446,14761,-77,2964,3041,15420,294,15126,-582
"36740",NA,12095,"Orange County, FL","County or equivalent",2004,992012,27223,8672,15143,6471,19648,5129,14519,-1097
"36740",NA,12097,"Osceola County, FL","County or equivalent",2004,219345,13911,1794,3287,1493,12360,1322,11038,-243
"36740",NA,12117,"Seminole County, FL","County or equivalent",2004,391756,6303,1926,4596,2670,4735,1053,3682,-358
"36780",NA,NA,"Oshkosh-Neenah, WI","Metropolitan Statistical Area",2004,158535,313,460,1762,1302,-44,151,-195,-103
"36780",NA,55139,"Winnebago County, WI","County or equivalent",2004,158535,313,460,1762,1302,-44,151,-195,-103
"36980",NA,NA,"Owensboro, KY","Metropolitan Statistical Area",2004,110429,150,499,1592,1093,-268,42,-310,-81
"36980",NA,21059,"Daviess County, KY","County or equivalent",2004,92192,187,444,1349,905,-189,33,-222,-68
"36980",NA,21091,"Hancock County, KY","County or equivalent",2004,8413,-25,46,115,69,-64,1,-65,-7
"36980",NA,21149,"McLean County, KY","County or equivalent",2004,9824,-12,9,128,119,-15,8,-23,-6
"37100",NA,NA,"Oxnard-Thousand Oaks-Ventura, CA","Metropolitan Statistical Area",2004,789670,4450,6750,11929,5179,-1642,3484,-5126,-658
"37100",NA,6111,"Ventura County, CA","County or equivalent",2004,789670,4450,6750,11929,5179,-1642,3484,-5126,-658
"37340",NA,NA,"Palm Bay-Melbourne-Titusville, FL","Metropolitan Statistical Area",2004,515904,12909,-504,5093,5597,14177,675,13502,-764
"37340",NA,12009,"Brevard County, FL","County or equivalent",2004,515904,12909,-504,5093,5597,14177,675,13502,-764
"37380",NA,NA,"Palm Coast, FL","Metropolitan Statistical Area",2004,68172,6069,-210,541,751,6526,58,6468,-247
"37380",NA,12035,"Flagler County, FL","County or equivalent",2004,68172,6069,-210,541,751,6526,58,6468,-247
"37460",NA,NA,"Panama City-Lynn Haven, FL","Metropolitan Statistical Area",2004,157738,3096,651,2126,1475,2619,376,2243,-174
"37460",NA,12005,"Bay County, FL","County or equivalent",2004,157738,3096,651,2126,1475,2619,376,2243,-174
"37620",NA,NA,"Parkersburg-Marietta-Vienna, WV-OH","Metropolitan Statistical Area",2004,162344,-280,21,1848,1827,-184,24,-208,-117
"37620",NA,39167,"Washington County, OH","County or equivalent",2004,62467,56,24,716,692,73,3,70,-41
"37620",NA,54073,"Pleasants County, WV","County or equivalent",2004,7359,-29,-23,69,92,0,1,-1,-6
"37620",NA,54105,"Wirt County, WV","County or equivalent",2004,5768,27,0,54,54,32,0,32,-5
"37620",NA,54107,"Wood County, WV","County or equivalent",2004,86750,-334,20,1009,989,-289,20,-309,-65
"37700",NA,NA,"Pascagoula, MS","Metropolitan Statistical Area",2004,154429,1486,780,2167,1387,817,305,512,-111
"37700",NA,28039,"George County, MS","County or equivalent",2004,20435,191,81,319,238,126,15,111,-16
"37700",NA,28059,"Jackson County, MS","County or equivalent",2004,133994,1295,699,1848,1149,691,290,401,-95
"37860",NA,NA,"Pensacola-Ferry Pass-Brent, FL","Metropolitan Statistical Area",2004,439832,6419,1821,5721,3900,5095,1288,3807,-497
"37860",NA,12033,"Escambia County, FL","County or equivalent",2004,301610,690,1234,4079,2845,-295,1007,-1302,-249
"37860",NA,12113,"Santa Rosa County, FL","County or equivalent",2004,138222,5729,587,1642,1055,5390,281,5109,-248
"37900",NA,NA,"Peoria, IL","Metropolitan Statistical Area",2004,366030,1287,1151,4859,3708,379,284,95,-243
"37900",NA,17123,"Marshall County, IL","County or equivalent",2004,12999,92,-41,131,172,147,2,145,-14
"37900",NA,17143,"Peoria County, IL","County or equivalent",2004,181974,144,776,2607,1831,-498,232,-730,-134
"37900",NA,17175,"Stark County, IL","County or equivalent",2004,6143,-32,-4,73,77,-22,1,-23,-6
"37900",NA,17179,"Tazewell County, IL","County or equivalent",2004,128405,601,372,1636,1264,318,43,275,-89
"37900",NA,17203,"Woodford County, IL","County or equivalent",2004,36509,482,48,412,364,434,6,428,0
"37980",NA,NA,"Philadelphia-Camden-Wilmington, PA-NJ-DE-MD","Metropolitan Statistical Area",2004,5771697,22641,22721,76629,53908,3266,11384,-8118,-3346
"37980",15804,NA,"Camden, NJ","Metropolitan Division",2004,1231357,10373,4995,15786,10791,5162,1862,3300,216
"37980",15804,34005,"Burlington County, NJ","County or equivalent",2004,446043,3520,1755,5470,3715,2077,848,1229,-312
"37980",15804,34007,"Camden County, NJ","County or equivalent",2004,512448,2110,2266,6971,4705,-515,883,-1398,359
"37980",15804,34015,"Gloucester County, NJ","County or equivalent",2004,272866,4743,974,3345,2371,3600,131,3469,169
"37980",37964,NA,"Philadelphia, PA","Metropolitan Division",2004,3864661,5723,14093,51617,37524,-5309,8151,-13460,-3061
"37980",37964,42017,"Bucks County, PA","County or equivalent",2004,613566,3540,1826,6974,5148,2117,794,1323,-403
"37980",37964,42029,"Chester County, PA","County or equivalent",2004,463097,7807,2827,6117,3290,5414,751,4663,-434
"37980",37964,42045,"Delaware County, PA","County or equivalent",2004,551237,-800,1105,6806,5701,-1500,963,-2463,-405
"37980",37964,42091,"Montgomery County, PA","County or equivalent",2004,770670,2444,2537,9689,7152,428,1272,-844,-521
"37980",37964,42101,"Philadelphia County, PA","County or equivalent",2004,1466091,-7268,5798,22031,16233,-11768,4371,-16139,-1298
"37980",48864,NA,"Wilmington, DE-MD-NJ","Metropolitan Division",2004,675679,6545,3633,9226,5593,3413,1371,2042,-501
"37980",48864,10003,"New Castle County, DE","County or equivalent",2004,516103,3733,3010,7148,4138,1056,1266,-210,-333
"37980",48864,24015,"Cecil County, MD","County or equivalent",2004,94673,2306,461,1213,752,1964,48,1916,-119
"37980",48864,34033,"Salem County, NJ","County or equivalent",2004,64903,506,162,865,703,393,57,336,-49
"38060",NA,NA,"Phoenix-Mesa-Scottsdale, AZ","Metropolitan Statistical Area",2004,3715972,120484,36825,62415,25590,86033,19802,66231,-2374
"38060",NA,4013,"Maricopa County, AZ","County or equivalent",2004,3495453,108606,35544,59393,23849,77105,19365,57740,-4043
"38060",NA,4021,"Pinal County, AZ","County or equivalent",2004,220519,11878,1281,3022,1741,8928,437,8491,1669
"38220",NA,NA,"Pine Bluff, AR","Metropolitan Statistical Area",2004,104506,-893,300,1422,1122,-1097,58,-1155,-96
"38220",NA,5025,"Cleveland County, AR","County or equivalent",2004,8647,22,17,116,99,11,3,8,-6
"38220",NA,5069,"Jefferson County, AR","County or equivalent",2004,81715,-709,266,1162,896,-899,55,-954,-76
"38220",NA,5079,"Lincoln County, AR","County or equivalent",2004,14144,-206,17,144,127,-209,0,-209,-14
"38300",NA,NA,"Pittsburgh, PA","Metropolitan Statistical Area",2004,2387882,-12333,-3602,25159,28761,-6836,1862,-8698,-1895
"38300",NA,42003,"Allegheny County, PA","County or equivalent",2004,1246004,-11295,-1555,13515,15070,-8665,1632,-10297,-1075
"38300",NA,42005,"Armstrong County, PA","County or equivalent",2004,70801,-387,-121,738,859,-218,2,-220,-48
"38300",NA,42007,"Beaver County, PA","County or equivalent",2004,176863,-1008,-361,1797,2158,-517,45,-562,-130
"38300",NA,42019,"Butler County, PA","County or equivalent",2004,179343,726,228,2114,1886,615,66,549,-117
"38300",NA,42051,"Fayette County, PA","County or equivalent",2004,145870,458,-450,1457,1907,1041,16,1025,-133
"38300",NA,42125,"Washington County, PA","County or equivalent",2004,203747,183,-358,2091,2449,693,50,643,-152
"38300",NA,42129,"Westmoreland County, PA","County or equivalent",2004,365254,-1010,-985,3447,4432,215,51,164,-240
"38340",NA,NA,"Pittsfield, MA","Metropolitan Statistical Area",2004,131985,-580,-249,1297,1546,-237,106,-343,-94
"38340",NA,25003,"Berkshire County, MA","County or equivalent",2004,131985,-580,-249,1297,1546,-237,106,-343,-94
"38540",NA,NA,"Pocatello, ID","Metropolitan Statistical Area",2004,85755,1035,972,1599,627,-475,84,-559,538
"38540",NA,16005,"Bannock County, ID","County or equivalent",2004,78180,862,894,1467,573,-519,61,-580,487
"38540",NA,16077,"Power County, ID","County or equivalent",2004,7575,173,78,132,54,44,23,21,51
"38860",NA,NA,"Portland-South Portland-Biddeford, ME","Metropolitan Statistical Area",2004,509203,3284,1388,5733,4345,2277,549,1728,-381
"38860",NA,23005,"Cumberland County, ME","County or equivalent",2004,273170,1375,659,3071,2412,891,387,504,-175
"38860",NA,23023,"Sagadahoc County, ME","County or equivalent",2004,36597,-94,161,462,301,-220,53,-273,-35
"38860",NA,23031,"York County, ME","County or equivalent",2004,199436,2003,568,2200,1632,1606,109,1497,-171
"38900",NA,NA,"Portland-Vancouver-Beaverton, OR-WA","Metropolitan Statistical Area",2004,2054913,19524,13123,28035,14912,8437,7952,485,-2036
"38900",NA,41005,"Clackamas County, OR","County or equivalent",2004,360831,5040,1337,4103,2766,4008,750,3258,-305
"38900",NA,41009,"Columbia County, OR","County or equivalent",2004,46241,566,109,514,405,498,14,484,-41
"38900",NA,41051,"Multnomah County, OR","County or equivalent",2004,672660,-6527,3609,9191,5582,-9317,3247,-12564,-819
"38900",NA,41067,"Washington County, OR","County or equivalent",2004,486036,7406,4784,7532,2748,2937,2482,455,-315
"38900",NA,41071,"Yamhill County, OR","County or equivalent",2004,89691,898,380,1119,739,576,256,320,-58
"38900",NA,53011,"Clark County, WA","County or equivalent",2004,389229,11955,2870,5475,2605,9570,1200,8370,-485
"38900",NA,53059,"Skamania County, WA","County or equivalent",2004,10225,186,34,101,67,165,3,162,-13
"38940",NA,NA,"Port St. Lucie, FL","Metropolitan Statistical Area",2004,361979,15072,-260,3849,4109,16062,747,15315,-730
"38940",NA,12085,"Martin County, FL","County or equivalent",2004,136827,2411,-501,1216,1717,3107,264,2843,-195
"38940",NA,12111,"St. Lucie County, FL","County or equivalent",2004,225152,12661,241,2633,2392,12955,483,12472,-535
"39100",NA,NA,"Poughkeepsie-Newburgh-Middletown, NY","Metropolitan Statistical Area",2004,658516,6638,3687,8534,4847,3427,1457,1970,-476
"39100",NA,36027,"Dutchess County, NY","County or equivalent",2004,290812,1612,1041,3259,2218,761,545,216,-190
"39100",NA,36071,"Orange County, NY","County or equivalent",2004,367704,5026,2646,5275,2629,2666,912,1754,-286
"39140",NA,NA,"Prescott, AZ","Metropolitan Statistical Area",2004,189411,6098,-215,1934,2149,6626,272,6354,-313
"39140",NA,4025,"Yavapai County, AZ","County or equivalent",2004,189411,6098,-215,1934,2149,6626,272,6354,-313
"39300",NA,NA,"Providence-New Bedford-Fall River, RI-MA","Metropolitan Statistical Area",2004,1617299,-396,4727,19939,15212,-3892,3593,-7485,-1231
"39300",NA,25005,"Bristol County, MA","County or equivalent",2004,546204,-189,1387,6676,5289,-1187,639,-1826,-389
"39300",NA,44001,"Bristol County, RI","County or equivalent",2004,50867,-29,-1,494,495,4,27,-23,-32
"39300",NA,44003,"Kent County, RI","County or equivalent",2004,171056,58,156,1875,1719,11,137,-126,-109
"39300",NA,44005,"Newport County, RI","County or equivalent",2004,84485,-744,221,963,742,-876,272,-1148,-89
"39300",NA,44007,"Providence County, RI","County or equivalent",2004,636605,176,2668,8613,5945,-1961,2410,-4371,-531
"39300",NA,44009,"Washington County, RI","County or equivalent",2004,128082,332,296,1318,1022,117,108,9,-81
"39340",NA,NA,"Provo-Orem, UT","Metropolitan Statistical Area",2004,442896,24721,9297,11121,1824,1491,1130,361,13933
"39340",NA,49023,"Juab County, UT","County or equivalent",2004,8782,179,105,176,71,82,0,82,-8
"39340",NA,49049,"Utah County, UT","County or equivalent",2004,434114,24542,9192,10945,1753,1409,1130,279,13941
"39380",NA,NA,"Pueblo, CO","Metropolitan Statistical Area",2004,148597,667,414,1948,1534,351,149,202,-98
"39380",NA,8101,"Pueblo County, CO","County or equivalent",2004,148597,667,414,1948,1534,351,149,202,-98
"39460",NA,NA,"Punta Gorda, FL","Metropolitan Statistical Area",2004,156057,4088,-1283,1025,2308,5671,139,5532,-300
"39460",NA,12015,"Charlotte County, FL","County or equivalent",2004,156057,4088,-1283,1025,2308,5671,139,5532,-300
"39540",NA,NA,"Racine, WI","Metropolitan Statistical Area",2004,194701,1734,1033,2533,1500,175,216,-41,526
"39540",NA,55101,"Racine County, WI","County or equivalent",2004,194701,1734,1033,2533,1500,175,216,-41,526
"39580",NA,NA,"Raleigh-Cary, NC","Metropolitan Statistical Area",2004,916625,27547,9329,14556,5227,18507,3938,14569,-289
"39580",NA,37069,"Franklin County, NC","County or equivalent",2004,53095,1167,200,671,471,1028,111,917,-61
"39580",NA,37101,"Johnston County, NC","County or equivalent",2004,140713,4621,1127,2246,1119,3686,427,3259,-192
"39580",NA,37183,"Wake County, NC","County or equivalent",2004,722817,21759,8002,11639,3637,13793,3400,10393,-36
"39660",NA,NA,"Rapid City, SD","Metropolitan Statistical Area",2004,117543,1669,1048,1914,866,708,240,468,-87
"39660",NA,46093,"Meade County, SD","County or equivalent",2004,24615,233,153,346,193,95,114,-19,-15
"39660",NA,46103,"Pennington County, SD","County or equivalent",2004,92928,1436,895,1568,673,613,126,487,-72
"39740",NA,NA,"Reading, PA","Metropolitan Statistical Area",2004,388835,4550,1443,5018,3575,3454,525,2929,-347
"39740",NA,42011,"Berks County, PA","County or equivalent",2004,388835,4550,1443,5018,3575,3454,525,2929,-347
"39820",NA,NA,"Redding, CA","Metropolitan Statistical Area",2004,176466,2060,247,2091,1844,1976,102,1874,-163
"39820",NA,6089,"Shasta County, CA","County or equivalent",2004,176466,2060,247,2091,1844,1976,102,1874,-163
"39900",NA,NA,"Reno-Sparks, NV","Metropolitan Statistical Area",2004,384242,10076,2576,5457,2881,7930,1428,6502,-430
"39900",NA,32029,"Storey County, NV","County or equivalent",2004,3670,158,0,15,15,167,2,165,-9
"39900",NA,32031,"Washoe County, NV","County or equivalent",2004,380572,9918,2576,5442,2866,7763,1426,6337,-421
"40060",NA,NA,"Richmond, VA","Metropolitan Statistical Area",2004,1154113,15369,5394,15291,9897,11164,1975,9189,-1189
"40060",NA,51007,"Amelia County, VA","County or equivalent",2004,11835,195,35,147,112,172,0,172,-12
"40060",NA,51033,"Caroline County, VA","County or equivalent",2004,23751,727,83,312,229,682,10,672,-38
"40060",NA,51036,"Charles City County, VA","County or equivalent",2004,7037,-42,-9,55,64,-29,2,-31,-4
"40060",NA,51041,"Chesterfield County, VA","County or equivalent",2004,279243,5334,1890,3579,1689,3732,428,3304,-288
"40060",NA,51049,"Cumberland County, VA","County or equivalent",2004,9118,-20,15,97,82,-30,9,-39,-5
"40060",NA,51053,"Dinwiddie County, VA","County or equivalent",2004,25016,171,9,258,249,185,10,175,-23
"40060",NA,51075,"Goochland County, VA","County or equivalent",2004,18497,489,47,188,141,468,12,456,-26
"40060",NA,51085,"Hanover County, VA","County or equivalent",2004,95414,1866,464,1171,707,1508,42,1466,-106
"40060",NA,51087,"Henrico County, VA","County or equivalent",2004,275996,4892,1517,3905,2388,3640,728,2912,-265
"40060",NA,51097,"King and Queen County, VA","County or equivalent",2004,6693,169,-8,80,88,188,1,187,-11
"40060",NA,51101,"King William County, VA","County or equivalent",2004,14152,216,67,185,118,162,6,156,-13
"40060",NA,51109,"Louisa County, VA","County or equivalent",2004,28584,735,78,326,248,698,5,693,-41
"40060",NA,51127,"New Kent County, VA","County or equivalent",2004,15318,554,52,168,116,529,5,524,-27
"40060",NA,51145,"Powhatan County, VA","County or equivalent",2004,25490,655,101,264,163,589,0,589,-35
"40060",NA,51149,"Prince George County, VA","County or equivalent",2004,36408,378,208,377,169,193,272,-79,-23
"40060",NA,51183,"Sussex County, VA","County or equivalent",2004,11939,-204,-26,116,142,-166,7,-173,-12
"40060",NA,51570,"Colonial Heights city, VA","County or equivalent",2004,17438,265,3,220,217,281,18,263,-19
"40060",NA,51670,"Hopewell city, VA","County or equivalent",2004,22312,15,79,342,263,-46,19,-65,-18
"40060",NA,51730,"Petersburg city, VA","County or equivalent",2004,32678,-296,90,554,464,-351,40,-391,-35
"40060",NA,51760,"Richmond city, VA","County or equivalent",2004,197194,-730,699,2947,2248,-1241,361,-1602,-188
"40140",NA,NA,"Riverside-San Bernardino-Ontario, CA","Metropolitan Statistical Area",2004,3753081,135951,33717,59701,25984,107708,12487,95221,-5474
"40140",NA,6065,"Riverside County, CA","County or equivalent",2004,1849378,82985,14909,28575,13666,71358,5832,65526,-3282
"40140",NA,6071,"San Bernardino County, CA","County or equivalent",2004,1903703,52966,18808,31126,12318,36350,6655,29695,-2192
"40220",NA,NA,"Roanoke, VA","Metropolitan Statistical Area",2004,290172,846,257,3380,3123,846,280,566,-257
"40220",NA,51023,"Botetourt County, VA","County or equivalent",2004,31527,224,44,296,252,211,3,208,-31
"40220",NA,51045,"Craig County, VA","County or equivalent",2004,5094,29,6,48,42,27,0,27,-4
"40220",NA,51067,"Franklin County, VA","County or equivalent",2004,49220,551,67,514,447,534,11,523,-50
"40220",NA,51161,"Roanoke County, VA","County or equivalent",2004,87506,683,308,1186,878,445,89,356,-70
"40220",NA,51770,"Roanoke city, VA","County or equivalent",2004,92318,-380,-87,1112,1199,-214,157,-371,-79
"40220",NA,51775,"Salem city, VA","County or equivalent",2004,24507,-261,-81,224,305,-157,20,-177,-23
"40340",NA,NA,"Rochester, MN","Metropolitan Statistical Area",2004,174027,2317,1549,2667,1118,895,536,359,-127
"40340",NA,27039,"Dodge County, MN","County or equivalent",2004,19068,342,170,292,122,191,15,176,-19
"40340",NA,27109,"Olmsted County, MN","County or equivalent",2004,133154,2031,1323,2123,800,799,497,302,-91
"40340",NA,27157,"Wabasha County, MN","County or equivalent",2004,21805,-56,56,252,196,-95,24,-119,-17
"40380",NA,NA,"Rochester, NY","Metropolitan Statistical Area",2004,1038973,-1286,3108,12157,9049,-3568,1536,-5104,-826
"40380",NA,36051,"Livingston County, NY","County or equivalent",2004,63956,69,110,635,525,-2,7,-9,-39
"40380",NA,36055,"Monroe County, NY","County or equivalent",2004,736600,-1394,2404,8771,6367,-3191,1426,-4617,-607
"40380",NA,36069,"Ontario County, NY","County or equivalent",2004,102639,545,183,1134,951,433,60,373,-71
"40380",NA,36073,"Orleans County, NY","County or equivalent",2004,43137,-77,84,449,365,-130,13,-143,-31
"40380",NA,36117,"Wayne County, NY","County or equivalent",2004,92641,-429,327,1168,841,-678,30,-708,-78
"40420",NA,NA,"Rockford, IL","Metropolitan Statistical Area",2004,334773,3520,1797,4612,2815,1277,760,517,446
"40420",NA,17007,"Boone County, IL","County or equivalent",2004,47753,1630,306,627,321,1395,111,1284,-71
"40420",NA,17201,"Winnebago County, IL","County or equivalent",2004,287020,1890,1491,3985,2494,-118,649,-767,517
"40580",NA,NA,"Rocky Mount, NC","Metropolitan Statistical Area",2004,143673,263,443,1934,1491,-34,171,-205,-146
"40580",NA,37065,"Edgecombe County, NC","County or equivalent",2004,53786,-436,180,768,588,-535,71,-606,-81
"40580",NA,37127,"Nash County, NC","County or equivalent",2004,89887,699,263,1166,903,501,100,401,-65
"40660",NA,NA,"Rome, GA","Metropolitan Statistical Area",2004,93865,423,405,1403,998,82,203,-121,-64
"40660",NA,13115,"Floyd County, GA","County or equivalent",2004,93865,423,405,1403,998,82,203,-121,-64
"40900",NA,NA,"Sacramento--Arden-Arcade--Roseville, CA","Metropolitan Statistical Area",2004,2006869,37967,14013,28457,14444,25794,7501,18293,-1840
"40900",NA,6017,"El Dorado County, CA","County or equivalent",2004,170409,3038,582,1841,1259,2648,248,2400,-192
"40900",NA,6061,"Placer County, CA","County or equivalent",2004,304478,12557,1441,3715,2274,11637,423,11214,-521
"40900",NA,6067,"Sacramento County, CA","County or equivalent",2004,1346677,20039,10705,20484,9779,10340,5617,4723,-1006
"40900",NA,6113,"Yolo County, CA","County or equivalent",2004,185305,2333,1285,2417,1132,1169,1213,-44,-121
"40980",NA,NA,"Saginaw-Saginaw Township North, MI","Metropolitan Statistical Area",2004,207784,-392,646,2655,2009,-874,123,-997,-164
"40980",NA,26145,"Saginaw County, MI","County or equivalent",2004,207784,-392,646,2655,2009,-874,123,-997,-164
"41060",NA,NA,"St. Cloud, MN","Metropolitan Statistical Area",2004,179343,1437,1316,2403,1087,76,142,-66,45
"41060",NA,27009,"Benton County, MN","County or equivalent",2004,38156,473,243,544,301,219,23,196,11
"41060",NA,27145,"Stearns County, MN","County or equivalent",2004,141187,964,1073,1859,786,-143,119,-262,34
"41100",NA,NA,"St. George, UT","Metropolitan Statistical Area",2004,110253,6008,1414,2242,828,4796,135,4661,-202
"41100",NA,49053,"Washington County, UT","County or equivalent",2004,110253,6008,1414,2242,828,4796,135,4661,-202
"41140",NA,NA,"St. Joseph, MO-KS","Metropolitan Statistical Area",2004,123460,-508,195,1474,1279,-975,46,-1021,272
"41140",NA,20043,"Doniphan County, KS","County or equivalent",2004,7891,-159,1,80,79,-152,1,-153,-8
"41140",NA,29003,"Andrew County, MO","County or equivalent",2004,16579,-33,13,174,161,-35,4,-39,-11
"41140",NA,29021,"Buchanan County, MO","County or equivalent",2004,86634,330,192,1120,928,-179,38,-217,317
"41140",NA,29063,"DeKalb County, MO","County or equivalent",2004,12356,-646,-11,100,111,-609,3,-612,-26
"41180",NA,NA,"St. Louis, MO-IL","Metropolitan Statistical Area",2004,2759063,15383,10879,36649,25770,-976,3748,-4724,5480
"41180",NA,17005,"Bond County, IL","County or equivalent",2004,18252,183,40,225,185,161,2,159,-18
"41180",NA,17013,"Calhoun County, IL","County or equivalent",2004,5106,8,-19,50,69,30,0,30,-3
"41180",NA,17027,"Clinton County, IL","County or equivalent",2004,35973,122,80,403,323,67,26,41,-25
"41180",NA,17083,"Jersey County, IL","County or equivalent",2004,22130,190,5,236,231,204,1,203,-19
"41180",NA,17117,"Macoupin County, IL","County or equivalent",2004,48648,-71,12,585,573,-49,6,-55,-34
"41180",NA,17119,"Madison County, IL","County or equivalent",2004,263959,1002,641,3371,2730,351,116,235,10
"41180",NA,17133,"Monroe County, IL","County or equivalent",2004,30652,721,91,335,244,584,4,580,46
"41180",NA,17163,"St. Clair County, IL","County or equivalent",2004,258338,647,1124,3726,2602,-525,557,-1082,48
"41180",NA,29071,"Franklin County, MO","County or equivalent",2004,97270,946,417,1288,871,610,9,601,-81
"41180",NA,29099,"Jefferson County, MO","County or equivalent",2004,208188,3107,1210,2814,1604,2084,72,2012,-187
"41180",NA,29113,"Lincoln County, MO","County or equivalent",2004,45374,1511,259,651,392,1321,11,1310,-69
"41180",NA,29183,"St. Charles County, MO","County or equivalent",2004,318557,8075,2549,4523,1974,5895,161,5734,-369
"41180",NA,29189,"St. Louis County, MO","County or equivalent",2004,1004466,-4579,2806,12407,9601,-6519,1458,-7977,-866
"41180",NA,29219,"Warren County, MO","County or equivalent",2004,27578,709,109,368,259,638,7,631,-38
"41180",NA,29221,"Washington County, MO","County or equivalent",2004,23867,146,64,310,246,100,5,95,-18
"41180",NA,29510,"St. Louis city, MO","County or equivalent",2004,350705,2666,1491,5357,3866,-5928,1313,-7241,7103
"41420",NA,NA,"Salem, OR","Metropolitan Statistical Area",2004,366680,4115,2331,5480,3149,2090,1480,610,-306
"41420",NA,41047,"Marion County, OR","County or equivalent",2004,298923,2308,2069,4641,2572,460,1329,-869,-221
"41420",NA,41053,"Polk County, OR","County or equivalent",2004,67757,1807,262,839,577,1630,151,1479,-85
"41500",NA,NA,"Salinas, CA","Metropolitan Statistical Area",2004,410223,-1162,4942,7394,2452,-5570,3552,-9122,-534
"41500",NA,6053,"Monterey County, CA","County or equivalent",2004,410223,-1162,4942,7394,2452,-5570,3552,-9122,-534
"41540",NA,NA,"Salisbury, MD","Metropolitan Statistical Area",2004,114154,1495,301,1445,1144,1300,152,1148,-106
"41540",NA,24039,"Somerset County, MD","County or equivalent",2004,25613,206,4,272,268,225,25,200,-23
"41540",NA,24045,"Wicomico County, MD","County or equivalent",2004,88541,1289,297,1173,876,1075,127,948,-83
"41620",NA,NA,"Salt Lake City, UT","Metropolitan Statistical Area",2004,1031306,14570,14469,20182,5713,-1704,4618,-6322,1805
"41620",NA,49035,"Salt Lake County, UT","County or equivalent",2004,948909,12195,13217,18561,5344,-2910,4426,-7336,1888
"41620",NA,49043,"Summit County, UT","County or equivalent",2004,33683,1030,451,538,87,616,120,496,-37
"41620",NA,49045,"Tooele County, UT","County or equivalent",2004,48714,1345,801,1083,282,590,72,518,-46
"41660",NA,NA,"San Angelo, TX","Metropolitan Statistical Area",2004,106492,120,557,1584,1027,-351,281,-632,-86
"41660",NA,48235,"Irion County, TX","County or equivalent",2004,1701,-28,1,12,11,-26,0,-26,-3
"41660",NA,48451,"Tom Green County, TX","County or equivalent",2004,104791,148,556,1572,1016,-325,281,-606,-83
"41700",NA,NA,"San Antonio, TX","Metropolitan Statistical Area",2004,1844604,35943,16846,30078,13232,20752,5727,15025,-1655
"41700",NA,48013,"Atascosa County, TX","County or equivalent",2004,42069,772,358,680,322,453,35,418,-39
"41700",NA,48019,"Bandera County, TX","County or equivalent",2004,19300,178,57,202,145,139,18,121,-18
"41700",NA,48029,"Bexar County, TX","County or equivalent",2004,1488264,25714,14927,25405,10478,11953,5283,6670,-1166
"41700",NA,48091,"Comal County, TX","County or equivalent",2004,90950,4031,498,1205,707,3711,100,3611,-178
"41700",NA,48187,"Guadalupe County, TX","County or equivalent",2004,98983,2583,590,1280,690,2113,220,1893,-120
"41700",NA,48259,"Kendall County, TX","County or equivalent",2004,27067,877,73,316,243,841,34,807,-37
"41700",NA,48325,"Medina County, TX","County or equivalent",2004,41861,681,227,554,327,494,22,472,-40
"41700",NA,48493,"Wilson County, TX","County or equivalent",2004,36110,1107,116,436,320,1048,15,1033,-57
"41740",NA,NA,"San Diego-Carlsbad-San Marcos, CA","Metropolitan Statistical Area",2004,2930053,2742,24758,45221,20463,-19018,19083,-38101,-2998
"41740",NA,6073,"San Diego County, CA","County or equivalent",2004,2930053,2742,24758,45221,20463,-19018,19083,-38101,-2998
"41780",NA,NA,"Sandusky, OH","Metropolitan Statistical Area",2004,78365,-107,121,945,824,-169,21,-190,-59
"41780",NA,39043,"Erie County, OH","County or equivalent",2004,78365,-107,121,945,824,-169,21,-190,-59
"41860",NA,NA,"San Francisco-Oakland-Fremont, CA","Metropolitan Statistical Area",2004,4149620,-7982,26914,55869,28955,-35867,28792,-64659,971
"41860",36084,NA,"Oakland-Fremont-Hayward, CA","Metropolitan Division",2004,2439206,-2888,18168,34496,16328,-18495,15617,-34112,-2561
"41860",36084,6001,"Alameda County, CA","County or equivalent",2004,1444362,-8561,11860,21287,9427,-18619,11310,-29929,-1802
"41860",36084,6013,"Contra Costa County, CA","County or equivalent",2004,994844,5673,6308,13209,6901,124,4307,-4183,-759
"41860",41884,NA,"San Francisco-San Mateo-Redwood City, CA","Metropolitan Division",2004,1710414,-5094,8746,21373,12627,-17372,13175,-30547,3532
"41860",41884,6041,"Marin County, CA","County or equivalent",2004,244036,-1245,1024,2826,1802,-2016,1131,-3147,-253
"41860",41884,6075,"San Francisco County, CA","County or equivalent",2004,772417,-1942,2390,8536,6146,-8921,6435,-15356,4589
"41860",41884,6081,"San Mateo County, CA","County or equivalent",2004,693961,-1907,5332,10011,4679,-6435,5609,-12044,-804
"41940",NA,NA,"San Jose-Sunnyvale-Santa Clara, CA","Metropolitan Statistical Area",2004,1728380,1999,18895,27694,8799,-14791,18688,-33479,-2105
"41940",NA,6069,"San Benito County, CA","County or equivalent",2004,55082,-287,594,871,277,-817,245,-1062,-64
"41940",NA,6085,"Santa Clara County, CA","County or equivalent",2004,1673298,2286,18301,26823,8522,-13974,18443,-32417,-2041
"42020",NA,NA,"San Luis Obispo-Paso Robles, CA","Metropolitan Statistical Area",2004,256250,1897,575,2677,2102,1525,475,1050,-203
"42020",NA,6079,"San Luis Obispo County, CA","County or equivalent",2004,256250,1897,575,2677,2102,1525,475,1050,-203
"42060",NA,NA,"Santa Barbara-Santa Maria-Goleta, CA","Metropolitan Statistical Area",2004,402128,-955,3046,5962,2916,-3575,2276,-5851,-426
"42060",NA,6083,"Santa Barbara County, CA","County or equivalent",2004,402128,-955,3046,5962,2916,-3575,2276,-5851,-426
"42100",NA,NA,"Santa Cruz-Watsonville, CA","Metropolitan Statistical Area",2004,250905,-994,1811,3489,1678,-2531,1124,-3655,-274
"42100",NA,6087,"Santa Cruz County, CA","County or equivalent",2004,250905,-994,1811,3489,1678,-2531,1124,-3655,-274
"42140",NA,NA,"Santa Fe, NM","Metropolitan Statistical Area",2004,137767,1492,766,1634,868,818,568,250,-92
"42140",NA,35049,"Santa Fe County, NM","County or equivalent",2004,137767,1492,766,1634,868,818,568,250,-92
"42220",NA,NA,"Santa Rosa-Petaluma, CA","Metropolitan Statistical Area",2004,463915,-307,2036,5910,3874,-1930,1875,-3805,-413
"42220",NA,6097,"Sonoma County, CA","County or equivalent",2004,463915,-307,2036,5910,3874,-1930,1875,-3805,-413
"42340",NA,NA,"Savannah, GA","Metropolitan Statistical Area",2004,310290,5356,1919,4715,2796,3736,684,3052,-299
"42340",NA,13029,"Bryan County, GA","County or equivalent",2004,27038,1183,226,422,196,1007,42,965,-50
"42340",NA,13051,"Chatham County, GA","County or equivalent",2004,238960,2513,1355,3653,2298,1337,628,709,-179
"42340",NA,13103,"Effingham County, GA","County or equivalent",2004,44292,1660,338,640,302,1392,14,1378,-70
"42540",NA,NA,"Scranton--Wilkes-Barre, PA","Metropolitan Statistical Area",2004,548815,-1504,-2122,5571,7693,1011,250,761,-393
"42540",NA,42069,"Lackawanna County, PA","County or equivalent",2004,209261,-514,-824,2184,3008,460,108,352,-150
"42540",NA,42079,"Luzerne County, PA","County or equivalent",2004,311553,-1063,-1339,3089,4428,498,137,361,-222
"42540",NA,42131,"Wyoming County, PA","County or equivalent",2004,28001,73,41,298,257,53,5,48,-21
"42660",NA,NA,"Seattle-Tacoma-Bellevue, WA","Metropolitan Statistical Area",2004,3160537,23572,20688,41770,21082,3493,13762,-10269,-609
"42660",42644,NA,"Seattle-Bellevue-Everett, WA","Metropolitan Division",2004,2419295,18523,15810,31508,15698,2790,11325,-8535,-77
"42660",42644,53033,"King County, WA","County or equivalent",2004,1779905,12054,11197,22757,11560,527,9321,-8794,330
"42660",42644,53061,"Snohomish County, WA","County or equivalent",2004,639390,6469,4613,8751,4138,2263,2004,259,-407
"42660",45104,NA,"Tacoma, WA","Metropolitan Division",2004,741242,5049,4878,10262,5384,703,2437,-1734,-532
"42660",45104,53053,"Pierce County, WA","County or equivalent",2004,741242,5049,4878,10262,5384,703,2437,-1734,-532
"42680",NA,NA,"Sebastian-Vero Beach, FL","Metropolitan Statistical Area",2004,123959,4219,-631,1212,1843,5077,231,4846,-227
"42680",NA,12061,"Indian River County, FL","County or equivalent",2004,123959,4219,-631,1212,1843,5077,231,4846,-227
"43100",NA,NA,"Sheboygan, WI","Metropolitan Statistical Area",2004,113226,272,315,1365,1050,32,133,-101,-75
"43100",NA,55117,"Sheboygan County, WI","County or equivalent",2004,113226,272,315,1365,1050,32,133,-101,-75
"43300",NA,NA,"Sherman-Denison, TX","Metropolitan Statistical Area",2004,114932,548,395,1619,1224,229,179,50,-76
"43300",NA,48181,"Grayson County, TX","County or equivalent",2004,114932,548,395,1619,1224,229,179,50,-76
"43340",NA,NA,"Shreveport-Bossier City, LA","Metropolitan Statistical Area",2004,379421,2631,1837,5664,3827,1063,497,566,-269
"43340",NA,22015,"Bossier Parish, LA","County or equivalent",2004,103646,1698,804,1630,826,982,302,680,-88
"43340",NA,22017,"Caddo Parish, LA","County or equivalent",2004,249876,665,944,3669,2725,-122,188,-310,-157
"43340",NA,22031,"De Soto Parish, LA","County or equivalent",2004,25899,268,89,365,276,203,7,196,-24
"43580",NA,NA,"Sioux City, IA-NE-SD","Metropolitan Statistical Area",2004,141919,-49,1141,2343,1202,-1048,463,-1511,-142
"43580",NA,19193,"Woodbury County, IA","County or equivalent",2004,102456,-61,786,1689,903,-749,317,-1066,-98
"43580",NA,31043,"Dakota County, NE","County or equivalent",2004,20240,-106,275,422,147,-353,118,-471,-28
"43580",NA,31051,"Dixon County, NE","County or equivalent",2004,6066,-54,8,72,64,-57,7,-64,-5
"43580",NA,46127,"Union County, SD","County or equivalent",2004,13157,172,72,160,88,111,21,90,-11
"43620",NA,NA,"Sioux Falls, SD","Metropolitan Statistical Area",2004,208680,5990,1859,3336,1477,3202,374,2828,929
"43620",NA,46083,"Lincoln County, SD","County or equivalent",2004,31669,2431,352,554,202,2074,21,2053,5
"43620",NA,46087,"McCook County, SD","County or equivalent",2004,5830,32,9,87,78,28,1,27,-5
"43620",NA,46099,"Minnehaha County, SD","County or equivalent",2004,162672,3580,1517,2604,1087,1127,350,777,936
"43620",NA,46125,"Turner County, SD","County or equivalent",2004,8509,-53,-19,91,110,-27,2,-29,-7
"43780",NA,NA,"South Bend-Mishawaka, IN-MI","Metropolitan Statistical Area",2004,315471,12,1483,4412,2929,-1208,503,-1711,-263
"43780",NA,18141,"St. Joseph County, IN","County or equivalent",2004,264315,-216,1381,3852,2471,-1374,488,-1862,-223
"43780",NA,26027,"Cass County, MI","County or equivalent",2004,51156,228,102,560,458,166,15,151,-40
"43900",NA,NA,"Spartanburg, SC","Metropolitan Statistical Area",2004,262550,1807,805,3423,2618,1189,363,826,-187
"43900",NA,45083,"Spartanburg County, SC","County or equivalent",2004,262550,1807,805,3423,2618,1189,363,826,-187
"44060",NA,NA,"Spokane, WA","Metropolitan Statistical Area",2004,435225,4234,1774,5496,3722,2776,831,1945,-316
"44060",NA,53063,"Spokane County, WA","County or equivalent",2004,435225,4234,1774,5496,3722,2776,831,1945,-316
"44100",NA,NA,"Springfield, IL","Metropolitan Statistical Area",2004,204747,461,740,2720,1980,-310,119,-429,31
"44100",NA,17129,"Menard County, IL","County or equivalent",2004,12520,44,-11,122,133,64,4,60,-9
"44100",NA,17167,"Sangamon County, IL","County or equivalent",2004,192227,417,751,2598,1847,-374,115,-489,40
"44140",NA,NA,"Springfield, MA","Metropolitan Statistical Area",2004,685814,198,1152,7679,6527,-465,1483,-1948,-489
"44140",NA,25011,"Franklin County, MA","County or equivalent",2004,71950,46,31,679,648,60,92,-32,-45
"44140",NA,25013,"Hampden County, MA","County or equivalent",2004,460088,47,1074,5745,4671,-681,1138,-1819,-346
"44140",NA,25015,"Hampshire County, MA","County or equivalent",2004,153776,105,47,1255,1208,156,253,-97,-98
"44180",NA,NA,"Springfield, MO","Metropolitan Statistical Area",2004,392715,7217,1589,5240,3651,6054,193,5861,-426
"44180",NA,29043,"Christian County, MO","County or equivalent",2004,63522,2601,486,949,463,2224,11,2213,-109
"44180",NA,29059,"Dallas County, MO","County or equivalent",2004,16168,230,45,222,177,203,4,199,-18
"44180",NA,29077,"Greene County, MO","County or equivalent",2004,250907,3339,797,3201,2404,2775,152,2623,-233
"44180",NA,29167,"Polk County, MO","County or equivalent",2004,28499,280,67,375,308,239,21,218,-26
"44180",NA,29225,"Webster County, MO","County or equivalent",2004,33619,767,194,493,299,613,5,608,-40
"44220",NA,NA,"Springfield, OH","Metropolitan Statistical Area",2004,141568,-341,174,1807,1633,-405,42,-447,-110
"44220",NA,39023,"Clark County, OH","County or equivalent",2004,141568,-341,174,1807,1633,-405,42,-447,-110
"44300",NA,NA,"State College, PA","Metropolitan Statistical Area",2004,141003,500,469,1347,878,132,523,-391,-101
"44300",NA,42027,"Centre County, PA","County or equivalent",2004,141003,500,469,1347,878,132,523,-391,-101
"44700",NA,NA,"Stockton, CA","Metropolitan Statistical Area",2004,642049,16035,6212,10648,4436,10491,2453,8038,-668
"44700",NA,6077,"San Joaquin County, CA","County or equivalent",2004,642049,16035,6212,10648,4436,10491,2453,8038,-668
"44940",NA,NA,"Sumter, SC","Metropolitan Statistical Area",2004,105142,325,700,1658,958,-292,329,-621,-83
"44940",NA,45085,"Sumter County, SC","County or equivalent",2004,105142,325,700,1658,958,-292,329,-621,-83
"45060",NA,NA,"Syracuse, NY","Metropolitan Statistical Area",2004,649243,-476,2077,7752,5675,-2064,852,-2916,-489
"45060",NA,36053,"Madison County, NY","County or equivalent",2004,69861,33,105,714,609,-28,21,-49,-44
"45060",NA,36067,"Onondaga County, NY","County or equivalent",2004,456553,-611,1636,5655,4019,-1883,803,-2686,-364
"45060",NA,36075,"Oswego County, NY","County or equivalent",2004,122829,102,336,1383,1047,-153,28,-181,-81
"45220",NA,NA,"Tallahassee, FL","Metropolitan Statistical Area",2004,336961,4228,1984,4262,2278,2512,486,2026,-268
"45220",NA,12039,"Gadsden County, FL","County or equivalent",2004,45448,261,231,676,445,60,54,6,-30
"45220",NA,12065,"Jefferson County, FL","County or equivalent",2004,14276,320,-5,149,154,344,1,343,-19
"45220",NA,12073,"Leon County, FL","County or equivalent",2004,250646,2701,1669,3139,1470,1209,425,784,-177
"45220",NA,12129,"Wakulla County, FL","County or equivalent",2004,26591,946,89,298,209,899,6,893,-42
"45300",NA,NA,"Tampa-St. Petersburg-Clearwater, FL","Metropolitan Statistical Area",2004,2577050,54857,1568,30545,28977,56613,7186,49427,-3324
"45300",NA,12053,"Hernando County, FL","County or equivalent",2004,149007,6713,-962,1330,2292,8027,76,7951,-352
"45300",NA,12057,"Hillsborough County, FL","County or equivalent",2004,1099149,28027,6897,15805,8908,22404,4195,18209,-1274
"45300",NA,12101,"Pasco County, FL","County or equivalent",2004,404556,19163,-1332,4332,5664,21450,538,20912,-955
"45300",NA,12103,"Pinellas County, FL","County or equivalent",2004,924338,954,-3035,9078,12113,4732,2377,2355,-743
"45460",NA,NA,"Terre Haute, IN","Metropolitan Statistical Area",2004,168756,-701,115,2116,2001,-672,113,-785,-144
"45460",NA,18021,"Clay County, IN","County or equivalent",2004,26809,176,28,344,316,172,12,160,-24
"45460",NA,18153,"Sullivan County, IN","County or equivalent",2004,21662,-21,0,257,257,-7,1,-8,-14
"45460",NA,18165,"Vermillion County, IN","County or equivalent",2004,16395,-5,-12,208,220,17,5,12,-10
"45460",NA,18167,"Vigo County, IN","County or equivalent",2004,103890,-851,99,1307,1208,-854,95,-949,-96
"45500",NA,NA,"Texarkana, TX-Texarkana, AR","Metropolitan Statistical Area",2004,131528,768,214,1617,1403,649,67,582,-95
"45500",NA,5091,"Miller County, AR","County or equivalent",2004,41862,411,87,483,396,357,22,335,-33
"45500",NA,48037,"Bowie County, TX","County or equivalent",2004,89666,357,127,1134,1007,292,45,247,-62
"45780",NA,NA,"Toledo, OH","Metropolitan Statistical Area",2004,656491,-1263,2629,8856,6227,-3348,524,-3872,-544
"45780",NA,39051,"Fulton County, OH","County or equivalent",2004,42576,322,177,532,355,179,11,168,-34
"45780",NA,39095,"Lucas County, OH","County or equivalent",2004,449044,-2971,1973,6484,4511,-4522,402,-4924,-422
"45780",NA,39123,"Ottawa County, OH","County or equivalent",2004,41302,175,-10,431,441,176,6,170,9
"45780",NA,39173,"Wood County, OH","County or equivalent",2004,123569,1211,489,1409,920,819,105,714,-97
"45820",NA,NA,"Topeka, KS","Metropolitan Statistical Area",2004,226262,756,1013,3166,2153,-81,215,-296,-176
"45820",NA,20085,"Jackson County, KS","County or equivalent",2004,13076,85,80,189,109,13,2,11,-8
"45820",NA,20087,"Jefferson County, KS","County or equivalent",2004,18619,119,62,222,160,72,5,67,-15
"45820",NA,20139,"Osage County, KS","County or equivalent",2004,16763,99,-17,170,187,131,6,125,-15
"45820",NA,20177,"Shawnee County, KS","County or equivalent",2004,171079,417,876,2508,1632,-328,201,-529,-131
"45820",NA,20197,"Wabaunsee County, KS","County or equivalent",2004,6725,36,12,77,65,31,1,30,-7
"45940",NA,NA,"Trenton-Ewing, NJ","Metropolitan Statistical Area",2004,361583,2686,1653,4584,2931,1266,1759,-493,-233
"45940",NA,34021,"Mercer County, NJ","County or equivalent",2004,361583,2686,1653,4584,2931,1266,1759,-493,-233
"46060",NA,NA,"Tucson, AZ","Metropolitan Statistical Area",2004,923327,20554,5171,12988,7817,11481,2955,8526,3902
"46060",NA,4019,"Pima County, AZ","County or equivalent",2004,923327,20554,5171,12988,7817,11481,2955,8526,3902
"46140",NA,NA,"Tulsa, OK","Metropolitan Statistical Area",2004,876676,161,4982,13112,8130,-3944,1481,-5425,-877
"46140",NA,40037,"Creek County, OK","County or equivalent",2004,68163,-173,150,869,719,-272,8,-280,-51
"46140",NA,40111,"Okmulgee County, OK","County or equivalent",2004,39549,-30,64,545,481,-66,11,-77,-28
"46140",NA,40113,"Osage County, OK","County or equivalent",2004,44763,-71,39,444,405,-78,13,-91,-32
"46140",NA,40117,"Pawnee County, OK","County or equivalent",2004,16476,-143,-9,189,198,-119,0,-119,-15
"46140",NA,40131,"Rogers County, OK","County or equivalent",2004,78524,1665,368,989,621,1388,27,1361,-91
"46140",NA,40143,"Tulsa County, OK","County or equivalent",2004,567207,-1991,4071,9338,5267,-5470,1386,-6856,-592
"46140",NA,40145,"Wagoner County, OK","County or equivalent",2004,61994,904,299,738,439,673,36,637,-68
"46220",NA,NA,"Tuscaloosa, AL","Metropolitan Statistical Area",2004,195442,986,660,2513,1853,474,196,278,-148
"46220",NA,1063,"Greene County, AL","County or equivalent",2004,9533,-163,32,150,118,-183,0,-183,-12
"46220",NA,1065,"Hale County, AL","County or equivalent",2004,17859,-138,-11,188,199,-112,0,-112,-15
"46220",NA,1125,"Tuscaloosa County, AL","County or equivalent",2004,168050,1287,639,2175,1536,769,196,573,-121
"46340",NA,NA,"Tyler, TX","Metropolitan Statistical Area",2004,186134,2835,1225,2899,1674,1765,454,1311,-155
"46340",NA,48423,"Smith County, TX","County or equivalent",2004,186134,2835,1225,2899,1674,1765,454,1311,-155
"46540",NA,NA,"Utica-Rome, NY","Metropolitan Statistical Area",2004,295982,29,-23,3328,3351,257,623,-366,-205
"46540",NA,36043,"Herkimer County, NY","County or equivalent",2004,63221,-1,-91,693,784,134,18,116,-44
"46540",NA,36065,"Oneida County, NY","County or equivalent",2004,232761,30,68,2635,2567,123,605,-482,-161
"46660",NA,NA,"Valdosta, GA","Metropolitan Statistical Area",2004,124455,2046,1004,2082,1078,1153,314,839,-111
"46660",NA,13027,"Brooks County, GA","County or equivalent",2004,16138,68,19,241,222,61,12,49,-12
"46660",NA,13101,"Echols County, GA","County or equivalent",2004,4032,106,63,94,31,46,39,7,-3
"46660",NA,13173,"Lanier County, GA","County or equivalent",2004,7310,-48,42,130,88,-83,13,-96,-7
"46660",NA,13185,"Lowndes County, GA","County or equivalent",2004,96975,1920,880,1617,737,1129,250,879,-89
"46700",NA,NA,"Vallejo-Fairfield, CA","Metropolitan Statistical Area",2004,408850,116,3063,5749,2686,-2562,1762,-4324,-385
"46700",NA,6095,"Solano County, CA","County or equivalent",2004,408850,116,3063,5749,2686,-2562,1762,-4324,-385
"47020",NA,NA,"Victoria, TX","Metropolitan Statistical Area",2004,112485,137,769,1733,964,-537,174,-711,-95
"47020",NA,48057,"Calhoun County, TX","County or equivalent",2004,20315,25,137,306,169,-93,76,-169,-19
"47020",NA,48175,"Goliad County, TX","County or equivalent",2004,6992,-77,0,75,75,-71,2,-73,-6
"47020",NA,48469,"Victoria County, TX","County or equivalent",2004,85178,189,632,1352,720,-373,96,-469,-70
"47220",NA,NA,"Vineland-Millville-Bridgeton, NJ","Metropolitan Statistical Area",2004,150160,1504,590,2214,1624,1026,391,635,-112
"47220",NA,34011,"Cumberland County, NJ","County or equivalent",2004,150160,1504,590,2214,1624,1026,391,635,-112
"47260",NA,NA,"Virginia Beach-Norfolk-Newport News, VA-NC","Metropolitan Statistical Area",2004,1643620,18291,11707,24051,12344,7828,7496,332,-1244
"47260",NA,37053,"Currituck County, NC","County or equivalent",2004,21816,1257,71,251,180,1241,19,1222,-55
"47260",NA,51073,"Gloucester County, VA","County or equivalent",2004,36722,437,135,441,306,333,36,297,-31
"47260",NA,51093,"Isle of Wight County, VA","County or equivalent",2004,32165,729,2,310,308,773,18,755,-46
"47260",NA,51095,"James City County, VA","County or equivalent",2004,55246,2133,38,492,454,2199,65,2134,-104
"47260",NA,51115,"Mathews County, VA","County or equivalent",2004,9050,-79,-60,69,129,-12,6,-18,-7
"47260",NA,51181,"Surry County, VA","County or equivalent",2004,6889,-26,1,64,63,-21,0,-21,-6
"47260",NA,51199,"York County, VA","County or equivalent",2004,59977,574,250,590,340,364,294,70,-40
"47260",NA,51550,"Chesapeake city, VA","County or equivalent",2004,213169,4741,1530,2911,1381,3441,503,2938,-230
"47260",NA,51650,"Hampton city, VA","County or equivalent",2004,145105,-183,765,1935,1170,-819,550,-1369,-129
"47260",NA,51700,"Newport News city, VA","County or equivalent",2004,183832,1006,1778,3230,1452,-609,878,-1487,-163
"47260",NA,51710,"Norfolk city, VA","County or equivalent",2004,241717,1147,2069,4087,2018,-1083,2077,-3160,161
"47260",NA,51735,"Poquoson city, VA","County or equivalent",2004,11626,-74,3,92,89,-68,16,-84,-9
"47260",NA,51740,"Portsmouth city, VA","County or equivalent",2004,99802,332,525,1634,1109,-118,311,-429,-75
"47260",NA,51800,"Suffolk city, VA","County or equivalent",2004,75715,2871,497,1159,662,2498,120,2378,-124
"47260",NA,51810,"Virginia Beach city, VA","County or equivalent",2004,439141,3296,4036,6601,2565,-362,2579,-2941,-378
"47260",NA,51830,"Williamsburg city, VA","County or equivalent",2004,11648,130,67,185,118,71,24,47,-8
"47300",NA,NA,"Visalia-Porterville, CA","Metropolitan Statistical Area",2004,396120,8906,5074,7765,2691,4159,1895,2264,-327
"47300",NA,6107,"Tulare County, CA","County or equivalent",2004,396120,8906,5074,7765,2691,4159,1895,2264,-327
"47380",NA,NA,"Waco, TX","Metropolitan Statistical Area",2004,222474,2883,1249,3323,2074,1821,485,1336,-187
"47380",NA,48309,"McLennan County, TX","County or equivalent",2004,222474,2883,1249,3323,2074,1821,485,1336,-187
"47580",NA,NA,"Warner Robins, GA","Metropolitan Statistical Area",2004,123760,3801,1037,1856,819,2923,453,2470,-159
"47580",NA,13153,"Houston County, GA","County or equivalent",2004,123760,3801,1037,1856,819,2923,453,2470,-159
"47900",NA,NA,"Washington-Arlington-Alexandria, DC-VA-MD-WV","Metropolitan Statistical Area",2004,5154448,69842,46910,77763,30853,17533,32068,-14535,5399
"47900",13644,NA,"Bethesda-Frederick-Gaithersburg, MD","Metropolitan Division",2004,1139326,9431,9567,16653,7086,-1820,7898,-9718,1684
"47900",13644,24021,"Frederick County, MD","County or equivalent",2004,216232,3497,1615,3047,1432,2071,295,1776,-189
"47900",13644,24031,"Montgomery County, MD","County or equivalent",2004,923094,5934,7952,13606,5654,-3891,7603,-11494,1873
"47900",47894,NA,"Washington-Arlington-Alexandria, DC-VA-MD-WV","Metropolitan Division",2004,4015122,60411,37343,61110,23767,19353,24170,-4817,3715
"47900",47894,11001,"District of Columbia, DC","County or equivalent",2004,579521,2150,2267,7789,5522,-3885,3129,-7014,3768
"47900",47894,24009,"Calvert County, MD","County or equivalent",2004,85311,1969,451,1013,562,1617,77,1540,-99
"47900",47894,24017,"Charles County, MD","County or equivalent",2004,134531,3083,989,1858,869,2241,193,2048,-147
"47900",47894,24033,"Prince George's County, MD","County or equivalent",2004,832806,3984,7266,12563,5297,-2590,4019,-6609,-692
"47900",47894,51013,"Arlington County, VA","County or equivalent",2004,197955,1065,1677,2722,1045,-2315,2702,-5017,1703
"47900",47894,51043,"Clarke County, VA","County or equivalent",2004,13643,366,-17,128,145,403,11,392,-20
"47900",47894,51059,"Fairfax County, VA","County or equivalent",2004,995649,3786,10536,14942,4406,-5717,9065,-14782,-1033
"47900",47894,51061,"Fauquier County, VA","County or equivalent",2004,62561,1764,248,740,492,1603,64,1539,-87
"47900",47894,51107,"Loudoun County, VA","County or equivalent",2004,236965,17542,3920,4686,766,14213,725,13488,-591
"47900",47894,51153,"Prince William County, VA","County or equivalent",2004,332689,12071,5063,6295,1232,7402,1523,5879,-394
"47900",47894,51177,"Spotsylvania County, VA","County or equivalent",2004,110507,3971,987,1648,661,3152,92,3060,-168
"47900",47894,51179,"Stafford County, VA","County or equivalent",2004,113164,4129,1128,1619,491,3163,279,2884,-162
"47900",47894,51187,"Warren County, VA","County or equivalent",2004,34080,579,146,455,309,470,8,462,-37
"47900",47894,51510,"Alexandria city, VA","County or equivalent",2004,136635,1473,1584,2369,785,-1961,1660,-3621,1850
"47900",47894,51600,"Fairfax city, VA","County or equivalent",2004,22020,-153,52,267,215,-176,247,-423,-29
"47900",47894,51610,"Falls Church city, VA","County or equivalent",2004,10544,-11,18,102,84,-19,67,-86,-10
"47900",47894,51630,"Fredericksburg city, VA","County or equivalent",2004,21258,862,182,391,209,713,46,667,-33
"47900",47894,51683,"Manassas city, VA","County or equivalent",2004,36955,285,431,633,202,-111,180,-291,-35
"47900",47894,51685,"Manassas Park city, VA","County or equivalent",2004,11299,421,219,256,37,214,63,151,-12
"47900",47894,54037,"Jefferson County, WV","County or equivalent",2004,47029,1075,196,634,438,936,20,916,-57
"47940",NA,NA,"Waterloo-Cedar Falls, IA","Metropolitan Statistical Area",2004,161880,264,500,2037,1537,-114,324,-438,-122
"47940",NA,19013,"Black Hawk County, IA","County or equivalent",2004,126243,153,516,1683,1167,-266,316,-582,-97
"47940",NA,19017,"Bremer County, IA","County or equivalent",2004,23388,105,13,232,219,109,7,102,-17
"47940",NA,19075,"Grundy County, IA","County or equivalent",2004,12249,6,-29,122,151,43,1,42,-8
"48140",NA,NA,"Wausau, WI","Metropolitan Statistical Area",2004,126737,319,585,1522,937,-180,81,-261,-86
"48140",NA,55073,"Marathon County, WI","County or equivalent",2004,126737,319,585,1522,937,-180,81,-261,-86
"48260",NA,NA,"Weirton-Steubenville, WV-OH","Metropolitan Statistical Area",2004,126510,-1279,-524,1256,1780,-660,22,-682,-95
"48260",NA,39081,"Jefferson County, OH","County or equivalent",2004,70844,-552,-318,695,1013,-186,16,-202,-48
"48260",NA,54009,"Brooke County, WV","County or equivalent",2004,24508,-305,-103,227,330,-182,3,-185,-20
"48260",NA,54029,"Hancock County, WV","County or equivalent",2004,31158,-422,-103,334,437,-292,3,-295,-27
"48300",NA,NA,"Wenatchee, WA","Metropolitan Statistical Area",2004,101909,1287,469,1352,883,895,355,540,-77
"48300",NA,53007,"Chelan County, WA","County or equivalent",2004,68021,744,305,916,611,485,238,247,-46
"48300",NA,53017,"Douglas County, WA","County or equivalent",2004,33888,543,164,436,272,410,117,293,-31
"48540",NA,NA,"Wheeling, WV-OH","Metropolitan Statistical Area",2004,148592,-849,-417,1576,1993,-326,31,-357,-106
"48540",NA,39013,"Belmont County, OH","County or equivalent",2004,69002,-259,-209,736,945,-5,10,-15,-45
"48540",NA,54051,"Marshall County, WV","County or equivalent",2004,34341,-268,-65,353,418,-176,1,-177,-27
"48540",NA,54069,"Ohio County, WV","County or equivalent",2004,45249,-322,-143,487,630,-145,20,-165,-34
"48620",NA,NA,"Wichita, KS","Metropolitan Statistical Area",2004,581222,1451,4078,9091,5013,-2125,1343,-3468,-502
"48620",NA,20015,"Butler County, KS","County or equivalent",2004,61112,602,205,749,544,449,39,410,-52
"48620",NA,20079,"Harvey County, KS","County or equivalent",2004,33367,94,26,412,386,89,44,45,-21
"48620",NA,20173,"Sedgwick County, KS","County or equivalent",2004,461895,929,3833,7626,3793,-2492,1257,-3749,-412
"48620",NA,20191,"Sumner County, KS","County or equivalent",2004,24848,-174,14,304,290,-171,3,-174,-17
"48660",NA,NA,"Wichita Falls, TX","Metropolitan Statistical Area",2004,150986,258,731,2157,1426,-342,755,-1097,-131
"48660",NA,48009,"Archer County, TX","County or equivalent",2004,8981,51,52,126,74,7,2,5,-8
"48660",NA,48077,"Clay County, TX","County or equivalent",2004,11326,13,6,96,90,15,4,11,-8
"48660",NA,48485,"Wichita County, TX","County or equivalent",2004,130679,194,673,1935,1262,-364,749,-1113,-115
"48700",NA,NA,"Williamsport, PA","Metropolitan Statistical Area",2004,118072,-166,108,1351,1243,-195,18,-213,-79
"48700",NA,42081,"Lycoming County, PA","County or equivalent",2004,118072,-166,108,1351,1243,-195,18,-213,-79
"48900",NA,NA,"Wilmington, NC","Metropolitan Statistical Area",2004,303984,9771,735,3410,2675,9522,421,9101,-486
"48900",NA,37019,"Brunswick County, NC","County or equivalent",2004,83702,2801,2,854,852,2947,106,2841,-148
"48900",NA,37129,"New Hanover County, NC","County or equivalent",2004,175917,5750,714,2141,1427,5306,241,5065,-270
"48900",NA,37141,"Pender County, NC","County or equivalent",2004,44365,1220,19,415,396,1269,74,1195,-68
"49020",NA,NA,"Winchester, VA-WV","Metropolitan Statistical Area",2004,112780,2504,610,1529,919,2025,149,1876,-131
"49020",NA,51069,"Frederick County, VA","County or equivalent",2004,66331,1782,423,896,473,1445,41,1404,-86
"49020",NA,51840,"Winchester city, VA","County or equivalent",2004,25174,520,194,407,213,348,104,244,-22
"49020",NA,54027,"Hampshire County, WV","County or equivalent",2004,21275,202,-7,226,233,232,4,228,-23
"49180",NA,NA,"Winston-Salem, NC","Metropolitan Statistical Area",2004,439273,4228,2043,5981,3938,2515,1299,1216,-330
"49180",NA,37059,"Davie County, NC","County or equivalent",2004,37656,721,115,423,308,647,61,586,-41
"49180",NA,37067,"Forsyth County, NC","County or equivalent",2004,319441,3335,1748,4597,2849,1815,1130,685,-228
"49180",NA,37169,"Stokes County, NC","County or equivalent",2004,45157,268,85,514,429,214,34,180,-31
"49180",NA,37197,"Yadkin County, NC","County or equivalent",2004,37019,-96,95,447,352,-161,74,-235,-30
"49340",NA,NA,"Worcester, MA","Metropolitan Statistical Area",2004,775254,2740,3362,10070,6708,-70,2074,-2144,-552
"49340",NA,25027,"Worcester County, MA","County or equivalent",2004,775254,2740,3362,10070,6708,-70,2074,-2144,-552
"49420",NA,NA,"Yakima, WA","Metropolitan Statistical Area",2004,227107,2061,2534,4335,1801,-289,886,-1175,-184
"49420",NA,53077,"Yakima County, WA","County or equivalent",2004,227107,2061,2534,4335,1801,-289,886,-1175,-184
"49620",NA,NA,"York-Hanover, PA","Metropolitan Statistical Area",2004,399153,5794,1519,4935,3416,4669,243,4426,-394
"49620",NA,42133,"York County, PA","County or equivalent",2004,399153,5794,1519,4935,3416,4669,243,4426,-394
"49660",NA,NA,"Youngstown-Warren-Boardman, OH-PA","Metropolitan Statistical Area",2004,585792,-4106,-464,6472,6936,-3174,181,-3355,-468
"49660",NA,39099,"Mahoning County, OH","County or equivalent",2004,248176,-2223,-306,2785,3091,-1710,103,-1813,-207
"49660",NA,39155,"Trumbull County, OH","County or equivalent",2004,218903,-1482,-39,2426,2465,-1267,49,-1316,-176
"49660",NA,42085,"Mercer County, PA","County or equivalent",2004,118713,-401,-119,1261,1380,-197,29,-226,-85
"49700",NA,NA,"Yuba City, CA","Metropolitan Statistical Area",2004,150014,2501,1215,2509,1294,1404,806,598,-118
"49700",NA,6101,"Sutter County, CA","County or equivalent",2004,85645,1583,599,1333,734,1058,449,609,-74
"49700",NA,6115,"Yuba County, CA","County or equivalent",2004,64369,918,616,1176,560,346,357,-11,-44
"49740",NA,NA,"Yuma, AZ","Metropolitan Statistical Area",2004,173915,4643,2061,3255,1194,2750,1109,1641,-168
"49740",NA,4027,"Yuma County, AZ","County or equivalent",2004,173915,4643,2061,3255,1194,2750,1109,1641,-168
" ",NA,NA,"","",2004,NA,NA,NA,NA,NA,NA,NA,NA,NA
" ",NA,NA,"Micropolitan Statistical Area","",2004,NA,NA,NA,NA,NA,NA,NA,NA,NA
" ",NA,NA,"","",2004,NA,NA,NA,NA,NA,NA,NA,NA,NA
"10020",NA,NA,"Abbeville, LA","Micropolitan Statistical Area",2004,54336,205,221,783,562,19,46,-27,-35
"10020",NA,22113,"Vermilion Parish, LA","County or equivalent",2004,54336,205,221,783,562,19,46,-27,-35
"10100",NA,NA,"Aberdeen, SD","Micropolitan Statistical Area",2004,38941,-73,111,504,393,-152,9,-161,-32
"10100",NA,46013,"Brown County, SD","County or equivalent",2004,34869,22,122,459,337,-75,9,-84,-25
"10100",NA,46045,"Edmunds County, SD","County or equivalent",2004,4072,-95,-11,45,56,-77,0,-77,-7
"10140",NA,NA,"Aberdeen, WA","Micropolitan Statistical Area",2004,69606,586,21,800,779,630,78,552,-65
"10140",NA,53027,"Grays Harbor County, WA","County or equivalent",2004,69606,586,21,800,779,630,78,552,-65
"10220",NA,NA,"Ada, OK","Micropolitan Statistical Area",2004,35254,90,70,491,421,42,15,27,-22
"10220",NA,40123,"Pontotoc County, OK","County or equivalent",2004,35254,90,70,491,421,42,15,27,-22
"10300",NA,NA,"Adrian, MI","Micropolitan Statistical Area",2004,100945,454,370,1241,871,150,39,111,-66
"10300",NA,26091,"Lenawee County, MI","County or equivalent",2004,100945,454,370,1241,871,150,39,111,-66
"10460",NA,NA,"Alamogordo, NM","Micropolitan Statistical Area",2004,63225,1024,369,860,491,703,540,163,-48
"10460",NA,35035,"Otero County, NM","County or equivalent",2004,63225,1024,369,860,491,703,540,163,-48
"10540",NA,NA,"Albany-Lebanon, OR","Micropolitan Statistical Area",2004,106955,823,339,1412,1073,558,86,472,-74
"10540",NA,41043,"Linn County, OR","County or equivalent",2004,106955,823,339,1412,1073,558,86,472,-74
"10620",NA,NA,"Albemarle, NC","Micropolitan Statistical Area",2004,58249,-183,129,740,611,-264,71,-335,-48
"10620",NA,37167,"Stanly County, NC","County or equivalent",2004,58249,-183,129,740,611,-264,71,-335,-48
"10660",NA,NA,"Albert Lea, MN","Micropolitan Statistical Area",2004,31777,-117,60,404,344,-148,29,-177,-29
"10660",NA,27047,"Freeborn County, MN","County or equivalent",2004,31777,-117,60,404,344,-148,29,-177,-29
"10700",NA,NA,"Albertville, AL","Micropolitan Statistical Area",2004,83878,471,457,1408,951,70,206,-136,-56
"10700",NA,1095,"Marshall County, AL","County or equivalent",2004,83878,471,457,1408,951,70,206,-136,-56
"10760",NA,NA,"Alexander City, AL","Micropolitan Statistical Area",2004,51754,-352,-90,591,681,-224,10,-234,-38
"10760",NA,1037,"Coosa County, AL","County or equivalent",2004,11180,-264,-9,134,143,-242,2,-244,-13
"10760",NA,1123,"Tallapoosa County, AL","County or equivalent",2004,40574,-88,-81,457,538,18,8,10,-25
"10820",NA,NA,"Alexandria, MN","Micropolitan Statistical Area",2004,34602,442,61,381,320,415,4,411,-34
"10820",NA,27041,"Douglas County, MN","County or equivalent",2004,34602,442,61,381,320,415,4,411,-34
"10860",NA,NA,"Alice, TX","Micropolitan Statistical Area",2004,40458,350,271,619,348,110,11,99,-31
"10860",NA,48249,"Jim Wells County, TX","County or equivalent",2004,40458,350,271,619,348,110,11,99,-31
"10880",NA,NA,"Allegan, MI","Micropolitan Statistical Area",2004,111128,1237,695,1519,824,629,88,541,-87
"10880",NA,26005,"Allegan County, MI","County or equivalent",2004,111128,1237,695,1519,824,629,88,541,-87
"10940",NA,NA,"Alma, MI","Micropolitan Statistical Area",2004,42327,-16,100,518,418,-85,11,-96,-31
"10940",NA,26057,"Gratiot County, MI","County or equivalent",2004,42327,-16,100,518,418,-85,11,-96,-31
"10980",NA,NA,"Alpena, MI","Micropolitan Statistical Area",2004,30480,-158,-53,261,314,-85,19,-104,-20
"10980",NA,26007,"Alpena County, MI","County or equivalent",2004,30480,-158,-53,261,314,-85,19,-104,-20
"11060",NA,NA,"Altus, OK","Micropolitan Statistical Area",2004,27164,-25,174,453,279,-174,147,-321,-25
"11060",NA,40065,"Jackson County, OK","County or equivalent",2004,27164,-25,174,453,279,-174,147,-321,-25
"11140",NA,NA,"Americus, GA","Micropolitan Statistical Area",2004,36514,-282,134,559,425,-378,30,-408,-38
"11140",NA,13249,"Schley County, GA","County or equivalent",2004,3819,27,16,56,40,13,5,8,-2
"11140",NA,13261,"Sumter County, GA","County or equivalent",2004,32695,-309,118,503,385,-391,25,-416,-36
"11220",NA,NA,"Amsterdam, NY","Micropolitan Statistical Area",2004,48787,-162,-88,587,675,-42,18,-60,-32
"11220",NA,36057,"Montgomery County, NY","County or equivalent",2004,48787,-162,-88,587,675,-42,18,-60,-32
"11380",NA,NA,"Andrews, TX","Micropolitan Statistical Area",2004,12758,-31,82,199,117,-101,11,-112,-12
"11380",NA,48003,"Andrews County, TX","County or equivalent",2004,12758,-31,82,199,117,-101,11,-112,-12
"11420",NA,NA,"Angola, IN","Micropolitan Statistical Area",2004,33401,-141,100,383,283,-213,20,-233,-28
"11420",NA,18151,"Steuben County, IN","County or equivalent",2004,33401,-141,100,383,283,-213,20,-233,-28
"11580",NA,NA,"Arcadia, FL","Micropolitan Statistical Area",2004,34106,672,154,458,304,550,312,238,-32
"11580",NA,12027,"DeSoto County, FL","County or equivalent",2004,34106,672,154,458,304,550,312,238,-32
"11620",NA,NA,"Ardmore, OK","Micropolitan Statistical Area",2004,55554,562,49,767,718,567,31,536,-54
"11620",NA,40019,"Carter County, OK","County or equivalent",2004,46608,460,37,659,622,467,22,445,-44
"11620",NA,40085,"Love County, OK","County or equivalent",2004,8946,102,12,108,96,100,9,91,-10
"11660",NA,NA,"Arkadelphia, AR","Micropolitan Statistical Area",2004,23208,-66,23,274,251,-72,25,-97,-17
"11660",NA,5019,"Clark County, AR","County or equivalent",2004,23208,-66,23,274,251,-72,25,-97,-17
"11740",NA,NA,"Ashland, OH","Micropolitan Statistical Area",2004,53624,160,83,623,540,112,15,97,-35
"11740",NA,39005,"Ashland County, OH","County or equivalent",2004,53624,160,83,623,540,112,15,97,-35
"11780",NA,NA,"Ashtabula, OH","Micropolitan Statistical Area",2004,102235,-218,181,1240,1059,-323,38,-361,-76
"11780",NA,39007,"Ashtabula County, OH","County or equivalent",2004,102235,-218,181,1240,1059,-323,38,-361,-76
"11820",NA,NA,"Astoria, OR","Micropolitan Statistical Area",2004,36082,294,20,382,362,302,95,207,-28
"11820",NA,41007,"Clatsop County, OR","County or equivalent",2004,36082,294,20,382,362,302,95,207,-28
"11860",NA,NA,"Atchison, KS","Micropolitan Statistical Area",2004,16715,18,66,233,167,-37,4,-41,-11
"11860",NA,20005,"Atchison County, KS","County or equivalent",2004,16715,18,66,233,167,-37,4,-41,-11
"11900",NA,NA,"Athens, OH","Micropolitan Statistical Area",2004,62499,-771,171,630,459,-872,144,-1016,-70
"11900",NA,39009,"Athens County, OH","County or equivalent",2004,62499,-771,171,630,459,-872,144,-1016,-70
"11940",NA,NA,"Athens, TN","Micropolitan Statistical Area",2004,50448,208,16,604,588,227,31,196,-35
"11940",NA,47107,"McMinn County, TN","County or equivalent",2004,50448,208,16,604,588,227,31,196,-35
"11980",NA,NA,"Athens, TX","Micropolitan Statistical Area",2004,78259,1528,18,925,907,1613,79,1534,-103
"11980",NA,48213,"Henderson County, TX","County or equivalent",2004,78259,1528,18,925,907,1613,79,1534,-103
"12140",NA,NA,"Auburn, IN","Micropolitan Statistical Area",2004,41175,257,227,567,340,56,17,39,-26
"12140",NA,18033,"DeKalb County, IN","County or equivalent",2004,41175,257,227,567,340,56,17,39,-26
"12180",NA,NA,"Auburn, NY","Micropolitan Statistical Area",2004,80880,-217,87,852,765,-245,25,-270,-59
"12180",NA,36011,"Cayuga County, NY","County or equivalent",2004,80880,-217,87,852,765,-245,25,-270,-59
"12300",NA,NA,"Augusta-Waterville, ME","Micropolitan Statistical Area",2004,119729,582,162,1295,1133,512,48,464,-92
"12300",NA,23011,"Kennebec County, ME","County or equivalent",2004,119729,582,162,1295,1133,512,48,464,-92
"12380",NA,NA,"Austin, MN","Micropolitan Statistical Area",2004,38499,70,142,534,392,-44,77,-121,-28
"12380",NA,27099,"Mower County, MN","County or equivalent",2004,38499,70,142,534,392,-44,77,-121,-28
"12460",NA,NA,"Bainbridge, GA","Micropolitan Statistical Area",2004,28106,62,89,392,303,-8,41,-49,-19
"12460",NA,13087,"Decatur County, GA","County or equivalent",2004,28106,62,89,392,303,-8,41,-49,-19
"12660",NA,NA,"Baraboo, WI","Micropolitan Statistical Area",2004,56888,640,269,767,498,418,22,396,-47
"12660",NA,55111,"Sauk County, WI","County or equivalent",2004,56888,640,269,767,498,418,22,396,-47
"12740",NA,NA,"Barre, VT","Micropolitan Statistical Area",2004,58739,42,145,616,471,-62,63,-125,-41
"12740",NA,50023,"Washington County, VT","County or equivalent",2004,58739,42,145,616,471,-62,63,-125,-41
"12780",NA,NA,"Bartlesville, OK","Micropolitan Statistical Area",2004,48788,-57,66,626,560,-86,62,-148,-37
"12780",NA,40147,"Washington County, OK","County or equivalent",2004,48788,-57,66,626,560,-86,62,-148,-37
"12820",NA,NA,"Bastrop, LA","Micropolitan Statistical Area",2004,29948,-315,40,431,391,-328,1,-329,-27
"12820",NA,22067,"Morehouse Parish, LA","County or equivalent",2004,29948,-315,40,431,391,-328,1,-329,-27
"12860",NA,NA,"Batavia, NY","Micropolitan Statistical Area",2004,59130,-396,15,610,595,-363,31,-394,-48
"12860",NA,36037,"Genesee County, NY","County or equivalent",2004,59130,-396,15,610,595,-363,31,-394,-48
"12900",NA,NA,"Batesville, AR","Micropolitan Statistical Area",2004,34263,154,100,497,397,75,20,55,-21
"12900",NA,5063,"Independence County, AR","County or equivalent",2004,34263,154,100,497,397,75,20,55,-21
"13060",NA,NA,"Bay City, TX","Micropolitan Statistical Area",2004,37540,-255,190,558,368,-404,124,-528,-41
"13060",NA,48321,"Matagorda County, TX","County or equivalent",2004,37540,-255,190,558,368,-404,124,-528,-41
"13100",NA,NA,"Beatrice, NE","Micropolitan Statistical Area",2004,23200,33,3,275,272,45,5,40,-15
"13100",NA,31067,"Gage County, NE","County or equivalent",2004,23200,33,3,275,272,45,5,40,-15
"13180",NA,NA,"Beaver Dam, WI","Micropolitan Statistical Area",2004,87333,499,126,988,862,439,30,409,-66
"13180",NA,55027,"Dodge County, WI","County or equivalent",2004,87333,499,126,988,862,439,30,409,-66
"13220",NA,NA,"Beckley, WV","Micropolitan Statistical Area",2004,78631,27,10,937,927,70,40,30,-53
"13220",NA,54081,"Raleigh County, WV","County or equivalent",2004,78631,27,10,937,927,70,40,30,-53
"13260",NA,NA,"Bedford, IN","Micropolitan Statistical Area",2004,45892,-127,-8,525,533,-86,13,-99,-33
"13260",NA,18093,"Lawrence County, IN","County or equivalent",2004,45892,-127,-8,525,533,-86,13,-99,-33
"13300",NA,NA,"Beeville, TX","Micropolitan Statistical Area",2004,32643,-214,120,341,221,-306,6,-312,-28
"13300",NA,48025,"Bee County, TX","County or equivalent",2004,32643,-214,120,341,221,-306,6,-312,-28
"13340",NA,NA,"Bellefontaine, OH","Micropolitan Statistical Area",2004,46435,35,153,624,471,-85,21,-106,-33
"13340",NA,39091,"Logan County, OH","County or equivalent",2004,46435,35,153,624,471,-85,21,-106,-33
"13420",NA,NA,"Bemidji, MN","Micropolitan Statistical Area",2004,42077,440,294,634,340,175,17,158,-29
"13420",NA,27007,"Beltrami County, MN","County or equivalent",2004,42077,440,294,634,340,175,17,158,-29
"13500",NA,NA,"Bennettsville, SC","Micropolitan Statistical Area",2004,28094,-185,-10,312,322,-154,4,-158,-21
"13500",NA,45069,"Marlboro County, SC","County or equivalent",2004,28094,-185,-10,312,322,-154,4,-158,-21
"13540",NA,NA,"Bennington, VT","Micropolitan Statistical Area",2004,36719,-102,-4,373,377,-70,24,-94,-28
"13540",NA,50003,"Bennington County, VT","County or equivalent",2004,36719,-102,-4,373,377,-70,24,-94,-28
"13620",NA,NA,"Berlin, NH-VT","Micropolitan Statistical Area",2004,39271,-69,-191,334,525,150,13,137,-28
"13620",NA,33007,"Coos County, NH","County or equivalent",2004,32754,-75,-160,286,446,109,11,98,-24
"13620",NA,50009,"Essex County, VT","County or equivalent",2004,6517,6,-31,48,79,41,2,39,-4
"13660",NA,NA,"Big Rapids, MI","Micropolitan Statistical Area",2004,42070,373,99,437,338,308,40,268,-34
"13660",NA,26107,"Mecosta County, MI","County or equivalent",2004,42070,373,99,437,338,308,40,268,-34
"13700",NA,NA,"Big Spring, TX","Micropolitan Statistical Area",2004,32391,-211,68,462,394,-253,18,-271,-26
"13700",NA,48227,"Howard County, TX","County or equivalent",2004,32391,-211,68,462,394,-253,18,-271,-26
"13860",NA,NA,"Bishop, CA","Micropolitan Statistical Area",2004,17961,-159,-32,209,241,-112,24,-136,-15
"13860",NA,6027,"Inyo County, CA","County or equivalent",2004,17961,-159,-32,209,241,-112,24,-136,-15
"13940",NA,NA,"Blackfoot, ID","Micropolitan Statistical Area",2004,42447,86,459,738,279,-337,62,-399,-36
"13940",NA,16011,"Bingham County, ID","County or equivalent",2004,42447,86,459,738,279,-337,62,-399,-36
"14100",NA,NA,"Bloomsburg-Berwick, PA","Micropolitan Statistical Area",2004,82533,-4,-109,834,943,170,23,147,-65
"14100",NA,42037,"Columbia County, PA","County or equivalent",2004,64582,105,-125,617,742,280,19,261,-50
"14100",NA,42093,"Montour County, PA","County or equivalent",2004,17951,-109,16,217,201,-110,4,-114,-15
"14140",NA,NA,"Bluefield, WV-VA","Micropolitan Statistical Area",2004,105593,-185,-227,1206,1433,116,22,94,-74
"14140",NA,51185,"Tazewell County, VA","County or equivalent",2004,43972,30,-102,477,579,164,9,155,-32
"14140",NA,54055,"Mercer County, WV","County or equivalent",2004,61621,-215,-125,729,854,-48,13,-61,-42
"14180",NA,NA,"Blytheville, AR","Micropolitan Statistical Area",2004,47567,-820,181,763,582,-946,18,-964,-55
"14180",NA,5093,"Mississippi County, AR","County or equivalent",2004,47567,-820,181,763,582,-946,18,-964,-55
"14220",NA,NA,"Bogalusa, LA","Micropolitan Statistical Area",2004,43748,58,46,633,587,40,4,36,-28
"14220",NA,22117,"Washington Parish, LA","County or equivalent",2004,43748,58,46,633,587,40,4,36,-28
"14300",NA,NA,"Bonham, TX","Micropolitan Statistical Area",2004,32237,184,-48,373,421,257,24,233,-25
"14300",NA,48147,"Fannin County, TX","County or equivalent",2004,32237,184,-48,373,421,257,24,233,-25
"14340",NA,NA,"Boone, IA","Micropolitan Statistical Area",2004,26243,106,42,302,260,83,9,74,-19
"14340",NA,19015,"Boone County, IA","County or equivalent",2004,26243,106,42,302,260,83,9,74,-19
"14380",NA,NA,"Boone, NC","Micropolitan Statistical Area",2004,43174,-154,8,332,324,-130,42,-172,-32
"14380",NA,37189,"Watauga County, NC","County or equivalent",2004,43174,-154,8,332,324,-130,42,-172,-32
"14420",NA,NA,"Borger, TX","Micropolitan Statistical Area",2004,22242,-360,77,313,236,-410,38,-448,-27
"14420",NA,48233,"Hutchinson County, TX","County or equivalent",2004,22242,-360,77,313,236,-410,38,-448,-27
"14580",NA,NA,"Bozeman, MT","Micropolitan Statistical Area",2004,77408,2719,630,1021,391,2206,72,2134,-117
"14580",NA,30031,"Gallatin County, MT","County or equivalent",2004,77408,2719,630,1021,391,2206,72,2134,-117
"14620",NA,NA,"Bradford, PA","Micropolitan Statistical Area",2004,44356,-458,-67,470,537,-356,4,-360,-35
"14620",NA,42083,"McKean County, PA","County or equivalent",2004,44356,-458,-67,470,537,-356,4,-360,-35
"14660",NA,NA,"Brainerd, MN","Micropolitan Statistical Area",2004,87285,1111,241,1088,847,962,18,944,-92
"14660",NA,27021,"Cass County, MN","County or equivalent",2004,28341,327,24,337,313,334,3,331,-31
"14660",NA,27035,"Crow Wing County, MN","County or equivalent",2004,58944,784,217,751,534,628,15,613,-61
"14700",NA,NA,"Branson, MO","Micropolitan Statistical Area",2004,72458,1052,144,915,771,988,34,954,-80
"14700",NA,29209,"Stone County, MO","County or equivalent",2004,30320,404,-22,312,334,463,8,455,-37
"14700",NA,29213,"Taney County, MO","County or equivalent",2004,42138,648,166,603,437,525,26,499,-43
"14780",NA,NA,"Brenham, TX","Micropolitan Statistical Area",2004,31131,272,51,408,357,245,58,187,-24
"14780",NA,48477,"Washington County, TX","County or equivalent",2004,31131,272,51,408,357,245,58,187,-24
"14820",NA,NA,"Brevard, NC","Micropolitan Statistical Area",2004,29239,57,-98,275,373,178,26,152,-23
"14820",NA,37175,"Transylvania County, NC","County or equivalent",2004,29239,57,-98,275,373,178,26,152,-23
"14940",NA,NA,"Brigham City, UT","Micropolitan Statistical Area",2004,45561,348,482,784,302,-404,46,-450,270
"14940",NA,49003,"Box Elder County, UT","County or equivalent",2004,45561,348,482,784,302,-404,46,-450,270
"15020",NA,NA,"Brookhaven, MS","Micropolitan Statistical Area",2004,33434,82,100,452,352,4,5,-1,-22
"15020",NA,28085,"Lincoln County, MS","County or equivalent",2004,33434,82,100,452,352,4,5,-1,-22
"15060",NA,NA,"Brookings, OR","Micropolitan Statistical Area",2004,21938,438,-151,158,309,625,16,609,-36
"15060",NA,41015,"Curry County, OR","County or equivalent",2004,21938,438,-151,158,309,625,16,609,-36
"15100",NA,NA,"Brookings, SD","Micropolitan Statistical Area",2004,28582,25,132,339,207,-86,35,-121,-21
"15100",NA,46011,"Brookings County, SD","County or equivalent",2004,28582,25,132,339,207,-86,35,-121,-21
"15140",NA,NA,"Brownsville, TN","Micropolitan Statistical Area",2004,19573,114,72,282,210,56,18,38,-14
"15140",NA,47075,"Haywood County, TN","County or equivalent",2004,19573,114,72,282,210,56,18,38,-14
"15220",NA,NA,"Brownwood, TX","Micropolitan Statistical Area",2004,37952,335,78,532,454,290,26,264,-33
"15220",NA,48049,"Brown County, TX","County or equivalent",2004,37952,335,78,532,454,290,26,264,-33
"15340",NA,NA,"Bucyrus, OH","Micropolitan Statistical Area",2004,45491,-229,113,617,504,-305,4,-309,-37
"15340",NA,39033,"Crawford County, OH","County or equivalent",2004,45491,-229,113,617,504,-305,4,-309,-37
"15420",NA,NA,"Burley, ID","Micropolitan Statistical Area",2004,39733,-541,367,739,372,-857,103,-960,-51
"15420",NA,16031,"Cassia County, ID","County or equivalent",2004,20937,-234,217,399,182,-425,42,-467,-26
"15420",NA,16067,"Minidoka County, ID","County or equivalent",2004,18796,-307,150,340,190,-432,61,-493,-25
"15460",NA,NA,"Burlington, IA-IL","Micropolitan Statistical Area",2004,48642,-435,68,589,521,-455,24,-479,-48
"15460",NA,17071,"Henderson County, IL","County or equivalent",2004,7917,-28,-13,70,83,-9,0,-9,-6
"15460",NA,19057,"Des Moines County, IA","County or equivalent",2004,40725,-407,81,519,438,-446,24,-470,-42
"15580",NA,NA,"Butte-Silver Bow, MT","Micropolitan Statistical Area",2004,32879,-174,-44,398,442,-103,9,-112,-27
"15580",NA,30093,"Silver Bow County, MT","County or equivalent",2004,32879,-174,-44,398,442,-103,9,-112,-27
"15620",NA,NA,"Cadillac, MI","Micropolitan Statistical Area",2004,46341,242,125,560,435,151,11,140,-34
"15620",NA,26113,"Missaukee County, MI","County or equivalent",2004,15101,89,39,173,134,62,1,61,-12
"15620",NA,26165,"Wexford County, MI","County or equivalent",2004,31240,153,86,387,301,89,10,79,-22
"15660",NA,NA,"Calhoun, GA","Micropolitan Statistical Area",2004,48587,1084,441,840,399,691,164,527,-48
"15660",NA,13129,"Gordon County, GA","County or equivalent",2004,48587,1084,441,840,399,691,164,527,-48
"15700",NA,NA,"Cambridge, MD","Micropolitan Statistical Area",2004,30854,389,33,387,354,388,8,380,-32
"15700",NA,24019,"Dorchester County, MD","County or equivalent",2004,30854,389,33,387,354,388,8,380,-32
"15740",NA,NA,"Cambridge, OH","Micropolitan Statistical Area",2004,40859,-191,77,520,443,-237,6,-243,-31
"15740",NA,39059,"Guernsey County, OH","County or equivalent",2004,40859,-191,77,520,443,-237,6,-243,-31
"15780",NA,NA,"Camden, AR","Micropolitan Statistical Area",2004,32360,-522,-47,387,434,-443,13,-456,-32
"15780",NA,5013,"Calhoun County, AR","County or equivalent",2004,5483,-80,5,66,61,-80,5,-85,-5
"15780",NA,5103,"Ouachita County, AR","County or equivalent",2004,26877,-442,-52,321,373,-363,8,-371,-27
"15820",NA,NA,"Campbellsville, KY","Micropolitan Statistical Area",2004,23433,121,37,279,242,101,5,96,-17
"15820",NA,21217,"Taylor County, KY","County or equivalent",2004,23433,121,37,279,242,101,5,96,-17
"15860",NA,NA,"Canon City, CO","Micropolitan Statistical Area",2004,46873,-247,-99,402,501,-112,22,-134,-36
"15860",NA,8043,"Fremont County, CO","County or equivalent",2004,46873,-247,-99,402,501,-112,22,-134,-36
"15900",NA,NA,"Canton, IL","Micropolitan Statistical Area",2004,37381,-140,-67,408,475,-45,2,-47,-28
"15900",NA,17057,"Fulton County, IL","County or equivalent",2004,37381,-140,-67,408,475,-45,2,-47,-28
"16020",NA,NA,"Cape Girardeau-Jackson, MO-IL","Micropolitan Statistical Area",2004,91719,678,215,1205,990,542,45,497,-79
"16020",NA,17003,"Alexander County, IL","County or equivalent",2004,8941,-99,-18,137,155,-71,0,-71,-10
"16020",NA,29017,"Bollinger County, MO","County or equivalent",2004,12178,-35,-9,135,144,-18,2,-20,-8
"16020",NA,29031,"Cape Girardeau County, MO","County or equivalent",2004,70600,812,242,933,691,631,43,588,-61
"16060",NA,NA,"Carbondale, IL","Micropolitan Statistical Area",2004,58691,-45,205,698,493,-201,218,-419,-49
"16060",NA,17077,"Jackson County, IL","County or equivalent",2004,58691,-45,205,698,493,-201,218,-419,-49
"16100",NA,NA,"Carlsbad-Artesia, NM","Micropolitan Statistical Area",2004,50803,103,199,739,540,-62,37,-99,-34
"16100",NA,35015,"Eddy County, NM","County or equivalent",2004,50803,103,199,739,540,-62,37,-99,-34
"16260",NA,NA,"Cedar City, UT","Micropolitan Statistical Area",2004,37056,979,627,811,184,385,56,329,-33
"16260",NA,49021,"Iron County, UT","County or equivalent",2004,37056,979,627,811,184,385,56,329,-33
"16340",NA,NA,"Cedartown, GA","Micropolitan Statistical Area",2004,39875,313,186,683,497,154,111,43,-27
"16340",NA,13233,"Polk County, GA","County or equivalent",2004,39875,313,186,683,497,154,111,43,-27
"16380",NA,NA,"Celina, OH","Micropolitan Statistical Area",2004,40732,17,184,566,382,-137,8,-145,-30
"16380",NA,39107,"Mercer County, OH","County or equivalent",2004,40732,17,184,566,382,-137,8,-145,-30
"16420",NA,NA,"Central City, KY","Micropolitan Statistical Area",2004,31445,-18,-13,367,380,15,2,13,-20
"16420",NA,21177,"Muhlenberg County, KY","County or equivalent",2004,31445,-18,-13,367,380,15,2,13,-20
"16460",NA,NA,"Centralia, IL","Micropolitan Statistical Area",2004,40047,-415,-58,452,510,-320,3,-323,-37
"16460",NA,17121,"Marion County, IL","County or equivalent",2004,40047,-415,-58,452,510,-320,3,-323,-37
"16500",NA,NA,"Centralia, WA","Micropolitan Statistical Area",2004,70673,561,12,855,843,605,92,513,-56
"16500",NA,53041,"Lewis County, WA","County or equivalent",2004,70673,561,12,855,843,605,92,513,-56
"16540",NA,NA,"Chambersburg, PA","Micropolitan Statistical Area",2004,134185,1805,271,1662,1391,1668,112,1556,-134
"16540",NA,42055,"Franklin County, PA","County or equivalent",2004,134185,1805,271,1662,1391,1668,112,1556,-134
"16660",NA,NA,"Charleston-Mattoon, IL","Micropolitan Statistical Area",2004,63323,40,46,697,651,31,32,-1,-37
"16660",NA,17029,"Coles County, IL","County or equivalent",2004,52420,55,59,577,518,27,31,-4,-31
"16660",NA,17035,"Cumberland County, IL","County or equivalent",2004,10903,-15,-13,120,133,4,1,3,-6
"16900",NA,NA,"Chester, SC","Micropolitan Statistical Area",2004,33237,-364,46,410,364,-377,12,-389,-33
"16900",NA,45023,"Chester County, SC","County or equivalent",2004,33237,-364,46,410,364,-377,12,-389,-33
"17060",NA,NA,"Chillicothe, OH","Micropolitan Statistical Area",2004,74328,23,111,861,750,-38,19,-57,-50
"17060",NA,39141,"Ross County, OH","County or equivalent",2004,74328,23,111,861,750,-38,19,-57,-50
"17180",NA,NA,"City of The Dalles, OR","Micropolitan Statistical Area",2004,23393,-167,-6,259,265,-140,27,-167,-21
"17180",NA,41065,"Wasco County, OR","County or equivalent",2004,23393,-167,-6,259,265,-140,27,-167,-21
"17200",NA,NA,"Claremont, NH","Micropolitan Statistical Area",2004,42073,344,154,519,365,224,17,207,-34
"17200",NA,33019,"Sullivan County, NH","County or equivalent",2004,42073,344,154,519,365,224,17,207,-34
"17220",NA,NA,"Clarksburg, WV","Micropolitan Statistical Area",2004,91230,94,-91,1058,1149,258,31,227,-73
"17220",NA,54017,"Doddridge County, WV","County or equivalent",2004,7265,-173,-16,75,91,-147,0,-147,-10
"17220",NA,54033,"Harrison County, WV","County or equivalent",2004,67960,246,-60,825,885,359,29,330,-53
"17220",NA,54091,"Taylor County, WV","County or equivalent",2004,16005,21,-15,158,173,46,2,44,-10
"17260",NA,NA,"Clarksdale, MS","Micropolitan Statistical Area",2004,28812,-469,209,546,337,-641,13,-654,-37
"17260",NA,28027,"Coahoma County, MS","County or equivalent",2004,28812,-469,209,546,337,-641,13,-654,-37
"17340",NA,NA,"Clearlake, CA","Micropolitan Statistical Area",2004,63376,697,-188,667,855,960,86,874,-75
"17340",NA,6033,"Lake County, CA","County or equivalent",2004,63376,697,-188,667,855,960,86,874,-75
"17380",NA,NA,"Cleveland, MS","Micropolitan Statistical Area",2004,38274,-556,211,631,420,-722,7,-729,-45
"17380",NA,28011,"Bolivar County, MS","County or equivalent",2004,38274,-556,211,631,420,-722,7,-729,-45
"17500",NA,NA,"Clewiston, FL","Micropolitan Statistical Area",2004,37090,741,368,681,313,400,330,70,-27
"17500",NA,12051,"Hendry County, FL","County or equivalent",2004,37090,741,368,681,313,400,330,70,-27
"17540",NA,NA,"Clinton, IA","Micropolitan Statistical Area",2004,49358,-113,14,565,551,-93,29,-122,-34
"17540",NA,19045,"Clinton County, IA","County or equivalent",2004,49358,-113,14,565,551,-93,29,-122,-34
"17580",NA,NA,"Clovis, NM","Micropolitan Statistical Area",2004,45733,774,527,891,364,277,241,36,-30
"17580",NA,35009,"Curry County, NM","County or equivalent",2004,45733,774,527,891,364,277,241,36,-30
"17700",NA,NA,"Coffeyville, KS","Micropolitan Statistical Area",2004,34520,-146,-46,453,499,-74,21,-95,-26
"17700",NA,20125,"Montgomery County, KS","County or equivalent",2004,34520,-146,-46,453,499,-74,21,-95,-26
"17740",NA,NA,"Coldwater, MI","Micropolitan Statistical Area",2004,46477,43,203,624,421,-125,62,-187,-35
"17740",NA,26023,"Branch County, MI","County or equivalent",2004,46477,43,203,624,421,-125,62,-187,-35
"17940",NA,NA,"Columbia, TN","Micropolitan Statistical Area",2004,74092,1436,308,1026,718,1208,92,1116,-80
"17940",NA,47119,"Maury County, TN","County or equivalent",2004,74092,1436,308,1026,718,1208,92,1116,-80
"18060",NA,NA,"Columbus, MS","Micropolitan Statistical Area",2004,59930,-285,373,925,552,-600,105,-705,-58
"18060",NA,28087,"Lowndes County, MS","County or equivalent",2004,59930,-285,373,925,552,-600,105,-705,-58
"18100",NA,NA,"Columbus, NE","Micropolitan Statistical Area",2004,30868,-44,204,449,245,-222,49,-271,-26
"18100",NA,31141,"Platte County, NE","County or equivalent",2004,30868,-44,204,449,245,-222,49,-271,-26
"18180",NA,NA,"Concord, NH","Micropolitan Statistical Area",2004,144679,1476,333,1563,1230,1259,132,1127,-116
"18180",NA,33013,"Merrimack County, NH","County or equivalent",2004,144679,1476,333,1563,1230,1259,132,1127,-116
"18220",NA,NA,"Connersville, IN","Micropolitan Statistical Area",2004,24756,-129,19,326,307,-129,3,-132,-19
"18220",NA,18041,"Fayette County, IN","County or equivalent",2004,24756,-129,19,326,307,-129,3,-132,-19
"18260",NA,NA,"Cookeville, TN","Micropolitan Statistical Area",2004,97372,1273,253,1283,1030,1113,131,982,-93
"18260",NA,47087,"Jackson County, TN","County or equivalent",2004,11066,-9,-10,126,136,9,2,7,-8
"18260",NA,47133,"Overton County, TN","County or equivalent",2004,20365,301,13,259,246,311,1,310,-23
"18260",NA,47141,"Putnam County, TN","County or equivalent",2004,65941,981,250,898,648,793,128,665,-62
"18300",NA,NA,"Coos Bay, OR","Micropolitan Statistical Area",2004,63087,544,-244,612,856,849,48,801,-61
"18300",NA,41011,"Coos County, OR","County or equivalent",2004,63087,544,-244,612,856,849,48,801,-61
"18340",NA,NA,"Corbin, KY","Micropolitan Statistical Area",2004,37332,351,-22,486,508,407,7,400,-34
"18340",NA,21235,"Whitley County, KY","County or equivalent",2004,37332,351,-22,486,508,407,7,400,-34
"18380",NA,NA,"Cordele, GA","Micropolitan Statistical Area",2004,21754,19,81,330,249,-45,29,-74,-17
"18380",NA,13081,"Crisp County, GA","County or equivalent",2004,21754,19,81,330,249,-45,29,-74,-17
"18420",NA,NA,"Corinth, MS","Micropolitan Statistical Area",2004,34933,241,30,425,395,241,16,225,-30
"18420",NA,28003,"Alcorn County, MS","County or equivalent",2004,34933,241,30,425,395,241,16,225,-30
"18460",NA,NA,"Cornelia, GA","Micropolitan Statistical Area",2004,38660,477,282,599,317,224,107,117,-29
"18460",NA,13137,"Habersham County, GA","County or equivalent",2004,38660,477,282,599,317,224,107,117,-29
"18500",NA,NA,"Corning, NY","Micropolitan Statistical Area",2004,97775,-502,97,1098,1001,-520,44,-564,-79
"18500",NA,36101,"Steuben County, NY","County or equivalent",2004,97775,-502,97,1098,1001,-520,44,-564,-79
"18620",NA,NA,"Corsicana, TX","Micropolitan Statistical Area",2004,47710,660,114,636,522,587,195,392,-41
"18620",NA,48349,"Navarro County, TX","County or equivalent",2004,47710,660,114,636,522,587,195,392,-41
"18660",NA,NA,"Cortland, NY","Micropolitan Statistical Area",2004,48816,-9,111,529,418,-87,30,-117,-33
"18660",NA,36023,"Cortland County, NY","County or equivalent",2004,48816,-9,111,529,418,-87,30,-117,-33
"18740",NA,NA,"Coshocton, OH","Micropolitan Statistical Area",2004,36846,4,86,479,393,-56,24,-80,-26
"18740",NA,39031,"Coshocton County, OH","County or equivalent",2004,36846,4,86,479,393,-56,24,-80,-26
"18820",NA,NA,"Crawfordsville, IN","Micropolitan Statistical Area",2004,37551,84,93,477,384,18,41,-23,-27
"18820",NA,18107,"Montgomery County, IN","County or equivalent",2004,37551,84,93,477,384,18,41,-23,-27
"18860",NA,NA,"Crescent City, CA","Micropolitan Statistical Area",2004,28107,371,8,299,291,391,51,340,-28
"18860",NA,6015,"Del Norte County, CA","County or equivalent",2004,28107,371,8,299,291,391,51,340,-28
"18900",NA,NA,"Crossville, TN","Micropolitan Statistical Area",2004,49894,802,-29,496,525,893,9,884,-62
"18900",NA,47035,"Cumberland County, TN","County or equivalent",2004,49894,802,-29,496,525,893,9,884,-62
"18940",NA,NA,"Crowley, LA","Micropolitan Statistical Area",2004,58633,-114,323,949,626,-387,8,-395,-50
"18940",NA,22001,"Acadia Parish, LA","County or equivalent",2004,58633,-114,323,949,626,-387,8,-395,-50
"18980",NA,NA,"Cullman, AL","Micropolitan Statistical Area",2004,78631,569,108,998,890,524,73,451,-63
"18980",NA,1043,"Cullman County, AL","County or equivalent",2004,78631,569,108,998,890,524,73,451,-63
"19020",NA,NA,"Culpeper, VA","Micropolitan Statistical Area",2004,39687,1559,259,557,298,1366,56,1310,-66
"19020",NA,51047,"Culpeper County, VA","County or equivalent",2004,39687,1559,259,557,298,1366,56,1310,-66
"19220",NA,NA,"Danville, KY","Micropolitan Statistical Area",2004,52608,585,121,658,537,510,48,462,-46
"19220",NA,21021,"Boyle County, KY","County or equivalent",2004,28129,350,22,317,295,355,40,315,-27
"19220",NA,21137,"Lincoln County, KY","County or equivalent",2004,24479,235,99,341,242,155,8,147,-19
"19300",NA,NA,"Daphne-Fairhope-Foley, AL","Micropolitan Statistical Area",2004,156276,4774,293,1846,1553,4530,138,4392,-49
"19300",NA,1003,"Baldwin County, AL","County or equivalent",2004,156276,4774,293,1846,1553,4530,138,4392,-49
"19540",NA,NA,"Decatur, IN","Micropolitan Statistical Area",2004,33734,59,292,602,310,-204,11,-215,-29
"19540",NA,18001,"Adams County, IN","County or equivalent",2004,33734,59,292,602,310,-204,11,-215,-29
"19580",NA,NA,"Defiance, OH","Micropolitan Statistical Area",2004,38754,-170,180,515,335,-313,15,-328,-37
"19580",NA,39039,"Defiance County, OH","County or equivalent",2004,38754,-170,180,515,335,-313,15,-328,-37
"19620",NA,NA,"Del Rio, TX","Micropolitan Statistical Area",2004,46926,634,681,960,279,-6,257,-263,-41
"19620",NA,48465,"Val Verde County, TX","County or equivalent",2004,46926,634,681,960,279,-6,257,-263,-41
"19700",NA,NA,"Deming, NM","Micropolitan Statistical Area",2004,25561,224,144,417,273,97,124,-27,-17
"19700",NA,35029,"Luna County, NM","County or equivalent",2004,25561,224,144,417,273,97,124,-27,-17
"19760",NA,NA,"De Ridder, LA","Micropolitan Statistical Area",2004,33711,394,110,442,332,317,15,302,-33
"19760",NA,22011,"Beauregard Parish, LA","County or equivalent",2004,33711,394,110,442,332,317,15,302,-33
"19860",NA,NA,"Dickinson, ND","Micropolitan Statistical Area",2004,22900,-23,65,281,216,-71,15,-86,-17
"19860",NA,38007,"Billings County, ND","County or equivalent",2004,805,-25,-2,3,5,-22,1,-23,-1
"19860",NA,38089,"Stark County, ND","County or equivalent",2004,22095,2,67,278,211,-49,14,-63,-16
"19900",NA,NA,"Dillon, SC","Micropolitan Statistical Area",2004,30803,39,87,466,379,-28,16,-44,-20
"19900",NA,45033,"Dillon County, SC","County or equivalent",2004,30803,39,87,466,379,-28,16,-44,-20
"19940",NA,NA,"Dixon, IL","Micropolitan Statistical Area",2004,35086,-19,26,382,356,-22,14,-36,-23
"19940",NA,17103,"Lee County, IL","County or equivalent",2004,35086,-19,26,382,356,-22,14,-36,-23
"19980",NA,NA,"Dodge City, KS","Micropolitan Statistical Area",2004,32654,96,409,667,258,-271,333,-604,-42
"19980",NA,20057,"Ford County, KS","County or equivalent",2004,32654,96,409,667,258,-271,333,-604,-42
"20060",NA,NA,"Douglas, GA","Micropolitan Statistical Area",2004,46669,35,361,778,417,-283,143,-426,-43
"20060",NA,13003,"Atkinson County, GA","County or equivalent",2004,7872,-40,74,149,75,-104,37,-141,-10
"20060",NA,13069,"Coffee County, GA","County or equivalent",2004,38797,75,287,629,342,-179,106,-285,-33
"20140",NA,NA,"Dublin, GA","Micropolitan Statistical Area",2004,55264,154,169,791,622,25,33,-8,-40
"20140",NA,13167,"Johnson County, GA","County or equivalent",2004,9031,123,14,113,99,118,2,116,-9
"20140",NA,13175,"Laurens County, GA","County or equivalent",2004,46233,31,155,678,523,-93,31,-124,-31
"20180",NA,NA,"DuBois, PA","Micropolitan Statistical Area",2004,82187,-311,-87,827,914,-166,14,-180,-58
"20180",NA,42033,"Clearfield County, PA","County or equivalent",2004,82187,-311,-87,827,914,-166,14,-180,-58
"20300",NA,NA,"Dumas, TX","Micropolitan Statistical Area",2004,20001,71,299,418,119,-206,114,-320,-22
"20300",NA,48341,"Moore County, TX","County or equivalent",2004,20001,71,299,418,119,-206,114,-320,-22
"20340",NA,NA,"Duncan, OK","Micropolitan Statistical Area",2004,42456,194,-40,550,590,273,4,269,-39
"20340",NA,40137,"Stephens County, OK","County or equivalent",2004,42456,194,-40,550,590,273,4,269,-39
"20380",NA,NA,"Dunn, NC","Micropolitan Statistical Area",2004,100273,1938,631,1422,791,1404,384,1020,-97
"20380",NA,37085,"Harnett County, NC","County or equivalent",2004,100273,1938,631,1422,791,1404,384,1020,-97
"20420",NA,NA,"Durango, CO","Micropolitan Statistical Area",2004,46909,656,247,517,270,450,30,420,-41
"20420",NA,8067,"La Plata County, CO","County or equivalent",2004,46909,656,247,517,270,450,30,420,-41
"20460",NA,NA,"Durant, OK","Micropolitan Statistical Area",2004,37359,494,-14,482,496,550,38,512,-42
"20460",NA,40013,"Bryan County, OK","County or equivalent",2004,37359,494,-14,482,496,550,38,512,-42
"20540",NA,NA,"Dyersburg, TN","Micropolitan Statistical Area",2004,37269,121,65,511,446,81,27,54,-25
"20540",NA,47045,"Dyer County, TN","County or equivalent",2004,37269,121,65,511,446,81,27,54,-25
"20580",NA,NA,"Eagle Pass, TX","Micropolitan Statistical Area",2004,49569,505,789,1053,264,-237,237,-474,-47
"20580",NA,48323,"Maverick County, TX","County or equivalent",2004,49569,505,789,1053,264,-237,237,-474,-47
"20620",NA,NA,"East Liverpool-Salem, OH","Micropolitan Statistical Area",2004,110429,-415,72,1255,1183,-402,17,-419,-85
"20620",NA,39029,"Columbiana County, OH","County or equivalent",2004,110429,-415,72,1255,1183,-402,17,-419,-85
"20660",NA,NA,"Easton, MD","Micropolitan Statistical Area",2004,35163,624,6,379,373,659,28,631,-41
"20660",NA,24041,"Talbot County, MD","County or equivalent",2004,35163,624,6,379,373,659,28,631,-41
"20700",NA,NA,"East Stroudsburg, PA","Micropolitan Statistical Area",2004,156659,3734,358,1533,1175,3593,113,3480,-217
"20700",NA,42089,"Monroe County, PA","County or equivalent",2004,156659,3734,358,1533,1175,3593,113,3480,-217
"20780",NA,NA,"Edwards, CO","Micropolitan Statistical Area",2004,54067,1056,786,909,123,309,546,-237,-39
"20780",NA,8037,"Eagle County, CO","County or equivalent",2004,46417,1051,707,793,86,374,466,-92,-30
"20780",NA,8065,"Lake County, CO","County or equivalent",2004,7650,5,79,116,37,-65,80,-145,-9
"20820",NA,NA,"Effingham, IL","Micropolitan Statistical Area",2004,34535,106,152,473,321,-22,12,-34,-24
"20820",NA,17049,"Effingham County, IL","County or equivalent",2004,34535,106,152,473,321,-22,12,-34,-24
"20900",NA,NA,"El Campo, TX","Micropolitan Statistical Area",2004,40901,-59,193,647,454,-218,97,-315,-34
"20900",NA,48481,"Wharton County, TX","County or equivalent",2004,40901,-59,193,647,454,-218,97,-315,-34
"20980",NA,NA,"El Dorado, AR","Micropolitan Statistical Area",2004,44159,-446,21,571,550,-426,28,-454,-41
"20980",NA,5139,"Union County, AR","County or equivalent",2004,44159,-446,21,571,550,-426,28,-454,-41
"21020",NA,NA,"Elizabeth City, NC","Micropolitan Statistical Area",2004,56848,1441,129,721,592,1394,71,1323,-82
"21020",NA,37029,"Camden County, NC","County or equivalent",2004,8348,494,18,92,74,500,6,494,-24
"21020",NA,37139,"Pasquotank County, NC","County or equivalent",2004,36924,893,136,504,368,804,60,744,-47
"21020",NA,37143,"Perquimans County, NC","County or equivalent",2004,11576,54,-25,125,150,90,5,85,-11
"21120",NA,NA,"Elk City, OK","Micropolitan Statistical Area",2004,18159,-1043,51,280,229,-1051,7,-1058,-43
"21120",NA,40009,"Beckham County, OK","County or equivalent",2004,18159,-1043,51,280,229,-1051,7,-1058,-43
"21220",NA,NA,"Elko, NV","Micropolitan Statistical Area",2004,44948,27,368,658,290,-302,123,-425,-39
"21220",NA,32007,"Elko County, NV","County or equivalent",2004,43547,79,361,638,277,-245,118,-363,-37
"21220",NA,32011,"Eureka County, NV","County or equivalent",2004,1401,-52,7,20,13,-57,5,-62,-2
"21260",NA,NA,"Ellensburg, WA","Micropolitan Statistical Area",2004,36506,1107,101,351,250,1061,57,1004,-55
"21260",NA,53037,"Kittitas County, WA","County or equivalent",2004,36506,1107,101,351,250,1061,57,1004,-55
"21380",NA,NA,"Emporia, KS","Micropolitan Statistical Area",2004,38918,201,241,553,312,-5,151,-156,-35
"21380",NA,20017,"Chase County, KS","County or equivalent",2004,3017,56,1,32,31,59,2,57,-4
"21380",NA,20111,"Lyon County, KS","County or equivalent",2004,35901,145,240,521,281,-64,149,-213,-31
"21420",NA,NA,"Enid, OK","Micropolitan Statistical Area",2004,57182,26,149,879,730,-78,119,-197,-45
"21420",NA,40047,"Garfield County, OK","County or equivalent",2004,57182,26,149,879,730,-78,119,-197,-45
"21460",NA,NA,"Enterprise-Ozark, AL","Micropolitan Statistical Area",2004,93327,140,348,1309,961,-111,309,-420,-97
"21460",NA,1031,"Coffee County, AL","County or equivalent",2004,44694,517,68,565,497,491,114,377,-42
"21460",NA,1045,"Dale County, AL","County or equivalent",2004,48633,-377,280,744,464,-602,195,-797,-55
"21540",NA,NA,"Escanaba, MI","Micropolitan Statistical Area",2004,38011,-59,-2,400,402,-30,7,-37,-27
"21540",NA,26041,"Delta County, MI","County or equivalent",2004,38011,-59,-2,400,402,-30,7,-37,-27
"21580",NA,NA,"Espanola, NM","Micropolitan Statistical Area",2004,40574,-33,368,716,348,-363,65,-428,-38
"21580",NA,35039,"Rio Arriba County, NM","County or equivalent",2004,40574,-33,368,716,348,-363,65,-428,-38
"21640",NA,NA,"Eufaula, AL-GA","Micropolitan Statistical Area",2004,31918,-47,14,340,326,-246,35,-281,185
"21640",NA,1005,"Barbour County, AL","County or equivalent",2004,29402,-39,29,313,284,-255,35,-290,187
"21640",NA,13239,"Quitman County, GA","County or equivalent",2004,2516,-8,-15,27,42,9,0,9,-2
"21700",NA,NA,"Eureka-Arcata-Fortuna, CA","Micropolitan Statistical Area",2004,128703,479,209,1476,1267,356,116,240,-86
"21700",NA,6023,"Humboldt County, CA","County or equivalent",2004,128703,479,209,1476,1267,356,116,240,-86
"21740",NA,NA,"Evanston, WY","Micropolitan Statistical Area",2004,19418,-21,192,317,125,-193,12,-205,-20
"21740",NA,56041,"Uinta County, WY","County or equivalent",2004,19418,-21,192,317,125,-193,12,-205,-20
"21860",NA,NA,"Fairmont, MN","Micropolitan Statistical Area",2004,20842,-146,35,248,213,-160,5,-165,-21
"21860",NA,27091,"Martin County, MN","County or equivalent",2004,20842,-146,35,248,213,-160,5,-165,-21
"21900",NA,NA,"Fairmont, WV","Micropolitan Statistical Area",2004,56201,-65,-130,646,776,104,10,94,-39
"21900",NA,54049,"Marion County, WV","County or equivalent",2004,56201,-65,-130,646,776,104,10,94,-39
"21980",NA,NA,"Fallon, NV","Micropolitan Statistical Area",2004,24094,63,114,335,221,-30,87,-117,-21
"21980",NA,32001,"Churchill County, NV","County or equivalent",2004,24094,63,114,335,221,-30,87,-117,-21
"22060",NA,NA,"Faribault-Northfield, MN","Micropolitan Statistical Area",2004,59888,689,293,739,446,443,120,323,-47
"22060",NA,27131,"Rice County, MN","County or equivalent",2004,59888,689,293,739,446,443,120,323,-47
"22100",NA,NA,"Farmington, MO","Micropolitan Statistical Area",2004,60318,2632,64,751,687,2692,19,2673,-124
"22100",NA,29187,"St. Francois County, MO","County or equivalent",2004,60318,2632,64,751,687,2692,19,2673,-124
"22260",NA,NA,"Fergus Falls, MN","Micropolitan Statistical Area",2004,57290,-42,-50,614,664,49,59,-10,-41
"22260",NA,27111,"Otter Tail County, MN","County or equivalent",2004,57290,-42,-50,614,664,49,59,-10,-41
"22280",NA,NA,"Fernley, NV","Micropolitan Statistical Area",2004,42835,2951,108,541,433,2958,44,2914,-115
"22280",NA,32019,"Lyon County, NV","County or equivalent",2004,42835,2951,108,541,433,2958,44,2914,-115
"22300",NA,NA,"Findlay, OH","Micropolitan Statistical Area",2004,73278,364,288,953,665,124,69,55,-48
"22300",NA,39063,"Hancock County, OH","County or equivalent",2004,73278,364,288,953,665,124,69,55,-48
"22340",NA,NA,"Fitzgerald, GA","Micropolitan Statistical Area",2004,26750,-307,66,401,335,-346,41,-387,-27
"22340",NA,13017,"Ben Hill County, GA","County or equivalent",2004,17055,7,49,274,225,-30,26,-56,-12
"22340",NA,13155,"Irwin County, GA","County or equivalent",2004,9695,-314,17,127,110,-316,15,-331,-15
"22580",NA,NA,"Forest City, NC","Micropolitan Statistical Area",2004,62835,-214,34,790,756,-200,24,-224,-48
"22580",NA,37161,"Rutherford County, NC","County or equivalent",2004,62835,-214,34,790,756,-200,24,-224,-48
"22620",NA,NA,"Forrest City, AR","Micropolitan Statistical Area",2004,27938,-521,133,419,286,-618,0,-618,-36
"22620",NA,5123,"St. Francis County, AR","County or equivalent",2004,27938,-521,133,419,286,-618,0,-618,-36
"22700",NA,NA,"Fort Dodge, IA","Micropolitan Statistical Area",2004,38932,-436,66,521,455,-465,24,-489,-37
"22700",NA,19187,"Webster County, IA","County or equivalent",2004,38932,-436,66,521,455,-465,24,-489,-37
"22780",NA,NA,"Fort Leonard Wood, MO","Micropolitan Statistical Area",2004,44054,-493,345,635,290,-768,636,-1404,-70
"22780",NA,29169,"Pulaski County, MO","County or equivalent",2004,44054,-493,345,635,290,-768,636,-1404,-70
"22800",NA,NA,"Fort Madison-Keokuk, IA-MO","Micropolitan Statistical Area",2004,43626,-122,-72,465,537,-22,17,-39,-28
"22800",NA,19111,"Lee County, IA","County or equivalent",2004,36394,-79,-66,381,447,10,17,-7,-23
"22800",NA,29045,"Clark County, MO","County or equivalent",2004,7232,-43,-6,84,90,-32,0,-32,-5
"22820",NA,NA,"Fort Morgan, CO","Micropolitan Statistical Area",2004,27673,3,192,417,225,-161,143,-304,-28
"22820",NA,8087,"Morgan County, CO","County or equivalent",2004,27673,3,192,417,225,-161,143,-304,-28
"22840",NA,NA,"Fort Payne, AL","Micropolitan Statistical Area",2004,66393,507,296,1002,706,257,141,116,-46
"22840",NA,1049,"DeKalb County, AL","County or equivalent",2004,66393,507,296,1002,706,257,141,116,-46
"22860",NA,NA,"Fort Polk South, LA","Micropolitan Statistical Area",2004,50193,-925,518,890,372,-1353,524,-1877,-90
"22860",NA,22115,"Vernon Parish, LA","County or equivalent",2004,50193,-925,518,890,372,-1353,524,-1877,-90
"22980",NA,NA,"Fort Valley, GA","Micropolitan Statistical Area",2004,24581,161,108,325,217,70,57,13,-17
"22980",NA,13225,"Peach County, GA","County or equivalent",2004,24581,161,108,325,217,70,57,13,-17
"23140",NA,NA,"Frankfort, IN","Micropolitan Statistical Area",2004,33720,43,141,504,363,-68,133,-201,-30
"23140",NA,18023,"Clinton County, IN","County or equivalent",2004,33720,43,141,504,363,-68,133,-201,-30
"23180",NA,NA,"Frankfort, KY","Micropolitan Statistical Area",2004,68236,511,260,866,606,300,64,236,-49
"23180",NA,21005,"Anderson County, KY","County or equivalent",2004,19900,249,107,253,146,160,7,153,-18
"23180",NA,21073,"Franklin County, KY","County or equivalent",2004,48336,262,153,613,460,140,57,83,-31
"23240",NA,NA,"Fredericksburg, TX","Micropolitan Statistical Area",2004,22327,274,-21,247,268,318,28,290,-23
"23240",NA,48171,"Gillespie County, TX","County or equivalent",2004,22327,274,-21,247,268,318,28,290,-23
"23300",NA,NA,"Freeport, IL","Micropolitan Statistical Area",2004,47846,-160,64,557,493,-184,54,-238,-40
"23300",NA,17177,"Stephenson County, IL","County or equivalent",2004,47846,-160,64,557,493,-184,54,-238,-40
"23340",NA,NA,"Fremont, NE","Micropolitan Statistical Area",2004,35786,-29,105,532,427,-104,27,-131,-30
"23340",NA,31053,"Dodge County, NE","County or equivalent",2004,35786,-29,105,532,427,-104,27,-131,-30
"23380",NA,NA,"Fremont, OH","Micropolitan Statistical Area",2004,61431,33,138,794,656,-67,14,-81,-38
"23380",NA,39143,"Sandusky County, OH","County or equivalent",2004,61431,33,138,794,656,-67,14,-81,-38
"23500",NA,NA,"Gaffney, SC","Micropolitan Statistical Area",2004,53410,160,103,701,598,92,24,68,-35
"23500",NA,45021,"Cherokee County, SC","County or equivalent",2004,53410,160,103,701,598,92,24,68,-35
"23620",NA,NA,"Gainesville, TX","Micropolitan Statistical Area",2004,37914,232,122,524,402,137,100,37,-27
"23620",NA,48097,"Cooke County, TX","County or equivalent",2004,37914,232,122,524,402,137,100,37,-27
"23660",NA,NA,"Galesburg, IL","Micropolitan Statistical Area",2004,71068,-996,-118,798,916,-807,17,-824,-71
"23660",NA,17095,"Knox County, IL","County or equivalent",2004,53308,-644,-108,608,716,-486,13,-499,-50
"23660",NA,17187,"Warren County, IL","County or equivalent",2004,17760,-352,-10,190,200,-321,4,-325,-21
"23700",NA,NA,"Gallup, NM","Micropolitan Statistical Area",2004,71420,-64,914,1381,467,-906,38,-944,-72
"23700",NA,35031,"McKinley County, NM","County or equivalent",2004,71420,-64,914,1381,467,-906,38,-944,-72
"23780",NA,NA,"Garden City, KS","Micropolitan Statistical Area",2004,40516,499,600,787,187,-460,325,-785,359
"23780",NA,20055,"Finney County, KS","County or equivalent",2004,40516,499,600,787,187,-460,325,-785,359
"23820",NA,NA,"Gardnerville Ranchos, NV","Micropolitan Statistical Area",2004,45549,1639,56,407,351,1648,38,1610,-65
"23820",NA,32005,"Douglas County, NV","County or equivalent",2004,45549,1639,56,407,351,1648,38,1610,-65
"23860",NA,NA,"Georgetown, SC","Micropolitan Statistical Area",2004,59141,786,183,732,549,658,50,608,-55
"23860",NA,45043,"Georgetown County, SC","County or equivalent",2004,59141,786,183,732,549,658,50,608,-55
"23900",NA,NA,"Gettysburg, PA","Micropolitan Statistical Area",2004,97491,1810,181,1055,874,1741,111,1630,-112
"23900",NA,42001,"Adams County, PA","County or equivalent",2004,97491,1810,181,1055,874,1741,111,1630,-112
"23940",NA,NA,"Gillette, WY","Micropolitan Statistical Area",2004,36224,163,391,563,172,-198,11,-209,-30
"23940",NA,56005,"Campbell County, WY","County or equivalent",2004,36224,163,391,563,172,-198,11,-209,-30
"23980",NA,NA,"Glasgow, KY","Micropolitan Statistical Area",2004,49354,423,83,637,554,381,19,362,-41
"23980",NA,21009,"Barren County, KY","County or equivalent",2004,39353,386,96,518,422,323,19,304,-33
"23980",NA,21169,"Metcalfe County, KY","County or equivalent",2004,10001,37,-13,119,132,58,0,58,-8
"24100",NA,NA,"Gloversville, NY","Micropolitan Statistical Area",2004,54967,92,-6,563,569,136,26,110,-38
"24100",NA,36035,"Fulton County, NY","County or equivalent",2004,54967,92,-6,563,569,136,26,110,-38
"24180",NA,NA,"Granbury, TX","Micropolitan Statistical Area",2004,53032,1077,69,602,533,1070,55,1015,-62
"24180",NA,48221,"Hood County, TX","County or equivalent",2004,45720,999,46,515,469,1010,46,964,-57
"24180",NA,48425,"Somervell County, TX","County or equivalent",2004,7312,78,23,87,64,60,9,51,-5
"24260",NA,NA,"Grand Island, NE","Micropolitan Statistical Area",2004,68693,276,423,1082,659,-92,203,-295,-55
"24260",NA,31079,"Hall County, NE","County or equivalent",2004,54193,335,407,920,513,-29,201,-230,-43
"24260",NA,31093,"Howard County, NE","County or equivalent",2004,6547,-27,11,76,65,-33,0,-33,-5
"24260",NA,31121,"Merrick County, NE","County or equivalent",2004,7953,-32,5,86,81,-30,2,-32,-7
"24380",NA,NA,"Grants, NM","Micropolitan Statistical Area",2004,27161,190,222,444,222,-15,11,-26,-17
"24380",NA,35006,"Cibola County, NM","County or equivalent",2004,27161,190,222,444,222,-15,11,-26,-17
"24420",NA,NA,"Grants Pass, OR","Micropolitan Statistical Area",2004,79108,807,-254,822,1076,1147,21,1126,-86
"24420",NA,41033,"Josephine County, OR","County or equivalent",2004,79108,807,-254,822,1076,1147,21,1126,-86
"24460",NA,NA,"Great Bend, KS","Micropolitan Statistical Area",2004,27725,-102,6,330,324,-291,62,-353,183
"24460",NA,20009,"Barton County, KS","County or equivalent",2004,27725,-102,6,330,324,-291,62,-353,183
"24620",NA,NA,"Greeneville, TN","Micropolitan Statistical Area",2004,64103,475,24,731,707,510,40,470,-59
"24620",NA,47059,"Greene County, TN","County or equivalent",2004,64103,475,24,731,707,510,40,470,-59
"24700",NA,NA,"Greensburg, IN","Micropolitan Statistical Area",2004,24932,199,162,398,236,53,29,24,-16
"24700",NA,18031,"Decatur County, IN","County or equivalent",2004,24932,199,162,398,236,53,29,24,-16
"24740",NA,NA,"Greenville, MS","Micropolitan Statistical Area",2004,58207,-937,318,944,626,-1184,21,-1205,-71
"24740",NA,28151,"Washington County, MS","County or equivalent",2004,58207,-937,318,944,626,-1184,21,-1205,-71
"24820",NA,NA,"Greenville, OH","Micropolitan Statistical Area",2004,52808,-65,87,701,614,-113,3,-116,-39
"24820",NA,39037,"Darke County, OH","County or equivalent",2004,52808,-65,87,701,614,-113,3,-116,-39
"24900",NA,NA,"Greenwood, MS","Micropolitan Statistical Area",2004,46170,598,218,697,479,424,17,407,-44
"24900",NA,28015,"Carroll County, MS","County or equivalent",2004,10379,-55,6,108,102,-53,3,-56,-8
"24900",NA,28083,"Leflore County, MS","County or equivalent",2004,35791,653,212,589,377,477,14,463,-36
"24940",NA,NA,"Greenwood, SC","Micropolitan Statistical Area",2004,67188,-43,147,857,710,-139,131,-270,-51
"24940",NA,45047,"Greenwood County, SC","County or equivalent",2004,67188,-43,147,857,710,-139,131,-270,-51
"24980",NA,NA,"Grenada, MS","Micropolitan Statistical Area",2004,22679,-76,-24,297,321,-34,16,-50,-18
"24980",NA,28043,"Grenada County, MS","County or equivalent",2004,22679,-76,-24,297,321,-34,16,-50,-18
"25100",NA,NA,"Guymon, OK","Micropolitan Statistical Area",2004,20057,312,270,399,129,58,184,-126,-16
"25100",NA,40139,"Texas County, OK","County or equivalent",2004,20057,312,270,399,129,58,184,-126,-16
"25220",NA,NA,"Hammond, LA","Micropolitan Statistical Area",2004,104714,1377,624,1639,1015,844,32,812,-91
"25220",NA,22105,"Tangipahoa Parish, LA","County or equivalent",2004,104714,1377,624,1639,1015,844,32,812,-91
"25300",NA,NA,"Hannibal, MO","Micropolitan Statistical Area",2004,37613,-141,19,474,455,-129,6,-135,-31
"25300",NA,29127,"Marion County, MO","County or equivalent",2004,28058,-124,4,366,362,-104,5,-109,-24
"25300",NA,29173,"Ralls County, MO","County or equivalent",2004,9555,-17,15,108,93,-25,1,-26,-7
"25340",NA,NA,"Harriman, TN","Micropolitan Statistical Area",2004,52633,223,-116,511,627,384,20,364,-45
"25340",NA,47145,"Roane County, TN","County or equivalent",2004,52633,223,-116,511,627,384,20,364,-45
"25380",NA,NA,"Harrisburg, IL","Micropolitan Statistical Area",2004,26133,19,-95,319,414,134,7,127,-20
"25380",NA,17165,"Saline County, IL","County or equivalent",2004,26133,19,-95,319,414,134,7,127,-20
"25460",NA,NA,"Harrison, AR","Micropolitan Statistical Area",2004,43263,205,47,516,469,199,9,190,-41
"25460",NA,5009,"Boone County, AR","County or equivalent",2004,34828,330,41,422,381,321,9,312,-32
"25460",NA,5101,"Newton County, AR","County or equivalent",2004,8435,-125,6,94,88,-122,0,-122,-9
"25580",NA,NA,"Hastings, NE","Micropolitan Statistical Area",2004,39304,413,130,494,364,-128,86,-214,411
"25580",NA,31001,"Adams County, NE","County or equivalent",2004,32653,511,138,432,294,-45,83,-128,418
"25580",NA,31035,"Clay County, NE","County or equivalent",2004,6651,-98,-8,62,70,-83,3,-86,-7
"25660",NA,NA,"Havre, MT","Micropolitan Statistical Area",2004,16215,13,115,252,137,-89,1,-90,-13
"25660",NA,30041,"Hill County, MT","County or equivalent",2004,16215,13,115,252,137,-89,1,-90,-13
"25700",NA,NA,"Hays, KS","Micropolitan Statistical Area",2004,27199,-111,95,373,278,-182,28,-210,-24
"25700",NA,20051,"Ellis County, KS","County or equivalent",2004,27199,-111,95,373,278,-182,28,-210,-24
"25720",NA,NA,"Heber, UT","Micropolitan Statistical Area",2004,17843,452,287,392,105,179,32,147,-14
"25720",NA,49051,"Wasatch County, UT","County or equivalent",2004,17843,452,287,392,105,179,32,147,-14
"25740",NA,NA,"Helena, MT","Micropolitan Statistical Area",2004,68281,1103,195,767,572,977,35,942,-69
"25740",NA,30043,"Jefferson County, MT","County or equivalent",2004,10574,262,27,105,78,248,3,245,-13
"25740",NA,30049,"Lewis and Clark County, MT","County or equivalent",2004,57707,841,168,662,494,729,32,697,-56
"25760",NA,NA,"Helena-West Helena, AR","Micropolitan Statistical Area",2004,23624,-468,96,421,325,-534,6,-540,-30
"25760",NA,5107,"Phillips County, AR","County or equivalent",2004,23624,-468,96,421,325,-534,6,-540,-30
"25780",NA,NA,"Henderson, NC","Micropolitan Statistical Area",2004,43045,-180,161,656,495,-300,88,-388,-41
"25780",NA,37181,"Vance County, NC","County or equivalent",2004,43045,-180,161,656,495,-300,88,-388,-41
"25820",NA,NA,"Hereford, TX","Micropolitan Statistical Area",2004,18306,143,191,355,164,-35,47,-82,-13
"25820",NA,48117,"Deaf Smith County, TX","County or equivalent",2004,18306,143,191,355,164,-35,47,-82,-13
"25900",NA,NA,"Hilo, HI","Micropolitan Statistical Area",2004,159865,3738,998,2214,1216,2928,349,2579,-188
"25900",NA,15001,"Hawaii County, HI","County or equivalent",2004,159865,3738,998,2214,1216,2928,349,2579,-188
"25940",NA,NA,"Hilton Head Island-Beaufort, SC","Micropolitan Statistical Area",2004,155502,3873,1321,2536,1215,2708,1085,1623,-156
"25940",NA,45013,"Beaufort County, SC","County or equivalent",2004,134595,3802,1178,2232,1054,2764,1004,1760,-140
"25940",NA,45053,"Jasper County, SC","County or equivalent",2004,20907,71,143,304,161,-56,81,-137,-16
"26020",NA,NA,"Hobbs, NM","Micropolitan Statistical Area",2004,55608,383,505,981,476,-84,75,-159,-38
"26020",NA,35025,"Lea County, NM","County or equivalent",2004,55608,383,505,981,476,-84,75,-159,-38
"26140",NA,NA,"Homosassa Springs, FL","Micropolitan Statistical Area",2004,129162,3445,-1235,915,2150,4926,56,4870,-246
"26140",NA,12017,"Citrus County, FL","County or equivalent",2004,129162,3445,-1235,915,2150,4926,56,4870,-246
"26220",NA,NA,"Hood River, OR","Micropolitan Statistical Area",2004,20812,208,107,299,192,114,86,28,-13
"26220",NA,41027,"Hood River County, OR","County or equivalent",2004,20812,208,107,299,192,114,86,28,-13
"26260",NA,NA,"Hope, AR","Micropolitan Statistical Area",2004,32620,-157,47,420,373,-177,101,-278,-27
"26260",NA,5057,"Hempstead County, AR","County or equivalent",2004,23037,-105,23,274,251,-109,92,-201,-19
"26260",NA,5099,"Nevada County, AR","County or equivalent",2004,9583,-52,24,146,122,-68,9,-77,-8
"26340",NA,NA,"Houghton, MI","Micropolitan Statistical Area",2004,37800,195,38,424,386,188,49,139,-31
"26340",NA,26061,"Houghton County, MI","County or equivalent",2004,35629,248,45,408,363,232,49,183,-29
"26340",NA,26083,"Keweenaw County, MI","County or equivalent",2004,2171,-53,-7,16,23,-44,0,-44,-2
"26460",NA,NA,"Hudson, NY","Micropolitan Statistical Area",2004,62962,160,-98,609,707,307,52,255,-49
"26460",NA,36021,"Columbia County, NY","County or equivalent",2004,62962,160,-98,609,707,307,52,255,-49
"26480",NA,NA,"Humboldt, TN","Micropolitan Statistical Area",2004,47786,100,-86,611,697,222,16,206,-36
"26480",NA,47053,"Gibson County, TN","County or equivalent",2004,47786,100,-86,611,697,222,16,206,-36
"26500",NA,NA,"Huntingdon, PA","Micropolitan Statistical Area",2004,45623,-54,-60,383,443,36,2,34,-30
"26500",NA,42061,"Huntingdon County, PA","County or equivalent",2004,45623,-54,-60,383,443,36,2,34,-30
"26540",NA,NA,"Huntington, IN","Micropolitan Statistical Area",2004,38048,-22,83,448,365,-73,10,-83,-32
"26540",NA,18069,"Huntington County, IN","County or equivalent",2004,38048,-22,83,448,365,-73,10,-83,-32
"26660",NA,NA,"Huntsville, TX","Micropolitan Statistical Area",2004,63447,687,167,612,445,574,88,486,-54
"26660",NA,48471,"Walker County, TX","County or equivalent",2004,63447,687,167,612,445,574,88,486,-54
"26700",NA,NA,"Huron, SD","Micropolitan Statistical Area",2004,15913,-236,11,194,183,-229,6,-235,-18
"26700",NA,46005,"Beadle County, SD","County or equivalent",2004,15913,-236,11,194,183,-229,6,-235,-18
"26740",NA,NA,"Hutchinson, KS","Micropolitan Statistical Area",2004,63366,-299,207,833,626,-451,41,-492,-55
"26740",NA,20155,"Reno County, KS","County or equivalent",2004,63366,-299,207,833,626,-451,41,-492,-55
"26780",NA,NA,"Hutchinson, MN","Micropolitan Statistical Area",2004,35975,402,247,538,291,181,22,159,-26
"26780",NA,27085,"McLeod County, MN","County or equivalent",2004,35975,402,247,538,291,181,22,159,-26
"26860",NA,NA,"Indiana, PA","Micropolitan Statistical Area",2004,88431,-461,25,911,886,-416,43,-459,-70
"26860",NA,42063,"Indiana County, PA","County or equivalent",2004,88431,-461,25,911,886,-416,43,-459,-70
"26940",NA,NA,"Indianola, MS","Micropolitan Statistical Area",2004,32084,-1121,145,470,325,-1210,16,-1226,-56
"26940",NA,28133,"Sunflower County, MS","County or equivalent",2004,32084,-1121,145,470,325,-1210,16,-1226,-56
"27020",NA,NA,"Iron Mountain, MI-WI","Micropolitan Statistical Area",2004,32288,258,-29,321,350,313,5,308,-26
"27020",NA,26043,"Dickinson County, MI","County or equivalent",2004,27355,321,-19,286,305,362,5,357,-22
"27020",NA,55037,"Florence County, WI","County or equivalent",2004,4933,-63,-10,35,45,-49,0,-49,-4
"27220",NA,NA,"Jackson, WY-ID","Micropolitan Statistical Area",2004,26331,509,267,368,101,264,109,155,-22
"27220",NA,16081,"Teton County, ID","County or equivalent",2004,7147,177,121,143,22,62,33,29,-6
"27220",NA,56039,"Teton County, WY","County or equivalent",2004,19184,332,146,225,79,202,76,126,-16
"27300",NA,NA,"Jacksonville, IL","Micropolitan Statistical Area",2004,41365,-35,50,505,455,-56,13,-69,-29
"27300",NA,17137,"Morgan County, IL","County or equivalent",2004,35995,25,32,430,398,17,13,4,-24
"27300",NA,17171,"Scott County, IL","County or equivalent",2004,5370,-60,18,75,57,-73,0,-73,-5
"27380",NA,NA,"Jacksonville, TX","Micropolitan Statistical Area",2004,47401,266,203,735,532,95,149,-54,-32
"27380",NA,48073,"Cherokee County, TX","County or equivalent",2004,47401,266,203,735,532,95,149,-54,-32
"27420",NA,NA,"Jamestown, ND","Micropolitan Statistical Area",2004,20885,-237,-34,190,224,-186,6,-192,-17
"27420",NA,38093,"Stutsman County, ND","County or equivalent",2004,20885,-237,-34,190,224,-186,6,-192,-17
"27460",NA,NA,"Jamestown-Dunkirk-Fredonia, NY","Micropolitan Statistical Area",2004,136338,-607,39,1468,1429,-541,72,-613,-105
"27460",NA,36013,"Chautauqua County, NY","County or equivalent",2004,136338,-607,39,1468,1429,-541,72,-613,-105
"27540",NA,NA,"Jasper, IN","Micropolitan Statistical Area",2004,53253,352,203,698,495,186,45,141,-37
"27540",NA,18037,"Dubois County, IN","County or equivalent",2004,40483,340,195,545,350,174,44,130,-29
"27540",NA,18125,"Pike County, IN","County or equivalent",2004,12770,12,8,153,145,12,1,11,-8
"27660",NA,NA,"Jennings, LA","Micropolitan Statistical Area",2004,30825,-49,141,450,309,-166,6,-172,-24
"27660",NA,22053,"Jefferson Davis Parish, LA","County or equivalent",2004,30825,-49,141,450,309,-166,6,-172,-24
"27700",NA,NA,"Jesup, GA","Micropolitan Statistical Area",2004,27997,314,90,396,306,249,21,228,-25
"27700",NA,13305,"Wayne County, GA","County or equivalent",2004,27997,314,90,396,306,249,21,228,-25
"27940",NA,NA,"Juneau, AK","Micropolitan Statistical Area",2004,30957,79,249,382,133,-145,48,-193,-25
"27940",NA,2110,"Juneau City and Borough, AK","County or equivalent",2004,30957,79,249,382,133,-145,48,-193,-25
"27980",NA,NA,"Kahului-Wailuku, HI","Micropolitan Statistical Area",2004,136732,2194,1014,1876,862,1296,435,861,-116
"27980",NA,15009,"Maui County, HI","County or equivalent",2004,136732,2194,1014,1876,862,1296,435,861,-116
"28060",NA,NA,"Kalispell, MT","Micropolitan Statistical Area",2004,80626,1474,213,992,779,1352,33,1319,-91
"28060",NA,30029,"Flathead County, MT","County or equivalent",2004,80626,1474,213,992,779,1352,33,1319,-91
"28180",NA,NA,"Kapaa, HI","Micropolitan Statistical Area",2004,60937,974,383,819,436,648,114,534,-57
"28180",NA,15007,"Kauai County, HI","County or equivalent",2004,60937,974,383,819,436,648,114,534,-57
"28260",NA,NA,"Kearney, NE","Micropolitan Statistical Area",2004,50434,447,279,715,436,203,33,170,-35
"28260",NA,31019,"Buffalo County, NE","County or equivalent",2004,43693,478,274,636,362,235,32,203,-31
"28260",NA,31099,"Kearney County, NE","County or equivalent",2004,6741,-31,5,79,74,-32,1,-33,-4
"28300",NA,NA,"Keene, NH","Micropolitan Statistical Area",2004,76545,539,103,737,634,494,28,466,-58
"28300",NA,33005,"Cheshire County, NH","County or equivalent",2004,76545,539,103,737,634,494,28,466,-58
"28340",NA,NA,"Kendallville, IN","Micropolitan Statistical Area",2004,46914,127,291,715,424,-127,127,-254,-37
"28340",NA,18113,"Noble County, IN","County or equivalent",2004,46914,127,291,715,424,-127,127,-254,-37
"28380",NA,NA,"Kennett, MO","Micropolitan Statistical Area",2004,31989,-396,3,473,470,-368,18,-386,-31
"28380",NA,29069,"Dunklin County, MO","County or equivalent",2004,31989,-396,3,473,470,-368,18,-386,-31
"28500",NA,NA,"Kerrville, TX","Micropolitan Statistical Area",2004,45548,666,-137,547,684,855,63,792,-52
"28500",NA,48265,"Kerr County, TX","County or equivalent",2004,45548,666,-137,547,684,855,63,792,-52
"28540",NA,NA,"Ketchikan, AK","Micropolitan Statistical Area",2004,13141,-139,77,173,96,-203,27,-230,-13
"28540",NA,2130,"Ketchikan Gateway Borough, AK","County or equivalent",2004,13141,-139,77,173,96,-203,27,-230,-13
"28580",NA,NA,"Key West, FL","Micropolitan Statistical Area",2004,77591,-1048,34,744,710,-1000,415,-1415,-82
"28580",NA,12087,"Monroe County, FL","County or equivalent",2004,77591,-1048,34,744,710,-1000,415,-1415,-82
"28620",NA,NA,"Kill Devil Hills, NC","Micropolitan Statistical Area",2004,33472,571,195,468,273,412,36,376,-36
"28620",NA,37055,"Dare County, NC","County or equivalent",2004,33472,571,195,468,273,412,36,376,-36
"28780",NA,NA,"Kingsville, TX","Micropolitan Statistical Area",2004,31317,-203,275,505,230,-442,87,-529,-36
"28780",NA,48261,"Kenedy County, TX","County or equivalent",2004,423,9,6,7,1,4,0,4,-1
"28780",NA,48273,"Kleberg County, TX","County or equivalent",2004,30894,-212,269,498,229,-446,87,-533,-35
"28820",NA,NA,"Kinston, NC","Micropolitan Statistical Area",2004,57560,-422,39,771,732,-410,71,-481,-51
"28820",NA,37107,"Lenoir County, NC","County or equivalent",2004,57560,-422,39,771,732,-410,71,-481,-51
"28860",NA,NA,"Kirksville, MO","Micropolitan Statistical Area",2004,28921,-9,67,328,261,-55,23,-78,-21
"28860",NA,29001,"Adair County, MO","County or equivalent",2004,24750,-25,74,288,214,-81,22,-103,-18
"28860",NA,29197,"Schuyler County, MO","County or equivalent",2004,4171,16,-7,40,47,26,1,25,-3
"28900",NA,NA,"Klamath Falls, OR","Micropolitan Statistical Area",2004,64725,193,97,787,690,140,68,72,-44
"28900",NA,41035,"Klamath County, OR","County or equivalent",2004,64725,193,97,787,690,140,68,72,-44
"28980",NA,NA,"Kodiak, AK","Micropolitan Statistical Area",2004,13114,-140,137,191,54,-258,127,-385,-19
"28980",NA,2150,"Kodiak Island Borough, AK","County or equivalent",2004,13114,-140,137,191,54,-258,127,-385,-19
"29060",NA,NA,"Laconia, NH","Micropolitan Statistical Area",2004,60760,800,69,666,597,791,41,750,-60
"29060",NA,33001,"Belknap County, NH","County or equivalent",2004,60760,800,69,666,597,791,41,750,-60
"29220",NA,NA,"La Follette, TN","Micropolitan Statistical Area",2004,40383,425,53,523,470,413,25,388,-41
"29220",NA,47013,"Campbell County, TN","County or equivalent",2004,40383,425,53,523,470,413,25,388,-41
"29260",NA,NA,"La Grande, OR","Micropolitan Statistical Area",2004,24337,-136,50,285,235,-164,28,-192,-22
"29260",NA,41061,"Union County, OR","County or equivalent",2004,24337,-136,50,285,235,-164,28,-192,-22
"29300",NA,NA,"LaGrange, GA","Micropolitan Statistical Area",2004,61177,1029,297,934,637,796,63,733,-64
"29300",NA,13285,"Troup County, GA","County or equivalent",2004,61177,1029,297,934,637,796,63,733,-64
"29380",NA,NA,"Lake City, FL","Micropolitan Statistical Area",2004,61434,1551,70,778,708,1567,30,1537,-86
"29380",NA,12023,"Columbia County, FL","County or equivalent",2004,61434,1551,70,778,708,1567,30,1537,-86
"29500",NA,NA,"Lamesa, TX","Micropolitan Statistical Area",2004,14013,-316,46,199,153,-343,18,-361,-19
"29500",NA,48115,"Dawson County, TX","County or equivalent",2004,14013,-316,46,199,153,-343,18,-361,-19
"29580",NA,NA,"Lancaster, SC","Micropolitan Statistical Area",2004,68174,1670,163,771,608,100,54,46,1407
"29580",NA,45057,"Lancaster County, SC","County or equivalent",2004,68174,1670,163,771,608,100,54,46,1407
"29660",NA,NA,"Laramie, WY","Micropolitan Statistical Area",2004,32681,245,221,388,167,46,59,-13,-22
"29660",NA,56001,"Albany County, WY","County or equivalent",2004,32681,245,221,388,167,46,59,-13,-22
"29780",NA,NA,"Las Vegas, NM","Micropolitan Statistical Area",2004,29097,-74,113,367,254,-163,7,-170,-24
"29780",NA,35047,"San Miguel County, NM","County or equivalent",2004,29097,-74,113,367,254,-163,7,-170,-24
"29860",NA,NA,"Laurel, MS","Micropolitan Statistical Area",2004,83248,306,408,1297,889,-42,126,-168,-60
"29860",NA,28061,"Jasper County, MS","County or equivalent",2004,18025,-38,118,274,156,-140,5,-145,-16
"29860",NA,28067,"Jones County, MS","County or equivalent",2004,65223,344,290,1023,733,98,121,-23,-44
"29900",NA,NA,"Laurinburg, NC","Micropolitan Statistical Area",2004,36484,993,147,500,353,899,23,876,-53
"29900",NA,37165,"Scotland County, NC","County or equivalent",2004,36484,993,147,500,353,899,23,876,-53
"29980",NA,NA,"Lawrenceburg, TN","Micropolitan Statistical Area",2004,40495,26,113,598,485,-60,12,-72,-27
"29980",NA,47099,"Lawrence County, TN","County or equivalent",2004,40495,26,113,598,485,-60,12,-72,-27
"30060",NA,NA,"Lebanon, MO","Micropolitan Statistical Area",2004,33499,361,117,501,384,272,8,264,-28
"30060",NA,29105,"Laclede County, MO","County or equivalent",2004,33499,361,117,501,384,272,8,264,-28
"30100",NA,NA,"Lebanon, NH-VT","Micropolitan Statistical Area",2004,170544,854,154,1688,1534,826,119,707,-126
"30100",NA,33009,"Grafton County, NH","County or equivalent",2004,84036,797,103,819,716,761,87,674,-67
"30100",NA,50017,"Orange County, VT","County or equivalent",2004,28944,116,60,304,244,77,2,75,-21
"30100",NA,50027,"Windsor County, VT","County or equivalent",2004,57564,-59,-9,565,574,-12,30,-42,-38
"30220",NA,NA,"Levelland, TX","Micropolitan Statistical Area",2004,22544,-116,162,380,218,-257,19,-276,-21
"30220",NA,48219,"Hockley County, TX","County or equivalent",2004,22544,-116,162,380,218,-257,19,-276,-21
"30260",NA,NA,"Lewisburg, PA","Micropolitan Statistical Area",2004,42540,477,88,441,353,430,15,415,-41
"30260",NA,42119,"Union County, PA","County or equivalent",2004,42540,477,88,441,353,430,15,415,-41
"30280",NA,NA,"Lewisburg, TN","Micropolitan Statistical Area",2004,27727,331,85,367,282,271,31,240,-25
"30280",NA,47117,"Marshall County, TN","County or equivalent",2004,27727,331,85,367,282,271,31,240,-25
"30380",NA,NA,"Lewistown, PA","Micropolitan Statistical Area",2004,45998,-182,30,571,541,-175,3,-178,-37
"30380",NA,42087,"Mifflin County, PA","County or equivalent",2004,45998,-182,30,571,541,-175,3,-178,-37
"30420",NA,NA,"Lexington, NE","Micropolitan Statistical Area",2004,26308,-45,257,512,255,-271,161,-432,-31
"30420",NA,31047,"Dawson County, NE","County or equivalent",2004,24281,-4,271,498,227,-247,161,-408,-28
"30420",NA,31073,"Gosper County, NE","County or equivalent",2004,2027,-41,-14,14,28,-24,0,-24,-3
"30500",NA,NA,"Lexington Park, MD","Micropolitan Statistical Area",2004,94884,2278,802,1402,600,1575,219,1356,-99
"30500",NA,24037,"St. Mary's County, MD","County or equivalent",2004,94884,2278,802,1402,600,1575,219,1356,-99
"30580",NA,NA,"Liberal, KS","Micropolitan Statistical Area",2004,22696,-40,374,512,138,-380,266,-646,-34
"30580",NA,20175,"Seward County, KS","County or equivalent",2004,22696,-40,374,512,138,-380,266,-646,-34
"30660",NA,NA,"Lincoln, IL","Micropolitan Statistical Area",2004,30452,-33,31,331,300,-43,7,-50,-21
"30660",NA,17107,"Logan County, IL","County or equivalent",2004,30452,-33,31,331,300,-43,7,-50,-21
"30740",NA,NA,"Lincolnton, NC","Micropolitan Statistical Area",2004,67550,682,309,912,603,420,218,202,-47
"30740",NA,37109,"Lincoln County, NC","County or equivalent",2004,67550,682,309,912,603,420,218,202,-47
"30820",NA,NA,"Lock Haven, PA","Micropolitan Statistical Area",2004,37242,-154,-4,418,422,-120,12,-132,-30
"30820",NA,42035,"Clinton County, PA","County or equivalent",2004,37242,-154,-4,418,422,-120,12,-132,-30
"30900",NA,NA,"Logansport, IN","Micropolitan Statistical Area",2004,39927,-224,170,584,414,-356,75,-431,-38
"30900",NA,18017,"Cass County, IN","County or equivalent",2004,39927,-224,170,584,414,-356,75,-431,-38
"30940",NA,NA,"London, KY","Micropolitan Statistical Area",2004,55465,365,220,749,529,190,25,165,-45
"30940",NA,21125,"Laurel County, KY","County or equivalent",2004,55465,365,220,749,529,190,25,165,-45
"31060",NA,NA,"Los Alamos, NM","Micropolitan Statistical Area",2004,18531,41,102,203,101,-48,54,-102,-13
"31060",NA,35028,"Los Alamos County, NM","County or equivalent",2004,18531,41,102,203,101,-48,54,-102,-13
"31260",NA,NA,"Lufkin, TX","Micropolitan Statistical Area",2004,80859,284,551,1321,770,-203,136,-339,-64
"31260",NA,48005,"Angelina County, TX","County or equivalent",2004,80859,284,551,1321,770,-203,136,-339,-64
"31300",NA,NA,"Lumberton, NC","Micropolitan Statistical Area",2004,124612,129,795,1981,1186,-562,376,-938,-104
"31300",NA,37155,"Robeson County, NC","County or equivalent",2004,124612,129,795,1981,1186,-562,376,-938,-104
"31380",NA,NA,"Macomb, IL","Micropolitan Statistical Area",2004,32814,-168,-16,282,298,-128,58,-186,-24
"31380",NA,17109,"McDonough County, IL","County or equivalent",2004,32814,-168,-16,282,298,-128,58,-186,-24
"31500",NA,NA,"Madison, IN","Micropolitan Statistical Area",2004,32045,148,98,370,272,70,8,62,-20
"31500",NA,18077,"Jefferson County, IN","County or equivalent",2004,32045,148,98,370,272,70,8,62,-20
"31580",NA,NA,"Madisonville, KY","Micropolitan Statistical Area",2004,46423,15,40,605,565,6,12,-6,-31
"31580",NA,21107,"Hopkins County, KY","County or equivalent",2004,46423,15,40,605,565,6,12,-6,-31
"31620",NA,NA,"Magnolia, AR","Micropolitan Statistical Area",2004,24799,-22,-8,306,314,1,12,-11,-15
"31620",NA,5027,"Columbia County, AR","County or equivalent",2004,24799,-22,-8,306,314,1,12,-11,-15
"31660",NA,NA,"Malone, NY","Micropolitan Statistical Area",2004,50445,-220,30,466,436,-213,8,-221,-37
"31660",NA,36033,"Franklin County, NY","County or equivalent",2004,50445,-220,30,466,436,-213,8,-221,-37
"31740",NA,NA,"Manhattan, KS","Micropolitan Statistical Area",2004,112829,305,1018,1706,688,-1173,817,-1990,460
"31740",NA,20061,"Geary County, KS","County or equivalent",2004,28130,-476,340,538,198,-1284,234,-1518,468
"31740",NA,20149,"Pottawatomie County, KS","County or equivalent",2004,18682,139,134,312,178,18,4,14,-13
"31740",NA,20161,"Riley County, KS","County or equivalent",2004,66017,642,544,856,312,93,579,-486,5
"31820",NA,NA,"Manitowoc, WI","Micropolitan Statistical Area",2004,81219,-316,167,913,746,-416,71,-487,-67
"31820",NA,55071,"Manitowoc County, WI","County or equivalent",2004,81219,-316,167,913,746,-416,71,-487,-67
"31860",NA,NA,"Mankato-North Mankato, MN","Micropolitan Statistical Area",2004,88681,503,470,1081,611,93,97,-4,-60
"31860",NA,27013,"Blue Earth County, MN","County or equivalent",2004,57914,279,271,693,422,48,67,-19,-40
"31860",NA,27103,"Nicollet County, MN","County or equivalent",2004,30767,224,199,388,189,45,30,15,-20
"31940",NA,NA,"Marinette, WI-MI","Micropolitan Statistical Area",2004,67655,-300,-61,691,752,-194,21,-215,-45
"31940",NA,26109,"Menominee County, MI","County or equivalent",2004,24888,-31,-1,251,252,-15,7,-22,-15
"31940",NA,55075,"Marinette County, WI","County or equivalent",2004,42767,-269,-60,440,500,-179,14,-193,-30
"31980",NA,NA,"Marion, IN","Micropolitan Statistical Area",2004,70814,-786,36,855,819,-756,14,-770,-66
"31980",NA,18053,"Grant County, IN","County or equivalent",2004,70814,-786,36,855,819,-756,14,-770,-66
"32020",NA,NA,"Marion, OH","Micropolitan Statistical Area",2004,65740,-163,144,812,668,-259,16,-275,-48
"32020",NA,39101,"Marion County, OH","County or equivalent",2004,65740,-163,144,812,668,-259,16,-275,-48
"32060",NA,NA,"Marion-Herrin, IL","Micropolitan Statistical Area",2004,63080,758,10,743,733,786,18,768,-38
"32060",NA,17199,"Williamson County, IL","County or equivalent",2004,63080,758,10,743,733,786,18,768,-38
"32100",NA,NA,"Marquette, MI","Micropolitan Statistical Area",2004,65091,451,14,633,619,491,21,470,-54
"32100",NA,26103,"Marquette County, MI","County or equivalent",2004,65091,451,14,633,619,491,21,470,-54
"32140",NA,NA,"Marshall, MN","Micropolitan Statistical Area",2004,24522,-206,40,298,258,-222,42,-264,-24
"32140",NA,27083,"Lyon County, MN","County or equivalent",2004,24522,-206,40,298,258,-222,42,-264,-24
"32180",NA,NA,"Marshall, MO","Micropolitan Statistical Area",2004,22934,75,-5,286,291,97,39,58,-17
"32180",NA,29195,"Saline County, MO","County or equivalent",2004,22934,75,-5,286,291,97,39,58,-17
"32220",NA,NA,"Marshall, TX","Micropolitan Statistical Area",2004,62314,522,257,864,607,312,78,234,-47
"32220",NA,48203,"Harrison County, TX","County or equivalent",2004,62314,522,257,864,607,312,78,234,-47
"32260",NA,NA,"Marshalltown, IA","Micropolitan Statistical Area",2004,39251,211,168,624,456,73,111,-38,-30
"32260",NA,19127,"Marshall County, IA","County or equivalent",2004,39251,211,168,624,456,73,111,-38,-30
"32270",NA,NA,"Marshfield-Wisconsin Rapids, WI","Micropolitan Statistical Area",2004,74753,-124,215,870,655,-279,50,-329,-60
"32270",NA,55141,"Wood County, WI","County or equivalent",2004,74753,-124,215,870,655,-279,50,-329,-60
"32280",NA,NA,"Martin, TN","Micropolitan Statistical Area",2004,33514,-407,8,341,333,-382,39,-421,-33
"32280",NA,47183,"Weakley County, TN","County or equivalent",2004,33514,-407,8,341,333,-382,39,-421,-33
"32300",NA,NA,"Martinsville, VA","Micropolitan Statistical Area",2004,70985,-610,-124,773,897,-422,162,-584,-64
"32300",NA,51089,"Henry County, VA","County or equivalent",2004,56254,-317,-32,624,656,-240,126,-366,-45
"32300",NA,51690,"Martinsville city, VA","County or equivalent",2004,14731,-293,-92,149,241,-182,36,-218,-19
"32340",NA,NA,"Maryville, MO","Micropolitan Statistical Area",2004,21989,65,43,241,198,36,16,20,-14
"32340",NA,29147,"Nodaway County, MO","County or equivalent",2004,21989,65,43,241,198,36,16,20,-14
"32380",NA,NA,"Mason City, IA","Micropolitan Statistical Area",2004,52377,-491,-53,583,636,-393,18,-411,-45
"32380",NA,19033,"Cerro Gordo County, IA","County or equivalent",2004,44664,-482,-22,501,523,-420,17,-437,-40
"32380",NA,19195,"Worth County, IA","County or equivalent",2004,7713,-9,-31,82,113,27,1,26,-5
"32460",NA,NA,"Mayfield, KY","Micropolitan Statistical Area",2004,37055,-51,-10,474,484,-13,53,-66,-28
"32460",NA,21083,"Graves County, KY","County or equivalent",2004,37055,-51,-10,474,484,-13,53,-66,-28
"32500",NA,NA,"Maysville, KY","Micropolitan Statistical Area",2004,30526,172,27,389,362,169,13,156,-24
"32500",NA,21135,"Lewis County, KY","County or equivalent",2004,13757,99,7,188,181,104,1,103,-12
"32500",NA,21161,"Mason County, KY","County or equivalent",2004,16769,73,20,201,181,65,12,53,-12
"32540",NA,NA,"McAlester, OK","Micropolitan Statistical Area",2004,43661,-42,10,519,509,-23,18,-41,-29
"32540",NA,40121,"Pittsburg County, OK","County or equivalent",2004,43661,-42,10,519,509,-23,18,-41,-29
"32620",NA,NA,"McComb, MS","Micropolitan Statistical Area",2004,51834,-85,220,810,590,-263,6,-269,-42
"32620",NA,28005,"Amite County, MS","County or equivalent",2004,13312,-97,8,151,143,-94,2,-96,-11
"32620",NA,28113,"Pike County, MS","County or equivalent",2004,38522,12,212,659,447,-169,4,-173,-31
"32660",NA,NA,"McMinnville, TN","Micropolitan Statistical Area",2004,39057,77,58,499,441,47,88,-41,-28
"32660",NA,47177,"Warren County, TN","County or equivalent",2004,39057,77,58,499,441,47,88,-41,-28
"32700",NA,NA,"McPherson, KS","Micropolitan Statistical Area",2004,29188,8,2,357,355,27,7,20,-21
"32700",NA,20113,"McPherson County, KS","County or equivalent",2004,29188,8,2,357,355,27,7,20,-21
"32740",NA,NA,"Meadville, PA","Micropolitan Statistical Area",2004,89375,-233,90,1009,919,-258,8,-266,-65
"32740",NA,42039,"Crawford County, PA","County or equivalent",2004,89375,-233,90,1009,919,-258,8,-266,-65
"32860",NA,NA,"Menomonie, WI","Micropolitan Statistical Area",2004,41350,388,220,477,257,200,27,173,-32
"32860",NA,55033,"Dunn County, WI","County or equivalent",2004,41350,388,220,477,257,200,27,173,-32
"32940",NA,NA,"Meridian, MS","Micropolitan Statistical Area",2004,105186,-468,392,1619,1227,-769,107,-876,-91
"32940",NA,28023,"Clarke County, MS","County or equivalent",2004,17524,-54,45,238,193,-86,3,-89,-13
"32940",NA,28069,"Kemper County, MS","County or equivalent",2004,10349,-41,34,142,108,-68,1,-69,-7
"32940",NA,28075,"Lauderdale County, MS","County or equivalent",2004,77313,-373,313,1239,926,-615,103,-718,-71
"32980",NA,NA,"Merrill, WI","Micropolitan Statistical Area",2004,29895,111,32,317,285,100,15,85,-21
"32980",NA,55069,"Lincoln County, WI","County or equivalent",2004,29895,111,32,317,285,100,15,85,-21
"33020",NA,NA,"Mexico, MO","Micropolitan Statistical Area",2004,25553,-195,88,399,311,-257,0,-257,-26
"33020",NA,29007,"Audrain County, MO","County or equivalent",2004,25553,-195,88,399,311,-257,0,-257,-26
"33060",NA,NA,"Miami, OK","Micropolitan Statistical Area",2004,32392,-18,-31,404,435,34,22,12,-21
"33060",NA,40115,"Ottawa County, OK","County or equivalent",2004,32392,-18,-31,404,435,34,22,12,-21
"33180",NA,NA,"Middlesborough, KY","Micropolitan Statistical Area",2004,29373,-196,45,404,359,-217,12,-229,-24
"33180",NA,21013,"Bell County, KY","County or equivalent",2004,29373,-196,45,404,359,-217,12,-229,-24
"33220",NA,NA,"Midland, MI","Micropolitan Statistical Area",2004,83452,-106,335,979,644,-373,111,-484,-68
"33220",NA,26111,"Midland County, MI","County or equivalent",2004,83452,-106,335,979,644,-373,111,-484,-68
"33300",NA,NA,"Milledgeville, GA","Micropolitan Statistical Area",2004,54806,145,191,686,495,-3,23,-26,-43
"33300",NA,13009,"Baldwin County, GA","County or equivalent",2004,45287,249,183,571,388,98,22,76,-32
"33300",NA,13141,"Hancock County, GA","County or equivalent",2004,9519,-104,8,115,107,-101,1,-102,-11
"33380",NA,NA,"Minden, LA","Micropolitan Statistical Area",2004,40862,-46,-15,525,540,-5,9,-14,-26
"33380",NA,22119,"Webster Parish, LA","County or equivalent",2004,40862,-46,-15,525,540,-5,9,-14,-26
"33420",NA,NA,"Mineral Wells, TX","Micropolitan Statistical Area",2004,27071,-60,8,346,338,-50,39,-89,-18
"33420",NA,48363,"Palo Pinto County, TX","County or equivalent",2004,27071,-60,8,346,338,-50,39,-89,-18
"33500",NA,NA,"Minot, ND","Micropolitan Statistical Area",2004,65016,69,439,1011,572,-311,308,-619,-59
"33500",NA,38049,"McHenry County, ND","County or equivalent",2004,5566,-102,-16,61,77,-81,1,-82,-5
"33500",NA,38075,"Renville County, ND","County or equivalent",2004,2424,-38,-12,25,37,-25,2,-27,-1
"33500",NA,38101,"Ward County, ND","County or equivalent",2004,57026,209,467,925,458,-205,305,-510,-53
"33580",NA,NA,"Mitchell, SD","Micropolitan Statistical Area",2004,22504,366,111,328,217,281,11,270,-26
"33580",NA,46035,"Davison County, SD","County or equivalent",2004,18884,156,78,278,200,94,10,84,-16
"33580",NA,46061,"Hanson County, SD","County or equivalent",2004,3620,210,33,50,17,187,1,186,-10
"33620",NA,NA,"Moberly, MO","Micropolitan Statistical Area",2004,25193,188,87,352,265,121,18,103,-20
"33620",NA,29175,"Randolph County, MO","County or equivalent",2004,25193,188,87,352,265,121,18,103,-20
"33820",NA,NA,"Monroe, WI","Micropolitan Statistical Area",2004,34485,425,105,423,318,349,11,338,-29
"33820",NA,55045,"Green County, WI","County or equivalent",2004,34485,425,105,423,318,349,11,338,-29
"33940",NA,NA,"Montrose, CO","Micropolitan Statistical Area",2004,36195,526,134,474,340,425,43,382,-33
"33940",NA,8085,"Montrose County, CO","County or equivalent",2004,36195,526,134,474,340,425,43,382,-33
"33980",NA,NA,"Morehead City, NC","Micropolitan Statistical Area",2004,61846,888,-64,637,701,938,79,859,14
"33980",NA,37031,"Carteret County, NC","County or equivalent",2004,61846,888,-64,637,701,938,79,859,14
"34020",NA,NA,"Morgan City, LA","Micropolitan Statistical Area",2004,51526,-357,213,790,577,-521,26,-547,-49
"34020",NA,22101,"St. Mary Parish, LA","County or equivalent",2004,51526,-357,213,790,577,-521,26,-547,-49
"34140",NA,NA,"Moscow, ID","Micropolitan Statistical Area",2004,35835,375,189,428,239,214,65,149,-28
"34140",NA,16057,"Latah County, ID","County or equivalent",2004,35835,375,189,428,239,214,65,149,-28
"34180",NA,NA,"Moses Lake, WA","Micropolitan Statistical Area",2004,78767,765,887,1449,562,-53,540,-593,-69
"34180",NA,53025,"Grant County, WA","County or equivalent",2004,78767,765,887,1449,562,-53,540,-593,-69
"34220",NA,NA,"Moultrie, GA","Micropolitan Statistical Area",2004,43253,467,256,692,436,239,205,34,-28
"34220",NA,13071,"Colquitt County, GA","County or equivalent",2004,43253,467,256,692,436,239,205,34,-28
"34260",NA,NA,"Mountain Home, AR","Micropolitan Statistical Area",2004,39553,605,-344,354,698,1005,2,1003,-56
"34260",NA,5005,"Baxter County, AR","County or equivalent",2004,39553,605,-344,354,698,1005,2,1003,-56
"34300",NA,NA,"Mountain Home, ID","Micropolitan Statistical Area",2004,29064,183,378,534,156,-164,260,-424,-31
"34300",NA,16039,"Elmore County, ID","County or equivalent",2004,29064,183,378,534,156,-164,260,-424,-31
"34340",NA,NA,"Mount Airy, NC","Micropolitan Statistical Area",2004,71704,-287,89,897,808,-316,172,-488,-60
"34340",NA,37171,"Surry County, NC","County or equivalent",2004,71704,-287,89,897,808,-316,172,-488,-60
"34380",NA,NA,"Mount Pleasant, MI","Micropolitan Statistical Area",2004,65716,692,270,731,461,474,73,401,-52
"34380",NA,26073,"Isabella County, MI","County or equivalent",2004,65716,692,270,731,461,474,73,401,-52
"34420",NA,NA,"Mount Pleasant, TX","Micropolitan Statistical Area",2004,28838,358,301,567,266,79,176,-97,-22
"34420",NA,48449,"Titus County, TX","County or equivalent",2004,28838,358,301,567,266,79,176,-97,-22
"34460",NA,NA,"Mount Sterling, KY","Micropolitan Statistical Area",2004,41891,322,181,582,401,173,4,169,-32
"34460",NA,21011,"Bath County, KY","County or equivalent",2004,11470,25,1,140,139,32,1,31,-8
"34460",NA,21165,"Menifee County, KY","County or equivalent",2004,6734,46,29,84,55,23,1,22,-6
"34460",NA,21173,"Montgomery County, KY","County or equivalent",2004,23687,251,151,358,207,118,2,116,-18
"34500",NA,NA,"Mount Vernon, IL","Micropolitan Statistical Area",2004,48429,65,38,566,528,63,10,53,-36
"34500",NA,17065,"Hamilton County, IL","County or equivalent",2004,8375,55,-10,95,105,74,0,74,-9
"34500",NA,17081,"Jefferson County, IL","County or equivalent",2004,40054,10,48,471,423,-11,10,-21,-27
"34540",NA,NA,"Mount Vernon, OH","Micropolitan Statistical Area",2004,57487,652,100,692,592,604,8,596,-52
"34540",NA,39083,"Knox County, OH","County or equivalent",2004,57487,652,100,692,592,604,8,596,-52
"34660",NA,NA,"Murray, KY","Micropolitan Statistical Area",2004,35066,362,21,359,338,372,57,315,-31
"34660",NA,21035,"Calloway County, KY","County or equivalent",2004,35066,362,21,359,338,372,57,315,-31
"34700",NA,NA,"Muscatine, IA","Micropolitan Statistical Area",2004,53859,9,224,726,502,-174,90,-264,-41
"34700",NA,19115,"Louisa County, IA","County or equivalent",2004,12049,-127,22,139,117,-136,24,-160,-13
"34700",NA,19139,"Muscatine County, IA","County or equivalent",2004,41810,136,202,587,385,-38,66,-104,-28
"34780",NA,NA,"Muskogee, OK","Micropolitan Statistical Area",2004,69897,-41,133,998,865,-122,62,-184,-52
"34780",NA,40101,"Muskogee County, OK","County or equivalent",2004,69897,-41,133,998,865,-122,62,-184,-52
"34860",NA,NA,"Nacogdoches, TX","Micropolitan Statistical Area",2004,60581,636,339,946,607,344,162,182,-47
"34860",NA,48347,"Nacogdoches County, TX","County or equivalent",2004,60581,636,339,946,607,344,162,182,-47
"35020",NA,NA,"Natchez, MS-LA","Micropolitan Statistical Area",2004,51235,-1165,-7,607,614,-1093,11,-1104,-65
"35020",NA,22029,"Concordia Parish, LA","County or equivalent",2004,19197,-286,11,225,214,-277,2,-279,-20
"35020",NA,28001,"Adams County, MS","County or equivalent",2004,32038,-879,-18,382,400,-816,9,-825,-45
"35060",NA,NA,"Natchitoches, LA","Micropolitan Statistical Area",2004,38690,-1,217,583,366,-187,26,-213,-31
"35060",NA,22069,"Natchitoches Parish, LA","County or equivalent",2004,38690,-1,217,583,366,-187,26,-213,-31
"35100",NA,NA,"New Bern, NC","Micropolitan Statistical Area",2004,116571,-93,610,1749,1139,-1139,594,-1733,436
"35100",NA,37049,"Craven County, NC","County or equivalent",2004,93881,-92,642,1536,894,-1193,577,-1770,459
"35100",NA,37103,"Jones County, NC","County or equivalent",2004,10158,145,-10,96,106,168,11,157,-13
"35100",NA,37137,"Pamlico County, NC","County or equivalent",2004,12532,-146,-22,117,139,-114,6,-120,-10
"35140",NA,NA,"Newberry, SC","Micropolitan Statistical Area",2004,36767,172,63,492,429,133,97,36,-24
"35140",NA,45071,"Newberry County, SC","County or equivalent",2004,36767,172,63,492,429,133,97,36,-24
"35220",NA,NA,"New Castle, IN","Micropolitan Statistical Area",2004,47562,-112,-32,553,585,-48,4,-52,-32
"35220",NA,18065,"Henry County, IN","County or equivalent",2004,47562,-112,-32,553,585,-48,4,-52,-32
"35260",NA,NA,"New Castle, PA","Micropolitan Statistical Area",2004,92654,-614,-277,943,1220,-270,19,-289,-67
"35260",NA,42073,"Lawrence County, PA","County or equivalent",2004,92654,-614,-277,943,1220,-270,19,-289,-67
"35340",NA,NA,"New Iberia, LA","Micropolitan Statistical Area",2004,73393,15,420,1121,701,-348,35,-383,-57
"35340",NA,22045,"Iberia Parish, LA","County or equivalent",2004,73393,15,420,1121,701,-348,35,-383,-57
"35420",NA,NA,"New Philadelphia-Dover, OH","Micropolitan Statistical Area",2004,91576,157,253,1162,909,-37,23,-60,-59
"35420",NA,39157,"Tuscarawas County, OH","County or equivalent",2004,91576,157,253,1162,909,-37,23,-60,-59
"35460",NA,NA,"Newport, TN","Micropolitan Statistical Area",2004,34459,171,-24,418,442,222,8,214,-27
"35460",NA,47029,"Cocke County, TN","County or equivalent",2004,34459,171,-24,418,442,222,8,214,-27
"35500",NA,NA,"Newton, IA","Micropolitan Statistical Area",2004,37266,-140,79,422,343,-190,20,-210,-29
"35500",NA,19099,"Jasper County, IA","County or equivalent",2004,37266,-140,79,422,343,-190,20,-210,-29
"35580",NA,NA,"New Ulm, MN","Micropolitan Statistical Area",2004,26510,-123,-18,292,310,-82,7,-89,-23
"35580",NA,27015,"Brown County, MN","County or equivalent",2004,26510,-123,-18,292,310,-82,7,-89,-23
"35700",NA,NA,"Nogales, AZ","Micropolitan Statistical Area",2004,40085,623,637,845,208,18,212,-194,-32
"35700",NA,4023,"Santa Cruz County, AZ","County or equivalent",2004,40085,623,637,845,208,18,212,-194,-32
"35740",NA,NA,"Norfolk, NE","Micropolitan Statistical Area",2004,49458,-310,264,777,513,-523,68,-591,-51
"35740",NA,31119,"Madison County, NE","County or equivalent",2004,35530,-168,237,596,359,-366,61,-427,-39
"35740",NA,31139,"Pierce County, NE","County or equivalent",2004,7446,-146,-14,95,109,-125,1,-126,-7
"35740",NA,31167,"Stanton County, NE","County or equivalent",2004,6482,4,41,86,45,-32,6,-38,-5
"35820",NA,NA,"North Platte, NE","Micropolitan Statistical Area",2004,36093,317,173,515,342,173,18,155,-29
"35820",NA,31111,"Lincoln County, NE","County or equivalent",2004,34853,328,169,506,337,187,18,169,-28
"35820",NA,31113,"Logan County, NE","County or equivalent",2004,732,1,1,6,5,0,0,0,0
"35820",NA,31117,"McPherson County, NE","County or equivalent",2004,508,-12,3,3,0,-14,0,-14,-1
"35860",NA,NA,"North Vernon, IN","Micropolitan Statistical Area",2004,27982,138,168,412,244,-12,6,-18,-18
"35860",NA,18079,"Jennings County, IN","County or equivalent",2004,27982,138,168,412,244,-12,6,-18,-18
"35900",NA,NA,"North Wilkesboro, NC","Micropolitan Statistical Area",2004,66339,-251,76,737,661,-273,136,-409,-54
"35900",NA,37193,"Wilkes County, NC","County or equivalent",2004,66339,-251,76,737,661,-273,136,-409,-54
"35940",NA,NA,"Norwalk, OH","Micropolitan Statistical Area",2004,59834,42,267,842,575,-181,47,-228,-44
"35940",NA,39077,"Huron County, OH","County or equivalent",2004,59834,42,267,842,575,-181,47,-228,-44
"36020",NA,NA,"Oak Harbor, WA","Micropolitan Statistical Area",2004,79270,2674,352,963,611,2420,450,1970,-98
"36020",NA,53029,"Island County, WA","County or equivalent",2004,79270,2674,352,963,611,2420,450,1970,-98
"36060",NA,NA,"Oak Hill, WV","Micropolitan Statistical Area",2004,46797,-306,-33,581,614,-234,15,-249,-39
"36060",NA,54019,"Fayette County, WV","County or equivalent",2004,46797,-306,-33,581,614,-234,15,-249,-39
"36180",NA,NA,"Ocean Pines, MD","Micropolitan Statistical Area",2004,48868,187,-136,448,584,367,50,317,-44
"36180",NA,24047,"Worcester County, MD","County or equivalent",2004,48868,187,-136,448,584,367,50,317,-44
"36300",NA,NA,"Ogdensburg-Massena, NY","Micropolitan Statistical Area",2004,110226,-144,195,1262,1067,-263,76,-339,-76
"36300",NA,36089,"St. Lawrence County, NY","County or equivalent",2004,110226,-144,195,1262,1067,-263,76,-339,-76
"36340",NA,NA,"Oil City, PA","Micropolitan Statistical Area",2004,55816,-490,-130,558,688,-318,9,-327,-42
"36340",NA,42121,"Venango County, PA","County or equivalent",2004,55816,-490,-130,558,688,-318,9,-327,-42
"36380",NA,NA,"Okeechobee, FL","Micropolitan Statistical Area",2004,38571,1338,201,580,379,1194,157,1037,-57
"36380",NA,12093,"Okeechobee County, FL","County or equivalent",2004,38571,1338,201,580,379,1194,157,1037,-57
"36460",NA,NA,"Olean, NY","Micropolitan Statistical Area",2004,82394,-589,68,986,918,-589,12,-601,-68
"36460",NA,36009,"Cattaraugus County, NY","County or equivalent",2004,82394,-589,68,986,918,-589,12,-601,-68
"36580",NA,NA,"Oneonta, NY","Micropolitan Statistical Area",2004,62446,307,-97,525,622,454,14,440,-50
"36580",NA,36077,"Otsego County, NY","County or equivalent",2004,62446,307,-97,525,622,454,14,440,-50
"36620",NA,NA,"Ontario, OR-ID","Micropolitan Statistical Area",2004,52289,-99,298,777,479,-348,97,-445,-49
"36620",NA,16075,"Payette County, ID","County or equivalent",2004,21295,40,141,323,182,-83,13,-96,-18
"36620",NA,41045,"Malheur County, OR","County or equivalent",2004,30994,-139,157,454,297,-265,84,-349,-31
"36660",NA,NA,"Opelousas-Eunice, LA","Micropolitan Statistical Area",2004,88305,348,471,1417,946,-64,15,-79,-59
"36660",NA,22097,"St. Landry Parish, LA","County or equivalent",2004,88305,348,471,1417,946,-64,15,-79,-59
"36700",NA,NA,"Orangeburg, SC","Micropolitan Statistical Area",2004,90570,-361,255,1243,988,-545,26,-571,-71
"36700",NA,45075,"Orangeburg County, SC","County or equivalent",2004,90570,-361,255,1243,988,-545,26,-571,-71
"36820",NA,NA,"Oskaloosa, IA","Micropolitan Statistical Area",2004,22069,43,83,298,215,-26,17,-43,-14
"36820",NA,19123,"Mahaska County, IA","County or equivalent",2004,22069,43,83,298,215,-26,17,-43,-14
"36860",NA,NA,"Ottawa-Streator, IL","Micropolitan Statistical Area",2004,151861,612,29,1848,1819,716,101,615,-133
"36860",NA,17011,"Bureau County, IL","County or equivalent",2004,34811,-166,22,445,423,-159,15,-174,-29
"36860",NA,17099,"LaSalle County, IL","County or equivalent",2004,111030,837,5,1349,1344,931,84,847,-99
"36860",NA,17155,"Putnam County, IL","County or equivalent",2004,6020,-59,2,54,52,-56,2,-58,-5
"36900",NA,NA,"Ottumwa, IA","Micropolitan Statistical Area",2004,35660,-60,90,500,410,-123,33,-156,-27
"36900",NA,19179,"Wapello County, IA","County or equivalent",2004,35660,-60,90,500,410,-123,33,-156,-27
"36940",NA,NA,"Owatonna, MN","Micropolitan Statistical Area",2004,35062,399,253,532,279,172,76,96,-26
"36940",NA,27147,"Steele County, MN","County or equivalent",2004,35062,399,253,532,279,172,76,96,-26
"37020",NA,NA,"Owosso, MI","Micropolitan Statistical Area",2004,72640,488,304,923,619,237,8,229,-53
"37020",NA,26155,"Shiawassee County, MI","County or equivalent",2004,72640,488,304,923,619,237,8,229,-53
"37060",NA,NA,"Oxford, MS","Micropolitan Statistical Area",2004,40957,308,192,477,285,141,55,86,-25
"37060",NA,28071,"Lafayette County, MS","County or equivalent",2004,40957,308,192,477,285,141,55,86,-25
"37140",NA,NA,"Paducah, KY-IL","Micropolitan Statistical Area",2004,97346,-39,16,1185,1169,17,16,1,-72
"37140",NA,17127,"Massac County, IL","County or equivalent",2004,15239,191,-3,181,184,209,0,209,-15
"37140",NA,21007,"Ballard County, KY","County or equivalent",2004,8222,-12,-10,95,105,3,1,2,-5
"37140",NA,21139,"Livingston County, KY","County or equivalent",2004,9623,-60,-38,99,137,-15,0,-15,-7
"37140",NA,21145,"McCracken County, KY","County or equivalent",2004,64262,-158,67,810,743,-180,15,-195,-45
"37220",NA,NA,"Pahrump, NV","Micropolitan Statistical Area",2004,37361,1737,-198,335,533,2019,41,1978,-84
"37220",NA,32023,"Nye County, NV","County or equivalent",2004,37361,1737,-198,335,533,2019,41,1978,-84
"37260",NA,NA,"Palatka, FL","Micropolitan Statistical Area",2004,71911,751,36,957,921,786,64,722,-71
"37260",NA,12107,"Putnam County, FL","County or equivalent",2004,71911,751,36,957,921,786,64,722,-71
"37300",NA,NA,"Palestine, TX","Micropolitan Statistical Area",2004,55562,-1,47,660,613,-8,48,-56,-40
"37300",NA,48001,"Anderson County, TX","County or equivalent",2004,55562,-1,47,660,613,-8,48,-56,-40
"37420",NA,NA,"Pampa, TX","Micropolitan Statistical Area",2004,22034,-280,13,289,276,-269,38,-307,-24
"37420",NA,48179,"Gray County, TX","County or equivalent",2004,21218,-292,25,285,260,-294,38,-332,-23
"37420",NA,48393,"Roberts County, TX","County or equivalent",2004,816,12,-12,4,16,25,0,25,-1
"37500",NA,NA,"Paragould, AR","Micropolitan Statistical Area",2004,38668,367,110,505,395,292,10,282,-35
"37500",NA,5055,"Greene County, AR","County or equivalent",2004,38668,367,110,505,395,292,10,282,-35
"37540",NA,NA,"Paris, TN","Micropolitan Statistical Area",2004,31083,26,-115,332,447,167,14,153,-26
"37540",NA,47079,"Henry County, TN","County or equivalent",2004,31083,26,-115,332,447,167,14,153,-26
"37580",NA,NA,"Paris, TX","Micropolitan Statistical Area",2004,49071,-1,65,657,592,-31,61,-92,-35
"37580",NA,48277,"Lamar County, TX","County or equivalent",2004,49071,-1,65,657,592,-31,61,-92,-35
"37660",NA,NA,"Parsons, KS","Micropolitan Statistical Area",2004,21944,-185,-58,267,325,-110,4,-114,-17
"37660",NA,20099,"Labette County, KS","County or equivalent",2004,21944,-185,-58,267,325,-110,4,-114,-17
"37740",NA,NA,"Payson, AZ","Micropolitan Statistical Area",2004,50836,-63,48,700,652,-75,37,-112,-36
"37740",NA,4007,"Gila County, AZ","County or equivalent",2004,50836,-63,48,700,652,-75,37,-112,-36
"37780",NA,NA,"Pecos, TX","Micropolitan Statistical Area",2004,11556,-460,57,171,114,-496,21,-517,-21
"37780",NA,48389,"Reeves County, TX","County or equivalent",2004,11556,-460,57,171,114,-496,21,-517,-21
"37800",NA,NA,"Pella, IA","Micropolitan Statistical Area",2004,32263,-16,28,369,341,-22,8,-30,-22
"37800",NA,19125,"Marion County, IA","County or equivalent",2004,32263,-16,28,369,341,-22,8,-30,-22
"37820",NA,NA,"Pendleton-Hermiston, OR","Micropolitan Statistical Area",2004,84154,455,575,1314,739,-58,198,-256,-62
"37820",NA,41049,"Morrow County, OR","County or equivalent",2004,11382,-22,101,190,89,-111,43,-154,-12
"37820",NA,41059,"Umatilla County, OR","County or equivalent",2004,72772,477,474,1124,650,53,155,-102,-50
"37940",NA,NA,"Peru, IN","Micropolitan Statistical Area",2004,36573,-266,135,460,325,-367,6,-373,-34
"37940",NA,18103,"Miami County, IN","County or equivalent",2004,36573,-266,135,460,325,-367,6,-373,-34
"38020",NA,NA,"Phoenix Lake-Cedar Ridge, CA","Micropolitan Statistical Area",2004,56172,-26,-161,464,625,180,18,162,-45
"38020",NA,6109,"Tuolumne County, CA","County or equivalent",2004,56172,-26,-161,464,625,180,18,162,-45
"38100",NA,NA,"Picayune, MS","Micropolitan Statistical Area",2004,51264,789,163,681,518,679,16,663,-53
"38100",NA,28109,"Pearl River County, MS","County or equivalent",2004,51264,789,163,681,518,679,16,663,-53
"38180",NA,NA,"Pierre, SD","Micropolitan Statistical Area",2004,19421,155,90,243,153,79,12,67,-14
"38180",NA,46065,"Hughes County, SD","County or equivalent",2004,16632,90,59,199,140,42,12,30,-11
"38180",NA,46117,"Stanley County, SD","County or equivalent",2004,2789,65,31,44,13,37,0,37,-3
"38200",NA,NA,"Pierre Part, LA","Micropolitan Statistical Area",2004,23042,-26,48,254,206,-57,6,-63,-17
"38200",NA,22007,"Assumption Parish, LA","County or equivalent",2004,23042,-26,48,254,206,-57,6,-63,-17
"38260",NA,NA,"Pittsburg, KS","Micropolitan Statistical Area",2004,38543,5,78,538,460,-41,72,-113,-32
"38260",NA,20037,"Crawford County, KS","County or equivalent",2004,38543,5,78,538,460,-41,72,-113,-32
"38380",NA,NA,"Plainview, TX","Micropolitan Statistical Area",2004,35966,630,376,668,292,286,71,215,-32
"38380",NA,48189,"Hale County, TX","County or equivalent",2004,35966,630,376,668,292,286,71,215,-32
"38420",NA,NA,"Platteville, WI","Micropolitan Statistical Area",2004,49251,8,77,590,513,-34,9,-43,-35
"38420",NA,55043,"Grant County, WI","County or equivalent",2004,49251,8,77,590,513,-34,9,-43,-35
"38460",NA,NA,"Plattsburgh, NY","Micropolitan Statistical Area",2004,81382,319,204,825,621,170,44,126,-55
"38460",NA,36019,"Clinton County, NY","County or equivalent",2004,81382,319,204,825,621,170,44,126,-55
"38500",NA,NA,"Plymouth, IN","Micropolitan Statistical Area",2004,46108,322,272,705,433,80,113,-33,-30
"38500",NA,18099,"Marshall County, IN","County or equivalent",2004,46108,322,272,705,433,80,113,-33,-30
"38580",NA,NA,"Point Pleasant, WV-OH","Micropolitan Statistical Area",2004,56683,-251,93,718,625,-299,5,-304,-45
"38580",NA,39053,"Gallia County, OH","County or equivalent",2004,30967,-73,63,383,320,-111,4,-115,-25
"38580",NA,54053,"Mason County, WV","County or equivalent",2004,25716,-178,30,335,305,-188,1,-189,-20
"38620",NA,NA,"Ponca City, OK","Micropolitan Statistical Area",2004,46561,-522,35,677,642,-509,40,-549,-48
"38620",NA,40071,"Kay County, OK","County or equivalent",2004,46561,-522,35,677,642,-509,40,-549,-48
"38700",NA,NA,"Pontiac, IL","Micropolitan Statistical Area",2004,38476,-104,108,548,440,-180,15,-195,-32
"38700",NA,17105,"Livingston County, IL","County or equivalent",2004,38476,-104,108,548,440,-180,15,-195,-32
"38740",NA,NA,"Poplar Bluff, MO","Micropolitan Statistical Area",2004,40890,211,29,581,552,217,14,203,-35
"38740",NA,29023,"Butler County, MO","County or equivalent",2004,40890,211,29,581,552,217,14,203,-35
"38780",NA,NA,"Portales, NM","Micropolitan Statistical Area",2004,18616,58,161,302,141,-88,26,-114,-15
"38780",NA,35041,"Roosevelt County, NM","County or equivalent",2004,18616,58,161,302,141,-88,26,-114,-15
"38820",NA,NA,"Port Angeles, WA","Micropolitan Statistical Area",2004,67409,1084,-196,635,831,1362,70,1292,-82
"38820",NA,53009,"Clallam County, WA","County or equivalent",2004,67409,1084,-196,635,831,1362,70,1292,-82
"39020",NA,NA,"Portsmouth, OH","Micropolitan Statistical Area",2004,76378,-792,-17,1018,1035,-705,15,-720,-70
"39020",NA,39145,"Scioto County, OH","County or equivalent",2004,76378,-792,-17,1018,1035,-705,15,-720,-70
"39060",NA,NA,"Pottsville, PA","Micropolitan Statistical Area",2004,146428,-877,-765,1385,2150,-18,25,-43,-94
"39060",NA,42107,"Schuylkill County, PA","County or equivalent",2004,146428,-877,-765,1385,2150,-18,25,-43,-94
"39220",NA,NA,"Price, UT","Micropolitan Statistical Area",2004,19444,-224,124,343,219,-324,10,-334,-24
"39220",NA,49007,"Carbon County, UT","County or equivalent",2004,19444,-224,124,343,219,-324,10,-334,-24
"39260",NA,NA,"Prineville, OR","Micropolitan Statistical Area",2004,21171,770,58,244,186,747,22,725,-35
"39260",NA,41013,"Crook County, OR","County or equivalent",2004,21171,770,58,244,186,747,22,725,-35
"39420",NA,NA,"Pullman, WA","Micropolitan Statistical Area",2004,41125,466,199,403,204,297,178,119,-30
"39420",NA,53075,"Whitman County, WA","County or equivalent",2004,41125,466,199,403,204,297,178,119,-30
"39500",NA,NA,"Quincy, IL-MO","Micropolitan Statistical Area",2004,76896,-532,-83,864,947,-386,17,-403,-63
"39500",NA,17001,"Adams County, IL","County or equivalent",2004,66750,-456,-63,774,837,-338,17,-355,-55
"39500",NA,29111,"Lewis County, MO","County or equivalent",2004,10146,-76,-20,90,110,-48,0,-48,-8
"39700",NA,NA,"Raymondville, TX","Micropolitan Statistical Area",2004,20009,164,287,398,111,-106,41,-147,-17
"39700",NA,48489,"Willacy County, TX","County or equivalent",2004,20009,164,287,398,111,-106,41,-147,-17
"39780",NA,NA,"Red Bluff, CA","Micropolitan Statistical Area",2004,58818,866,129,776,647,800,74,726,-63
"39780",NA,6103,"Tehama County, CA","County or equivalent",2004,58818,866,129,776,647,800,74,726,-63
"39860",NA,NA,"Red Wing, MN","Micropolitan Statistical Area",2004,45255,300,170,592,422,163,15,148,-33
"39860",NA,27049,"Goodhue County, MN","County or equivalent",2004,45255,300,170,592,422,163,15,148,-33
"39940",NA,NA,"Rexburg, ID","Micropolitan Statistical Area",2004,45912,2684,776,991,215,1257,65,1192,651
"39940",NA,16043,"Fremont County, ID","County or equivalent",2004,12367,196,144,242,98,60,36,24,-8
"39940",NA,16065,"Madison County, ID","County or equivalent",2004,33545,2488,632,749,117,1197,29,1168,659
"39980",NA,NA,"Richmond, IN","Micropolitan Statistical Area",2004,69293,-600,121,901,780,-655,39,-694,-66
"39980",NA,18177,"Wayne County, IN","County or equivalent",2004,69293,-600,121,901,780,-655,39,-694,-66
"40080",NA,NA,"Richmond-Berea, KY","Micropolitan Statistical Area",2004,93446,1739,428,1177,749,1413,48,1365,-102
"40080",NA,21151,"Madison County, KY","County or equivalent",2004,76901,1734,394,954,560,1432,47,1385,-92
"40080",NA,21203,"Rockcastle County, KY","County or equivalent",2004,16545,5,34,223,189,-19,1,-20,-10
"40100",NA,NA,"Rio Grande City-Roma, TX","Micropolitan Statistical Area",2004,58802,1408,1188,1486,298,272,382,-110,-52
"40100",NA,48427,"Starr County, TX","County or equivalent",2004,58802,1408,1188,1486,298,272,382,-110,-52
"40180",NA,NA,"Riverton, WY","Micropolitan Statistical Area",2004,35941,144,146,507,361,22,7,15,-24
"40180",NA,56013,"Fremont County, WY","County or equivalent",2004,35941,144,146,507,361,22,7,15,-24
"40260",NA,NA,"Roanoke Rapids, NC","Micropolitan Statistical Area",2004,76765,-706,40,1007,967,-675,31,-706,-71
"40260",NA,37083,"Halifax County, NC","County or equivalent",2004,55685,-357,82,758,676,-390,25,-415,-49
"40260",NA,37131,"Northampton County, NC","County or equivalent",2004,21080,-349,-42,249,291,-285,6,-291,-22
"40300",NA,NA,"Rochelle, IL","Micropolitan Statistical Area",2004,53343,550,90,576,486,352,87,265,108
"40300",NA,17141,"Ogle County, IL","County or equivalent",2004,53343,550,90,576,486,352,87,265,108
"40460",NA,NA,"Rockingham, NC","Micropolitan Statistical Area",2004,45962,-152,100,636,536,-216,84,-300,-36
"40460",NA,37153,"Richmond County, NC","County or equivalent",2004,45962,-152,100,636,536,-216,84,-300,-36
"40500",NA,NA,"Rockland, ME","Micropolitan Statistical Area",2004,40837,195,-37,390,427,265,17,248,-33
"40500",NA,23013,"Knox County, ME","County or equivalent",2004,40837,195,-37,390,427,265,17,248,-33
"40540",NA,NA,"Rock Springs, WY","Micropolitan Statistical Area",2004,36883,307,271,574,303,62,16,46,-26
"40540",NA,56037,"Sweetwater County, WY","County or equivalent",2004,36883,307,271,574,303,62,16,46,-26
"40620",NA,NA,"Rolla, MO","Micropolitan Statistical Area",2004,41522,461,93,521,428,402,97,305,-34
"40620",NA,29161,"Phelps County, MO","County or equivalent",2004,41522,461,93,521,428,402,97,305,-34
"40700",NA,NA,"Roseburg, OR","Micropolitan Statistical Area",2004,102052,719,-120,1114,1234,929,36,893,-90
"40700",NA,41019,"Douglas County, OR","County or equivalent",2004,102052,719,-120,1114,1234,929,36,893,-90
"40740",NA,NA,"Roswell, NM","Micropolitan Statistical Area",2004,60722,42,333,963,630,-243,126,-369,-48
"40740",NA,35005,"Chaves County, NM","County or equivalent",2004,60722,42,333,963,630,-243,126,-369,-48
"40760",NA,NA,"Ruidoso, NM","Micropolitan Statistical Area",2004,20405,335,89,246,157,271,28,243,-25
"40760",NA,35027,"Lincoln County, NM","County or equivalent",2004,20405,335,89,246,157,271,28,243,-25
"40780",NA,NA,"Russellville, AR","Micropolitan Statistical Area",2004,77453,797,350,1113,763,442,127,315,5
"40780",NA,5115,"Pope County, AR","County or equivalent",2004,56359,927,270,784,514,629,27,602,28
"40780",NA,5149,"Yell County, AR","County or equivalent",2004,21094,-130,80,329,249,-187,100,-287,-23
"40820",NA,NA,"Ruston, LA","Micropolitan Statistical Area",2004,57895,340,146,705,559,240,42,198,-46
"40820",NA,22049,"Jackson Parish, LA","County or equivalent",2004,15151,-38,2,197,195,-30,0,-30,-10
"40820",NA,22061,"Lincoln Parish, LA","County or equivalent",2004,42744,378,144,508,364,270,42,228,-36
"40860",NA,NA,"Rutland, VT","Micropolitan Statistical Area",2004,63397,-28,-26,607,633,38,8,30,-40
"40860",NA,50021,"Rutland County, VT","County or equivalent",2004,63397,-28,-26,607,633,38,8,30,-40
"40940",NA,NA,"Safford, AZ","Micropolitan Statistical Area",2004,39737,-416,212,521,309,-584,22,-606,-44
"40940",NA,4009,"Graham County, AZ","County or equivalent",2004,32430,-343,181,439,258,-488,16,-504,-36
"40940",NA,4011,"Greenlee County, AZ","County or equivalent",2004,7307,-73,31,82,51,-96,6,-102,-8
"41220",NA,NA,"St. Marys, GA","Micropolitan Statistical Area",2004,45185,737,504,755,251,266,345,-79,-33
"41220",NA,13039,"Camden County, GA","County or equivalent",2004,45185,737,504,755,251,266,345,-79,-33
"41260",NA,NA,"St. Marys, PA","Micropolitan Statistical Area",2004,33719,-333,-80,316,396,-227,4,-231,-26
"41260",NA,42047,"Elk County, PA","County or equivalent",2004,33719,-333,-80,316,396,-227,4,-231,-26
"41460",NA,NA,"Salina, KS","Micropolitan Statistical Area",2004,59874,27,224,834,610,-151,77,-228,-46
"41460",NA,20143,"Ottawa County, KS","County or equivalent",2004,6039,-58,-5,73,78,-47,0,-47,-6
"41460",NA,20169,"Saline County, KS","County or equivalent",2004,53835,85,229,761,532,-104,77,-181,-40
"41580",NA,NA,"Salisbury, NC","Micropolitan Statistical Area",2004,133119,-127,378,1647,1269,-401,297,-698,-104
"41580",NA,37159,"Rowan County, NC","County or equivalent",2004,133119,-127,378,1647,1269,-401,297,-698,-104
"41820",NA,NA,"Sanford, NC","Micropolitan Statistical Area",2004,54417,1545,376,877,501,-253,267,-520,1422
"41820",NA,37105,"Lee County, NC","County or equivalent",2004,54417,1545,376,877,501,-253,267,-520,1422
"42300",NA,NA,"Sault Ste. Marie, MI","Micropolitan Statistical Area",2004,38506,-75,77,393,316,-124,21,-145,-28
"42300",NA,26033,"Chippewa County, MI","County or equivalent",2004,38506,-75,77,393,316,-124,21,-145,-28
"42380",NA,NA,"Sayre, PA","Micropolitan Statistical Area",2004,61821,-144,13,729,716,-111,7,-118,-46
"42380",NA,42015,"Bradford County, PA","County or equivalent",2004,61821,-144,13,729,716,-111,7,-118,-46
"42420",NA,NA,"Scottsbluff, NE","Micropolitan Statistical Area",2004,36996,-209,100,541,441,-273,46,-319,-36
"42420",NA,31007,"Banner County, NE","County or equivalent",2004,748,-15,1,4,3,-15,0,-15,-1
"42420",NA,31157,"Scotts Bluff County, NE","County or equivalent",2004,36248,-194,99,537,438,-258,46,-304,-35
"42460",NA,NA,"Scottsboro, AL","Micropolitan Statistical Area",2004,53225,-266,56,654,598,-282,11,-293,-40
"42460",NA,1071,"Jackson County, AL","County or equivalent",2004,53225,-266,56,654,598,-282,11,-293,-40
"42500",NA,NA,"Scottsburg, IN","Micropolitan Statistical Area",2004,23400,-59,69,285,216,-109,0,-109,-19
"42500",NA,18143,"Scott County, IN","County or equivalent",2004,23400,-59,69,285,216,-109,0,-109,-19
"42580",NA,NA,"Seaford, DE","Micropolitan Statistical Area",2004,171260,3541,277,2121,1844,3471,270,3201,-207
"42580",NA,10005,"Sussex County, DE","County or equivalent",2004,171260,3541,277,2121,1844,3471,270,3201,-207
"42620",NA,NA,"Searcy, AR","Micropolitan Statistical Area",2004,70380,991,149,898,749,912,48,864,-70
"42620",NA,5145,"White County, AR","County or equivalent",2004,70380,991,149,898,749,912,48,864,-70
"42700",NA,NA,"Sebring, FL","Micropolitan Statistical Area",2004,92640,2010,-476,948,1424,2626,288,2338,-140
"42700",NA,12055,"Highlands County, FL","County or equivalent",2004,92640,2010,-476,948,1424,2626,288,2338,-140
"42740",NA,NA,"Sedalia, MO","Micropolitan Statistical Area",2004,39539,111,150,563,413,-12,78,-90,-27
"42740",NA,29159,"Pettis County, MO","County or equivalent",2004,39539,111,150,563,413,-12,78,-90,-27
"42780",NA,NA,"Selinsgrove, PA","Micropolitan Statistical Area",2004,37959,66,133,468,335,-42,3,-45,-25
"42780",NA,42109,"Snyder County, PA","County or equivalent",2004,37959,66,133,468,335,-42,3,-45,-25
"42820",NA,NA,"Selma, AL","Micropolitan Statistical Area",2004,43945,-572,119,708,589,-647,3,-650,-44
"42820",NA,1047,"Dallas County, AL","County or equivalent",2004,43945,-572,119,708,589,-647,3,-650,-44
"42860",NA,NA,"Seneca, SC","Micropolitan Statistical Area",2004,68560,455,122,832,710,392,63,329,-59
"42860",NA,45073,"Oconee County, SC","County or equivalent",2004,68560,455,122,832,710,392,63,329,-59
"42900",NA,NA,"Seneca Falls, NY","Micropolitan Statistical Area",2004,34649,-67,14,334,320,-57,21,-78,-24
"42900",NA,36099,"Seneca County, NY","County or equivalent",2004,34649,-67,14,334,320,-57,21,-78,-24
"42940",NA,NA,"Sevierville, TN","Micropolitan Statistical Area",2004,77244,1659,181,927,746,1576,43,1533,-98
"42940",NA,47155,"Sevier County, TN","County or equivalent",2004,77244,1659,181,927,746,1576,43,1533,-98
"42980",NA,NA,"Seymour, IN","Micropolitan Statistical Area",2004,41556,64,202,597,395,-104,77,-181,-34
"42980",NA,18071,"Jackson County, IN","County or equivalent",2004,41556,64,202,597,395,-104,77,-181,-34
"43060",NA,NA,"Shawnee, OK","Micropolitan Statistical Area",2004,67413,-131,134,890,756,-214,27,-241,-51
"43060",NA,40125,"Pottawatomie County, OK","County or equivalent",2004,67413,-131,134,890,756,-214,27,-241,-51
"43140",NA,NA,"Shelby, NC","Micropolitan Statistical Area",2004,97626,15,172,1221,1049,-88,62,-150,-69
"43140",NA,37045,"Cleveland County, NC","County or equivalent",2004,97626,15,172,1221,1049,-88,62,-150,-69
"43180",NA,NA,"Shelbyville, TN","Micropolitan Statistical Area",2004,40759,908,259,639,380,693,182,511,-44
"43180",NA,47003,"Bedford County, TN","County or equivalent",2004,40759,908,259,639,380,693,182,511,-44
"43220",NA,NA,"Shelton, WA","Micropolitan Statistical Area",2004,52727,1192,59,587,528,1204,53,1151,-71
"43220",NA,53045,"Mason County, WA","County or equivalent",2004,52727,1192,59,587,528,1204,53,1151,-71
"43260",NA,NA,"Sheridan, WY","Micropolitan Statistical Area",2004,26997,28,31,336,305,16,10,6,-19
"43260",NA,56033,"Sheridan County, WY","County or equivalent",2004,26997,28,31,336,305,16,10,6,-19
"43320",NA,NA,"Show Low, AZ","Micropolitan Statistical Area",2004,105018,1801,953,1767,814,942,56,886,-94
"43320",NA,4017,"Navajo County, AZ","County or equivalent",2004,105018,1801,953,1767,814,942,56,886,-94
"43380",NA,NA,"Sidney, OH","Micropolitan Statistical Area",2004,48262,-3,349,747,398,-312,43,-355,-40
"43380",NA,39149,"Shelby County, OH","County or equivalent",2004,48262,-3,349,747,398,-312,43,-355,-40
"43420",NA,NA,"Sierra Vista-Douglas, AZ","Micropolitan Statistical Area",2004,123120,2035,657,1791,1134,1488,617,871,-110
"43420",NA,4003,"Cochise County, AZ","County or equivalent",2004,123120,2035,657,1791,1134,1488,617,871,-110
"43460",NA,NA,"Sikeston, MO","Micropolitan Statistical Area",2004,40443,39,188,597,409,-121,13,-134,-28
"43460",NA,29201,"Scott County, MO","County or equivalent",2004,40443,39,188,597,409,-121,13,-134,-28
"43500",NA,NA,"Silver City, NM","Micropolitan Statistical Area",2004,29032,-450,1,323,322,-418,9,-427,-33
"43500",NA,35017,"Grant County, NM","County or equivalent",2004,29032,-450,1,323,322,-418,9,-427,-33
"43540",NA,NA,"Silverthorne, CO","Micropolitan Statistical Area",2004,25207,-116,306,353,47,-389,209,-598,-33
"43540",NA,8117,"Summit County, CO","County or equivalent",2004,25207,-116,306,353,47,-389,209,-598,-33
"43660",NA,NA,"Snyder, TX","Micropolitan Statistical Area",2004,15856,139,64,242,178,88,10,78,-13
"43660",NA,48415,"Scurry County, TX","County or equivalent",2004,15856,139,64,242,178,88,10,78,-13
"43700",NA,NA,"Somerset, KY","Micropolitan Statistical Area",2004,58348,751,78,758,680,730,14,716,-57
"43700",NA,21199,"Pulaski County, KY","County or equivalent",2004,58348,751,78,758,680,730,14,716,-57
"43740",NA,NA,"Somerset, PA","Micropolitan Statistical Area",2004,78955,-455,-201,744,945,-199,12,-211,-55
"43740",NA,42111,"Somerset County, PA","County or equivalent",2004,78955,-455,-201,744,945,-199,12,-211,-55
"43860",NA,NA,"Southern Pines-Pinehurst, NC","Micropolitan Statistical Area",2004,79520,1081,-37,905,942,1205,179,1026,-87
"43860",NA,37125,"Moore County, NC","County or equivalent",2004,79520,1081,-37,905,942,1205,179,1026,-87
"43940",NA,NA,"Spearfish, SD","Micropolitan Statistical Area",2004,22463,444,59,252,193,411,3,408,-26
"43940",NA,46081,"Lawrence County, SD","County or equivalent",2004,22463,444,59,252,193,411,3,408,-26
"43980",NA,NA,"Spencer, IA","Micropolitan Statistical Area",2004,16908,-41,54,213,159,-81,14,-95,-14
"43980",NA,19041,"Clay County, IA","County or equivalent",2004,16908,-41,54,213,159,-81,14,-95,-14
"44020",NA,NA,"Spirit Lake, IA","Micropolitan Statistical Area",2004,16480,158,0,180,180,176,0,176,-18
"44020",NA,19059,"Dickinson County, IA","County or equivalent",2004,16480,158,0,180,180,176,0,176,-18
"44260",NA,NA,"Starkville, MS","Micropolitan Statistical Area",2004,42082,-126,304,573,269,-388,101,-489,-42
"44260",NA,28105,"Oktibbeha County, MS","County or equivalent",2004,42082,-126,304,573,269,-388,101,-489,-42
"44340",NA,NA,"Statesboro, GA","Micropolitan Statistical Area",2004,61223,1565,372,799,427,1270,73,1197,-77
"44340",NA,13031,"Bulloch County, GA","County or equivalent",2004,61223,1565,372,799,427,1270,73,1197,-77
"44380",NA,NA,"Statesville-Mooresville, NC","Micropolitan Statistical Area",2004,136162,3329,664,1767,1103,2833,263,2570,-168
"44380",NA,37097,"Iredell County, NC","County or equivalent",2004,136162,3329,664,1767,1103,2833,263,2570,-168
"44420",NA,NA,"Staunton-Waynesboro, VA","Micropolitan Statistical Area",2004,112073,1179,177,1333,1156,1113,54,1059,-111
"44420",NA,51015,"Augusta County, VA","County or equivalent",2004,68116,960,119,752,633,912,29,883,-71
"44420",NA,51790,"Staunton city, VA","County or equivalent",2004,23166,-91,-47,278,325,-24,5,-29,-20
"44420",NA,51820,"Waynesboro city, VA","County or equivalent",2004,20791,310,105,303,198,225,20,205,-20
"44500",NA,NA,"Stephenville, TX","Micropolitan Statistical Area",2004,34201,579,106,447,341,507,68,439,-34
"44500",NA,48143,"Erath County, TX","County or equivalent",2004,34201,579,106,447,341,507,68,439,-34
"44540",NA,NA,"Sterling, CO","Micropolitan Statistical Area",2004,21128,-161,28,238,210,-169,39,-208,-20
"44540",NA,8075,"Logan County, CO","County or equivalent",2004,21128,-161,28,238,210,-169,39,-208,-20
"44580",NA,NA,"Sterling, IL","Micropolitan Statistical Area",2004,59461,-103,82,717,635,-140,42,-182,-45
"44580",NA,17195,"Whiteside County, IL","County or equivalent",2004,59461,-103,82,717,635,-140,42,-182,-45
"44620",NA,NA,"Stevens Point, WI","Micropolitan Statistical Area",2004,67409,-30,291,746,455,-268,39,-307,-53
"44620",NA,55097,"Portage County, WI","County or equivalent",2004,67409,-30,291,746,455,-268,39,-307,-53
"44660",NA,NA,"Stillwater, OK","Micropolitan Statistical Area",2004,74780,1398,320,872,552,29,226,-197,1049
"44660",NA,40119,"Payne County, OK","County or equivalent",2004,74780,1398,320,872,552,29,226,-197,1049
"44740",NA,NA,"Storm Lake, IA","Micropolitan Statistical Area",2004,19804,-185,72,242,170,-234,113,-347,-23
"44740",NA,19021,"Buena Vista County, IA","County or equivalent",2004,19804,-185,72,242,170,-234,113,-347,-23
"44780",NA,NA,"Sturgis, MI","Micropolitan Statistical Area",2004,62349,-64,329,946,617,-341,107,-448,-52
"44780",NA,26149,"St. Joseph County, MI","County or equivalent",2004,62349,-64,329,946,617,-341,107,-448,-52
"44860",NA,NA,"Sulphur Springs, TX","Micropolitan Statistical Area",2004,32859,384,43,441,398,370,54,316,-29
"44860",NA,48223,"Hopkins County, TX","County or equivalent",2004,32859,384,43,441,398,370,54,316,-29
"44900",NA,NA,"Summerville, GA","Micropolitan Statistical Area",2004,25865,-377,19,325,306,-367,21,-388,-29
"44900",NA,13055,"Chattooga County, GA","County or equivalent",2004,25865,-377,19,325,306,-367,21,-388,-29
"44980",NA,NA,"Sunbury, PA","Micropolitan Statistical Area",2004,92039,-531,-252,927,1179,-212,21,-233,-67
"44980",NA,42097,"Northumberland County, PA","County or equivalent",2004,92039,-531,-252,927,1179,-212,21,-233,-67
"45000",NA,NA,"Susanville, CA","Micropolitan Statistical Area",2004,34119,410,69,279,210,375,5,370,-34
"45000",NA,6035,"Lassen County, CA","County or equivalent",2004,34119,410,69,279,210,375,5,370,-34
"45020",NA,NA,"Sweetwater, TX","Micropolitan Statistical Area",2004,14858,-145,16,223,207,-149,7,-156,-12
"45020",NA,48353,"Nolan County, TX","County or equivalent",2004,14858,-145,16,223,207,-149,7,-156,-12
"45140",NA,NA,"Tahlequah, OK","Micropolitan Statistical Area",2004,44132,282,198,600,402,112,72,40,-28
"45140",NA,40021,"Cherokee County, OK","County or equivalent",2004,44132,282,198,600,402,112,72,40,-28
"45180",NA,NA,"Talladega-Sylacauga, AL","Micropolitan Statistical Area",2004,79724,-35,106,984,878,-89,18,-107,-52
"45180",NA,1121,"Talladega County, AL","County or equivalent",2004,79724,-35,106,984,878,-89,18,-107,-52
"45260",NA,NA,"Tallulah, LA","Micropolitan Statistical Area",2004,12261,-359,7,164,157,-348,0,-348,-18
"45260",NA,22065,"Madison Parish, LA","County or equivalent",2004,12261,-359,7,164,157,-348,0,-348,-18
"45340",NA,NA,"Taos, NM","Micropolitan Statistical Area",2004,31112,229,138,384,246,112,47,65,-21
"45340",NA,35055,"Taos County, NM","County or equivalent",2004,31112,229,138,384,246,112,47,65,-21
"45380",NA,NA,"Taylorville, IL","Micropolitan Statistical Area",2004,35020,70,29,425,396,66,13,53,-25
"45380",NA,17021,"Christian County, IL","County or equivalent",2004,35020,70,29,425,396,66,13,53,-25
"45540",NA,NA,"The Villages, FL","Micropolitan Statistical Area",2004,60062,1261,-256,482,738,1623,45,1578,-106
"45540",NA,12119,"Sumter County, FL","County or equivalent",2004,60062,1261,-256,482,738,1623,45,1578,-106
"45580",NA,NA,"Thomaston, GA","Micropolitan Statistical Area",2004,27478,-111,-92,312,404,2,32,-30,-21
"45580",NA,13293,"Upson County, GA","County or equivalent",2004,27478,-111,-92,312,404,2,32,-30,-21
"45620",NA,NA,"Thomasville, GA","Micropolitan Statistical Area",2004,43317,-74,115,582,467,-155,22,-177,-34
"45620",NA,13275,"Thomas County, GA","County or equivalent",2004,43317,-74,115,582,467,-155,22,-177,-34
"45640",NA,NA,"Thomasville-Lexington, NC","Micropolitan Statistical Area",2004,152331,959,566,1996,1430,499,317,182,-106
"45640",NA,37057,"Davidson County, NC","County or equivalent",2004,152331,959,566,1996,1430,499,317,182,-106
"45660",NA,NA,"Tiffin, OH","Micropolitan Statistical Area",2004,57532,-223,173,757,584,-347,18,-365,-49
"45660",NA,39147,"Seneca County, OH","County or equivalent",2004,57532,-223,173,757,584,-347,18,-365,-49
"45700",NA,NA,"Tifton, GA","Micropolitan Statistical Area",2004,39921,727,328,671,343,431,139,292,-32
"45700",NA,13277,"Tift County, GA","County or equivalent",2004,39921,727,328,671,343,431,139,292,-32
"45740",NA,NA,"Toccoa, GA","Micropolitan Statistical Area",2004,25133,-193,-9,308,317,-163,6,-169,-21
"45740",NA,13257,"Stephens County, GA","County or equivalent",2004,25133,-193,-9,308,317,-163,6,-169,-21
"45860",NA,NA,"Torrington, CT","Micropolitan Statistical Area",2004,187615,957,230,1963,1733,864,160,704,-137
"45860",NA,9005,"Litchfield County, CT","County or equivalent",2004,187615,957,230,1963,1733,864,160,704,-137
"45900",NA,NA,"Traverse City, MI","Micropolitan Statistical Area",2004,138939,1117,450,1623,1173,779,70,709,-112
"45900",NA,26019,"Benzie County, MI","County or equivalent",2004,17246,130,16,195,179,132,5,127,-18
"45900",NA,26055,"Grand Traverse County, MI","County or equivalent",2004,82612,856,345,1012,667,577,53,524,-66
"45900",NA,26079,"Kalkaska County, MI","County or equivalent",2004,17184,55,87,240,153,-20,1,-21,-12
"45900",NA,26089,"Leelanau County, MI","County or equivalent",2004,21897,76,2,176,174,90,11,79,-16
"45980",NA,NA,"Troy, AL","Micropolitan Statistical Area",2004,29722,316,109,412,303,233,30,203,-26
"45980",NA,1109,"Pike County, AL","County or equivalent",2004,29722,316,109,412,303,233,30,203,-26
"46020",NA,NA,"Truckee-Grass Valley, CA","Micropolitan Statistical Area",2004,95987,784,-220,773,993,1098,73,1025,-94
"46020",NA,6057,"Nevada County, CA","County or equivalent",2004,95987,784,-220,773,993,1098,73,1025,-94
"46100",NA,NA,"Tullahoma, TN","Micropolitan Statistical Area",2004,96212,709,100,1162,1062,688,74,614,-79
"46100",NA,47031,"Coffee County, TN","County or equivalent",2004,49931,438,74,656,582,407,55,352,-43
"46100",NA,47051,"Franklin County, TN","County or equivalent",2004,40357,206,17,447,430,220,18,202,-31
"46100",NA,47127,"Moore County, TN","County or equivalent",2004,5924,65,9,59,50,61,1,60,-5
"46180",NA,NA,"Tupelo, MS","Micropolitan Statistical Area",2004,128540,590,633,1891,1258,48,56,-8,-91
"46180",NA,28057,"Itawamba County, MS","County or equivalent",2004,22894,-37,-12,294,306,-10,3,-13,-15
"46180",NA,28081,"Lee County, MS","County or equivalent",2004,77724,384,517,1218,701,-78,38,-116,-55
"46180",NA,28115,"Pontotoc County, MS","County or equivalent",2004,27922,243,128,379,251,136,15,121,-21
"46260",NA,NA,"Tuskegee, AL","Micropolitan Statistical Area",2004,23045,-430,-48,227,275,-358,15,-373,-24
"46260",NA,1087,"Macon County, AL","County or equivalent",2004,23045,-430,-48,227,275,-358,15,-373,-24
"46300",NA,NA,"Twin Falls, ID","Micropolitan Statistical Area",2004,86754,1375,627,1423,796,816,225,591,-68
"46300",NA,16053,"Jerome County, ID","County or equivalent",2004,18966,283,201,332,131,95,62,33,-13
"46300",NA,16083,"Twin Falls County, ID","County or equivalent",2004,67788,1092,426,1091,665,721,163,558,-55
"46380",NA,NA,"Ukiah, CA","Micropolitan Statistical Area",2004,87214,-267,204,1069,865,-398,270,-668,-73
"46380",NA,6045,"Mendocino County, CA","County or equivalent",2004,87214,-267,204,1069,865,-398,270,-668,-73
"46420",NA,NA,"Union, SC","Micropolitan Statistical Area",2004,28467,-449,-56,332,388,-366,8,-374,-27
"46420",NA,45087,"Union County, SC","County or equivalent",2004,28467,-449,-56,332,388,-366,8,-374,-27
"46460",NA,NA,"Union City, TN-KY","Micropolitan Statistical Area",2004,39328,-229,-21,456,477,-178,23,-201,-30
"46460",NA,21075,"Fulton County, KY","County or equivalent",2004,7278,-154,-19,75,94,-126,0,-126,-9
"46460",NA,47131,"Obion County, TN","County or equivalent",2004,32050,-75,-2,381,383,-52,23,-75,-21
"46500",NA,NA,"Urbana, OH","Micropolitan Statistical Area",2004,39237,86,87,502,415,24,2,22,-25
"46500",NA,39021,"Champaign County, OH","County or equivalent",2004,39237,86,87,502,415,24,2,22,-25
"46620",NA,NA,"Uvalde, TX","Micropolitan Statistical Area",2004,26360,-8,207,450,243,-192,41,-233,-23
"46620",NA,48463,"Uvalde County, TX","County or equivalent",2004,26360,-8,207,450,243,-192,41,-233,-23
"46740",NA,NA,"Valley, AL","Micropolitan Statistical Area",2004,35353,-241,-15,436,451,-198,18,-216,-28
"46740",NA,1017,"Chambers County, AL","County or equivalent",2004,35353,-241,-15,436,451,-198,18,-216,-28
"46780",NA,NA,"Van Wert, OH","Micropolitan Statistical Area",2004,29143,-9,58,387,329,-47,5,-52,-20
"46780",NA,39161,"Van Wert County, OH","County or equivalent",2004,29143,-9,58,387,329,-47,5,-52,-20
"46820",NA,NA,"Vermillion, SD","Micropolitan Statistical Area",2004,13265,-132,57,156,99,-174,16,-190,-15
"46820",NA,46027,"Clay County, SD","County or equivalent",2004,13265,-132,57,156,99,-174,16,-190,-15
"46860",NA,NA,"Vernal, UT","Micropolitan Statistical Area",2004,26464,285,300,515,215,2,10,-8,-17
"46860",NA,49047,"Uintah County, UT","County or equivalent",2004,26464,285,300,515,215,2,10,-8,-17
"46900",NA,NA,"Vernon, TX","Micropolitan Statistical Area",2004,13896,-195,28,229,201,-207,12,-219,-16
"46900",NA,48487,"Wilbarger County, TX","County or equivalent",2004,13896,-195,28,229,201,-207,12,-219,-16
"46980",NA,NA,"Vicksburg, MS","Micropolitan Statistical Area",2004,48884,107,259,765,506,-116,19,-135,-36
"46980",NA,28149,"Warren County, MS","County or equivalent",2004,48884,107,259,765,506,-116,19,-135,-36
"47080",NA,NA,"Vidalia, GA","Micropolitan Statistical Area",2004,35341,417,183,545,362,263,92,171,-29
"47080",NA,13209,"Montgomery County, GA","County or equivalent",2004,8950,199,35,121,86,175,11,164,-11
"47080",NA,13279,"Toombs County, GA","County or equivalent",2004,26391,218,148,424,276,88,81,7,-18
"47180",NA,NA,"Vincennes, IN","Micropolitan Statistical Area",2004,38403,-11,-25,446,471,40,33,7,-26
"47180",NA,18083,"Knox County, IN","County or equivalent",2004,38403,-11,-25,446,471,40,33,7,-26
"47340",NA,NA,"Wabash, IN","Micropolitan Statistical Area",2004,33870,-244,-7,375,382,-207,1,-208,-30
"47340",NA,18169,"Wabash County, IN","County or equivalent",2004,33870,-244,-7,375,382,-207,1,-208,-30
"47420",NA,NA,"Wahpeton, ND-MN","Micropolitan Statistical Area",2004,24076,-329,69,295,226,-372,10,-382,-26
"47420",NA,27167,"Wilkin County, MN","County or equivalent",2004,6731,-136,14,89,75,-142,2,-144,-8
"47420",NA,38077,"Richland County, ND","County or equivalent",2004,17345,-193,55,206,151,-230,8,-238,-18
"47460",NA,NA,"Walla Walla, WA","Micropolitan Statistical Area",2004,56963,599,219,710,491,423,139,284,-43
"47460",NA,53071,"Walla Walla County, WA","County or equivalent",2004,56963,599,219,710,491,423,139,284,-43
"47500",NA,NA,"Walterboro, SC","Micropolitan Statistical Area",2004,38852,152,97,507,410,83,26,57,-28
"47500",NA,45029,"Colleton County, SC","County or equivalent",2004,38852,152,97,507,410,83,26,57,-28
"47540",NA,NA,"Wapakoneta, OH","Micropolitan Statistical Area",2004,46384,80,157,583,426,-43,18,-61,-34
"47540",NA,39011,"Auglaize County, OH","County or equivalent",2004,46384,80,157,583,426,-43,18,-61,-34
"47620",NA,NA,"Warren, PA","Micropolitan Statistical Area",2004,42167,-363,-80,405,485,-249,2,-251,-34
"47620",NA,42123,"Warren County, PA","County or equivalent",2004,42167,-363,-80,405,485,-249,2,-251,-34
"47660",NA,NA,"Warrensburg, MO","Micropolitan Statistical Area",2004,51160,660,435,761,326,259,267,-8,-34
"47660",NA,29101,"Johnson County, MO","County or equivalent",2004,51160,660,435,761,326,259,267,-8,-34
"47700",NA,NA,"Warsaw, IN","Micropolitan Statistical Area",2004,75032,167,473,1082,609,-249,99,-348,-57
"47700",NA,18085,"Kosciusko County, IN","County or equivalent",2004,75032,167,473,1082,609,-249,99,-348,-57
"47780",NA,NA,"Washington, IN","Micropolitan Statistical Area",2004,29911,113,224,491,267,-88,39,-127,-23
"47780",NA,18027,"Daviess County, IN","County or equivalent",2004,29911,113,224,491,267,-88,39,-127,-23
"47820",NA,NA,"Washington, NC","Micropolitan Statistical Area",2004,45080,74,-1,559,560,104,54,50,-29
"47820",NA,37013,"Beaufort County, NC","County or equivalent",2004,45080,74,-1,559,560,104,54,50,-29
"47920",NA,NA,"Washington Court House, OH","Micropolitan Statistical Area",2004,28082,-53,23,372,349,-56,9,-65,-20
"47920",NA,39047,"Fayette County, OH","County or equivalent",2004,28082,-53,23,372,349,-56,9,-65,-20
"47980",NA,NA,"Watertown, SD","Micropolitan Statistical Area",2004,31357,-26,155,460,305,-154,12,-166,-27
"47980",NA,46029,"Codington County, SD","County or equivalent",2004,25849,-14,132,372,240,-124,12,-136,-22
"47980",NA,46057,"Hamlin County, SD","County or equivalent",2004,5508,-12,23,88,65,-30,0,-30,-5
"48020",NA,NA,"Watertown-Fort Atkinson, WI","Micropolitan Statistical Area",2004,77971,880,439,1037,598,501,86,415,-60
"48020",NA,55055,"Jefferson County, WI","County or equivalent",2004,77971,880,439,1037,598,501,86,415,-60
"48060",NA,NA,"Watertown-Fort Drum, NY","Micropolitan Statistical Area",2004,114424,1064,767,1652,885,-2337,637,-2974,2634
"48060",NA,36045,"Jefferson County, NY","County or equivalent",2004,114424,1064,767,1652,885,-2337,637,-2974,2634
"48100",NA,NA,"Wauchula, FL","Micropolitan Statistical Area",2004,27596,220,276,499,223,-32,196,-228,-24
"48100",NA,12049,"Hardee County, FL","County or equivalent",2004,27596,220,276,499,223,-32,196,-228,-24
"48180",NA,NA,"Waycross, GA","Micropolitan Statistical Area",2004,51624,229,131,766,635,155,65,90,-57
"48180",NA,13229,"Pierce County, GA","County or equivalent",2004,16723,475,47,251,204,451,17,434,-23
"48180",NA,13299,"Ware County, GA","County or equivalent",2004,34901,-246,84,515,431,-296,48,-344,-34
"48460",NA,NA,"West Plains, MO","Micropolitan Statistical Area",2004,37535,210,48,534,486,192,23,169,-30
"48460",NA,29091,"Howell County, MO","County or equivalent",2004,37535,210,48,534,486,192,23,169,-30
"48500",NA,NA,"West Point, MS","Micropolitan Statistical Area",2004,21397,34,56,291,235,-8,9,-17,-14
"48500",NA,28025,"Clay County, MS","County or equivalent",2004,21397,34,56,291,235,-8,9,-17,-14
"48580",NA,NA,"Whitewater, WI","Micropolitan Statistical Area",2004,97458,854,251,1150,899,676,154,522,-73
"48580",NA,55127,"Walworth County, WI","County or equivalent",2004,97458,854,251,1150,899,676,154,522,-73
"48740",NA,NA,"Willimantic, CT","Micropolitan Statistical Area",2004,113873,1547,358,1340,982,1294,175,1119,-105
"48740",NA,9015,"Windham County, CT","County or equivalent",2004,113873,1547,358,1340,982,1294,175,1119,-105
"48780",NA,NA,"Williston, ND","Micropolitan Statistical Area",2004,19138,-114,2,211,209,-101,4,-105,-15
"48780",NA,38105,"Williams County, ND","County or equivalent",2004,19138,-114,2,211,209,-101,4,-105,-15
"48820",NA,NA,"Willmar, MN","Micropolitan Statistical Area",2004,41013,-30,191,572,381,-190,45,-235,-31
"48820",NA,27067,"Kandiyohi County, MN","County or equivalent",2004,41013,-30,191,572,381,-190,45,-235,-31
"48940",NA,NA,"Wilmington, OH","Micropolitan Statistical Area",2004,41804,359,195,606,411,196,32,164,-32
"48940",NA,39027,"Clinton County, OH","County or equivalent",2004,41804,359,195,606,411,196,32,164,-32
"48980",NA,NA,"Wilson, NC","Micropolitan Statistical Area",2004,75049,208,270,1012,742,-13,213,-226,-49
"48980",NA,37195,"Wilson County, NC","County or equivalent",2004,75049,208,270,1012,742,-13,213,-226,-49
"49060",NA,NA,"Winfield, KS","Micropolitan Statistical Area",2004,35140,-256,28,466,438,-255,23,-278,-29
"49060",NA,20035,"Cowley County, KS","County or equivalent",2004,35140,-256,28,466,438,-255,23,-278,-29
"49100",NA,NA,"Winona, MN","Micropolitan Statistical Area",2004,49305,-164,171,546,375,-293,46,-339,-42
"49100",NA,27169,"Winona County, MN","County or equivalent",2004,49305,-164,171,546,375,-293,46,-339,-42
"49260",NA,NA,"Woodward, OK","Micropolitan Statistical Area",2004,18731,307,109,297,188,218,8,210,-20
"49260",NA,40153,"Woodward County, OK","County or equivalent",2004,18731,307,109,297,188,218,8,210,-20
"49300",NA,NA,"Wooster, OH","Micropolitan Statistical Area",2004,112909,125,626,1580,954,-415,74,-489,-86
"49300",NA,39169,"Wayne County, OH","County or equivalent",2004,112909,125,626,1580,954,-415,74,-489,-86
"49380",NA,NA,"Worthington, MN","Micropolitan Statistical Area",2004,20232,-135,141,341,200,-254,58,-312,-22
"49380",NA,27105,"Nobles County, MN","County or equivalent",2004,20232,-135,141,341,200,-254,58,-312,-22
"49460",NA,NA,"Yankton, SD","Micropolitan Statistical Area",2004,21667,142,49,262,213,111,9,102,-18
"49460",NA,46135,"Yankton County, SD","County or equivalent",2004,21667,142,49,262,213,111,9,102,-18
"49540",NA,NA,"Yazoo City, MS","Micropolitan Statistical Area",2004,27775,-20,107,405,298,-107,10,-117,-20
"49540",NA,28163,"Yazoo County, MS","County or equivalent",2004,27775,-20,107,405,298,-107,10,-117,-20
"49780",NA,NA,"Zanesville, OH","Micropolitan Statistical Area",2004,85155,63,178,1089,911,-57,14,-71,-58
"49780",NA,39119,"Muskingum County, OH","County or equivalent",2004,85155,63,178,1089,911,-57,14,-71,-58
"10180",NA,48059,"Callahan County, TX","County or equivalent",2005,13211,104,-3,129,132,118,3,115,-11
"10180",NA,48253,"Jones County, TX","County or equivalent",2005,19544,-182,10,211,201,-182,4,-186,-10
"10180",NA,48441,"Taylor County, TX","County or equivalent",2005,125926,212,908,2117,1209,-581,79,-660,-115
"10420",NA,NA,"Akron, OH","Metropolitan Statistical Area",2005,700403,21,1451,8272,6821,-1229,533,-1762,-201
"10420",NA,39133,"Portage County, OH","County or equivalent",2005,155056,219,343,1659,1316,18,94,-76,-142
"10420",NA,39153,"Summit County, OH","County or equivalent",2005,545347,-198,1108,6613,5505,-1247,439,-1686,-59
"10500",NA,NA,"Albany, GA","Metropolitan Statistical Area",2005,161912,508,980,2315,1335,-371,91,-462,-101
"10500",NA,13007,"Baker County, GA","County or equivalent",2005,3990,-61,-1,32,33,-59,3,-62,-1
"10500",NA,13095,"Dougherty County, GA","County or equivalent",2005,95086,108,682,1488,806,-495,64,-559,-79
"10500",NA,13177,"Lee County, GA","County or equivalent",2005,30864,945,196,331,135,745,17,728,4
"10500",NA,13273,"Terrell County, GA","County or equivalent",2005,10550,-248,33,168,135,-274,2,-276,-7
"10500",NA,13321,"Worth County, GA","County or equivalent",2005,21422,-236,70,296,226,-288,5,-293,-18
"10580",NA,NA,"Albany-Schenectady-Troy, NY","Metropolitan Statistical Area",2005,846361,2550,1667,9333,7666,1687,1083,604,-804
"10580",NA,36001,"Albany County, NY","County or equivalent",2005,298594,-164,261,3106,2845,-142,553,-695,-283
"10580",NA,36083,"Rensselaer County, NY","County or equivalent",2005,154007,161,343,1779,1436,-38,218,-256,-144
"10580",NA,36091,"Saratoga County, NY","County or equivalent",2005,213246,1522,752,2362,1610,971,112,859,-201
"10580",NA,36093,"Schenectady County, NY","County or equivalent",2005,148583,982,319,1793,1474,810,199,611,-147
"10580",NA,36095,"Schoharie County, NY","County or equivalent",2005,31931,49,-8,293,301,86,1,85,-29
"10740",NA,NA,"Albuquerque, NM","Metropolitan Statistical Area",2005,797146,17395,5882,11760,5878,12165,1651,10514,-652
"10740",NA,35001,"Bernalillo County, NM","County or equivalent",2005,606502,12768,4792,9349,4557,8475,1474,7001,-499
"10740",NA,35043,"Sandoval County, NM","County or equivalent",2005,105625,4419,652,1308,656,3849,63,3786,-82
"10740",NA,35057,"Torrance County, NM","County or equivalent",2005,16672,-528,57,177,120,-577,9,-586,-8
"10740",NA,35061,"Valencia County, NM","County or equivalent",2005,68347,736,381,926,545,418,105,313,-63
"10780",NA,NA,"Alexandria, LA","Metropolitan Statistical Area",2005,147050,742,581,2152,1571,194,57,137,-33
"10780",NA,22043,"Grant Parish, LA","County or equivalent",2005,19285,299,43,247,204,274,0,274,-18
"10780",NA,22079,"Rapides Parish, LA","County or equivalent",2005,127765,443,538,1905,1367,-80,57,-137,-15
"10900",NA,NA,"Allentown-Bethlehem-Easton, PA-NJ","Metropolitan Statistical Area",2005,784814,9671,1608,9117,7509,8546,1282,7264,-483
"10900",NA,34041,"Warren County, NJ","County or equivalent",2005,109000,393,402,1294,892,89,176,-87,-98
"10900",NA,42025,"Carbon County, PA","County or equivalent",2005,61541,888,-150,616,766,1098,12,1086,-60
"10900",NA,42077,"Lehigh County, PA","County or equivalent",2005,328563,4460,1025,4197,3172,3730,684,3046,-295
"10900",NA,42095,"Northampton County, PA","County or equivalent",2005,285710,3930,331,3010,2679,3629,410,3219,-30
"11020",NA,NA,"Altoona, PA","Metropolitan Statistical Area",2005,125882,-647,-207,1449,1656,-319,22,-341,-121
"11020",NA,42013,"Blair County, PA","County or equivalent",2005,125882,-647,-207,1449,1656,-319,22,-341,-121
"11100",NA,NA,"Amarillo, TX","Metropolitan Statistical Area",2005,237644,2629,1727,3801,2074,1077,438,639,-175
"11100",NA,48011,"Armstrong County, TX","County or equivalent",2005,2125,31,0,27,27,32,1,31,-1
"11100",NA,48065,"Carson County, TX","County or equivalent",2005,6388,47,10,77,67,43,2,41,-6
"11100",NA,48375,"Potter County, TX","County or equivalent",2005,119434,1217,1096,2304,1208,222,338,-116,-101
"11100",NA,48381,"Randall County, TX","County or equivalent",2005,109697,1334,621,1393,772,780,97,683,-67
"11180",NA,NA,"Ames, IA","Metropolitan Statistical Area",2005,81852,-105,388,881,493,-420,426,-846,-73
"11180",NA,19169,"Story County, IA","County or equivalent",2005,81852,-105,388,881,493,-420,426,-846,-73
"11260",NA,NA,"Anchorage, AK","Metropolitan Statistical Area",2005,351128,5630,3761,5364,1603,2161,413,1748,-292
"11260",NA,2020,"Anchorage Municipality, AK","County or equivalent",2005,276164,1847,3088,4312,1224,-1002,383,-1385,-239
"11260",NA,2170,"Matanuska-Susitna Borough, AK","County or equivalent",2005,74964,3783,673,1052,379,3163,30,3133,-53
"11300",NA,NA,"Anderson, IN","Metropolitan Statistical Area",2005,130603,-595,98,1584,1486,-579,70,-649,-114
"11300",NA,18095,"Madison County, IN","County or equivalent",2005,130603,-595,98,1584,1486,-579,70,-649,-114
"11340",NA,NA,"Anderson, SC","Metropolitan Statistical Area",2005,174232,1644,397,2205,1808,1392,107,1285,-145
"11340",NA,45007,"Anderson County, SC","County or equivalent",2005,174232,1644,397,2205,1808,1392,107,1285,-145
"11460",NA,NA,"Ann Arbor, MI","Metropolitan Statistical Area",2005,344025,3300,2397,4239,1842,1203,1743,-540,-300
"11460",NA,26161,"Washtenaw County, MI","County or equivalent",2005,344025,3300,2397,4239,1842,1203,1743,-540,-300
"11500",NA,NA,"Anniston-Oxford, AL","Metropolitan Statistical Area",2005,111953,433,169,1514,1345,365,43,322,-101
"11500",NA,1015,"Calhoun County, AL","County or equivalent",2005,111953,433,169,1514,1345,365,43,322,-101
"11540",NA,NA,"Appleton, WI","Metropolitan Statistical Area",2005,214120,1959,1472,2923,1451,677,192,485,-190
"11540",NA,55015,"Calumet County, WI","County or equivalent",2005,44044,309,408,683,275,-59,29,-88,-40
"11540",NA,55087,"Outagamie County, WI","County or equivalent",2005,170076,1650,1064,2240,1176,736,163,573,-150
"11700",NA,NA,"Asheville, NC","Metropolitan Statistical Area",2005,390789,4469,23,4463,4440,4784,697,4087,-338
"11700",NA,37021,"Buncombe County, NC","County or equivalent",2005,218605,2828,354,2605,2251,2674,394,2280,-200
"11700",NA,37087,"Haywood County, NC","County or equivalent",2005,55837,23,-166,555,721,232,21,211,-43
"11700",NA,37089,"Henderson County, NC","County or equivalent",2005,96359,1526,-126,1109,1235,1729,272,1457,-77
"11700",NA,37115,"Madison County, NC","County or equivalent",2005,19988,92,-39,194,233,149,10,139,-18
"12020",NA,NA,"Athens-Clarke County, GA","Metropolitan Statistical Area",2005,178844,822,1251,2359,1108,-292,635,-927,-137
"12020",NA,13059,"Clarke County, GA","County or equivalent",2005,108942,-228,874,1450,576,-1020,579,-1599,-82
"12020",NA,13195,"Madison County, GA","County or equivalent",2005,27210,276,98,332,234,198,21,177,-20
"12020",NA,13219,"Oconee County, GA","County or equivalent",2005,29265,728,211,388,177,541,31,510,-24
"12020",NA,13221,"Oglethorpe County, GA","County or equivalent",2005,13427,46,68,189,121,-11,4,-15,-11
"12060",NA,NA,"Atlanta-Sandy Springs-Marietta, GA","Metropolitan Statistical Area",2005,4945773,144508,49906,77733,27827,73461,21999,51462,21141
"12060",NA,13013,"Barrow County, GA","County or equivalent",2005,59355,3188,671,1065,394,2551,47,2504,-34
"12060",NA,13015,"Bartow County, GA","County or equivalent",2005,88161,2013,757,1429,672,1324,106,1218,-68
"12060",NA,13035,"Butts County, GA","County or equivalent",2005,22455,430,106,299,193,336,3,333,-12
"12060",NA,13045,"Carroll County, GA","County or equivalent",2005,104394,3136,704,1538,834,2511,160,2351,-79
"12060",NA,13057,"Cherokee County, GA","County or equivalent",2005,182725,9157,2170,3103,933,7120,419,6701,-133
"12060",NA,13063,"Clayton County, GA","County or equivalent",2005,264644,2525,3247,4593,1346,-528,1220,-1748,-194
"12060",NA,13067,"Cobb County, GA","County or equivalent",2005,661197,9040,7341,10651,3310,2324,3613,-1289,-625
"12060",NA,13077,"Coweta County, GA","County or equivalent",2005,108694,4307,957,1635,678,3422,206,3216,-72
"12060",NA,13085,"Dawson County, GA","County or equivalent",2005,19654,857,90,243,153,781,11,770,-14
"12060",NA,13089,"DeKalb County, GA","County or equivalent",2005,716188,12114,6949,10973,4024,-1744,5904,-7648,6909
"12060",NA,13097,"Douglas County, GA","County or equivalent",2005,112302,5761,1048,1753,705,4799,147,4652,-86
"12060",NA,13113,"Fayette County, GA","County or equivalent",2005,102484,2596,384,970,586,2286,168,2118,-74
"12060",NA,13117,"Forsyth County, GA","County or equivalent",2005,138402,8169,1772,2386,614,6478,308,6170,-81
"12060",NA,13121,"Fulton County, GA","County or equivalent",2005,934242,28440,7293,12826,5533,4309,4436,-127,16838
"12060",NA,13135,"Gwinnett County, GA","County or equivalent",2005,716818,24516,10544,13320,2776,14584,4579,10005,-612
"12060",NA,13143,"Haralson County, GA","County or equivalent",2005,28110,379,67,372,305,337,8,329,-25
"12060",NA,13149,"Heard County, GA","County or equivalent",2005,11233,56,30,133,103,36,2,34,-10
"12060",NA,13151,"Henry County, GA","County or equivalent",2005,166974,9020,1727,2611,884,7414,84,7330,-121
"12060",NA,13159,"Jasper County, GA","County or equivalent",2005,13012,408,107,215,108,313,10,303,-12
"12060",NA,13171,"Lamar County, GA","County or equivalent",2005,16581,282,49,229,180,248,5,243,-15
"12060",NA,13199,"Meriwether County, GA","County or equivalent",2005,22812,7,46,326,280,-18,1,-19,-21
"12060",NA,13217,"Newton County, GA","County or equivalent",2005,85697,5022,822,1419,597,4258,58,4200,-58
"12060",NA,13223,"Paulding County, GA","County or equivalent",2005,111070,6272,1357,1930,573,4983,42,4941,-68
"12060",NA,13227,"Pickens County, GA","County or equivalent",2005,28149,662,87,330,243,592,19,573,-17
"12060",NA,13231,"Pike County, GA","County or equivalent",2005,15970,397,39,177,138,370,1,369,-12
"12060",NA,13247,"Rockdale County, GA","County or equivalent",2005,77761,1477,623,1132,509,926,322,604,-72
"12060",NA,13255,"Spalding County, GA","County or equivalent",2005,61233,535,414,987,573,176,82,94,-55
"12060",NA,13297,"Walton County, GA","County or equivalent",2005,75456,3742,505,1088,583,3273,38,3235,-36
"12100",NA,NA,"Atlantic City-Hammonton, NJ","Metropolitan Statistical Area",2005,268120,2300,1100,3613,2513,1455,1072,383,-255
"12100",NA,34001,"Atlantic County, NJ","County or equivalent",2005,268120,2300,1100,3613,2513,1455,1072,383,-255
"12220",NA,NA,"Auburn-Opelika, AL","Metropolitan Statistical Area",2005,125132,3590,699,1475,776,2990,146,2844,-99
"12220",NA,1081,"Lee County, AL","County or equivalent",2005,125132,3590,699,1475,776,2990,146,2844,-99
"12260",NA,NA,"Augusta-Richmond County, GA-SC","Metropolitan Statistical Area",2005,517079,2961,2845,7413,4568,534,300,234,-418
"12260",NA,13033,"Burke County, GA","County or equivalent",2005,22850,25,127,398,271,-81,3,-84,-21
"12260",NA,13073,"Columbia County, GA","County or equivalent",2005,102209,2638,767,1397,630,1962,82,1880,-91
"12260",NA,13189,"McDuffie County, GA","County or equivalent",2005,21391,127,97,331,234,50,3,47,-20
"12260",NA,13245,"Richmond County, GA","County or equivalent",2005,196724,-1081,1297,3089,1792,-2230,58,-2288,-148
"12260",NA,45003,"Aiken County, SC","County or equivalent",2005,148528,1040,494,1926,1432,661,143,518,-115
"12260",NA,45037,"Edgefield County, SC","County or equivalent",2005,25377,212,63,272,209,172,11,161,-23
"12420",NA,NA,"Austin-Round Rock, TX","Metropolitan Statistical Area",2005,1464563,45426,16953,23686,6733,29707,7170,22537,-1234
"12420",NA,48021,"Bastrop County, TX","County or equivalent",2005,68751,1215,452,919,467,821,135,686,-58
"12420",NA,48055,"Caldwell County, TX","County or equivalent",2005,36167,123,293,559,266,-140,34,-174,-30
"12420",NA,48209,"Hays County, TX","County or equivalent",2005,126324,6080,1109,1670,561,5072,148,4924,-101
"12420",NA,48453,"Travis County, TX","County or equivalent",2005,901701,22454,10947,14989,4042,12371,6249,6122,-864
"12420",NA,48491,"Williamson County, TX","County or equivalent",2005,331620,15554,4152,5549,1397,11583,604,10979,-181
"12540",NA,NA,"Bakersfield, CA","Metropolitan Statistical Area",2005,748766,21698,8514,13709,5195,13887,2517,11370,-703
"12540",NA,6029,"Kern County, CA","County or equivalent",2005,748766,21698,8514,13709,5195,13887,2517,11370,-703
"12580",NA,NA,"Baltimore-Towson, MD","Metropolitan Statistical Area",2005,2646991,10819,10938,34340,23402,-2066,3817,-5883,1947
"12580",NA,24003,"Anne Arundel County, MD","County or equivalent",2005,509414,1282,3113,6724,3611,-1355,306,-1661,-476
"12580",NA,24005,"Baltimore County, MD","County or equivalent",2005,781452,2642,1757,9515,7758,1627,1548,79,-742
"12580",NA,24013,"Carroll County, MD","County or equivalent",2005,166820,1820,743,2027,1284,1210,55,1155,-133
"12580",NA,24025,"Harford County, MD","County or equivalent",2005,237094,3310,1191,2931,1740,2341,110,2231,-222
"12580",NA,24027,"Howard County, MD","County or equivalent",2005,267133,2218,2070,3359,1289,391,866,-475,-243
"12580",NA,24035,"Queen Anne's County, MD","County or equivalent",2005,45014,487,156,514,358,375,35,340,-44
"12580",NA,24510,"Baltimore city, MD","County or equivalent",2005,640064,-940,1908,9270,7362,-6655,897,-7552,3807
"12620",NA,NA,"Bangor, ME","Metropolitan Statistical Area",2005,146902,336,176,1621,1445,303,91,212,-143
"12620",NA,23019,"Penobscot County, ME","County or equivalent",2005,146902,336,176,1621,1445,303,91,212,-143
"12700",NA,NA,"Barnstable Town, MA","Metropolitan Statistical Area",2005,224913,-1916,-731,1976,2707,-979,296,-1275,-206
"12700",NA,25001,"Barnstable County, MA","County or equivalent",2005,224913,-1916,-731,1976,2707,-979,296,-1275,-206
"12940",NA,NA,"Baton Rouge, LA","Metropolitan Statistical Area",2005,729366,4154,4383,10307,5924,393,751,-358,-622
"12940",NA,22005,"Ascension Parish, LA","County or equivalent",2005,89118,3230,918,1472,554,2382,71,2311,-70
"12940",NA,22033,"East Baton Rouge Parish, LA","County or equivalent",2005,411584,-1011,2294,5646,3352,-2943,653,-3596,-362
"12940",NA,22037,"East Feliciana Parish, LA","County or equivalent",2005,20535,-154,5,257,252,-142,1,-143,-17
"12940",NA,22047,"Iberville Parish, LA","County or equivalent",2005,32203,-146,137,471,334,-256,2,-258,-27
"12940",NA,22063,"Livingston Parish, LA","County or equivalent",2005,107390,2778,856,1645,789,2014,17,1997,-92
"12940",NA,22077,"Pointe Coupee Parish, LA","County or equivalent",2005,21807,-312,47,284,237,-340,-1,-339,-19
"12940",NA,22091,"St. Helena Parish, LA","County or equivalent",2005,10171,-88,15,109,94,-97,0,-97,-6
"12940",NA,22121,"West Baton Rouge Parish, LA","County or equivalent",2005,21518,-205,122,320,198,-311,5,-316,-16
"12940",NA,22125,"West Feliciana Parish, LA","County or equivalent",2005,15040,62,-11,103,114,86,3,83,-13
"12980",NA,NA,"Battle Creek, MI","Metropolitan Statistical Area",2005,138060,-694,462,1849,1387,-1040,148,-1188,-116
"12980",NA,26025,"Calhoun County, MI","County or equivalent",2005,138060,-694,462,1849,1387,-1040,148,-1188,-116
"13020",NA,NA,"Bay City, MI","Metropolitan Statistical Area",2005,108531,-398,126,1230,1104,-423,19,-442,-101
"13020",NA,26017,"Bay County, MI","County or equivalent",2005,108531,-398,126,1230,1104,-423,19,-442,-101
"13140",NA,NA,"Beaumont-Port Arthur, TX","Metropolitan Statistical Area",2005,380319,-23,1239,5219,3980,-929,485,-1414,-333
"13140",NA,48199,"Hardin County, TX","County or equivalent",2005,50626,800,176,699,523,671,9,662,-47
"13140",NA,48245,"Jefferson County, TX","County or equivalent",2005,246143,-739,923,3472,2549,-1446,434,-1880,-216
"13140",NA,48361,"Orange County, TX","County or equivalent",2005,83550,-84,140,1048,908,-154,42,-196,-70
"13380",NA,NA,"Bellingham, WA","Metropolitan Statistical Area",2005,185180,3605,740,2077,1337,3009,518,2491,-144
"13380",NA,53073,"Whatcom County, WA","County or equivalent",2005,185180,3605,740,2077,1337,3009,518,2491,-144
"13460",NA,NA,"Bend, OR","Metropolitan Statistical Area",2005,140942,6886,669,1721,1052,6298,71,6227,-81
"13460",NA,41017,"Deschutes County, OR","County or equivalent",2005,140942,6886,669,1721,1052,6298,71,6227,-81
"13740",NA,NA,"Billings, MT","Metropolitan Statistical Area",2005,146193,2004,677,1984,1307,1454,29,1425,-127
"13740",NA,30009,"Carbon County, MT","County or equivalent",2005,9746,84,-2,87,89,95,5,90,-9
"13740",NA,30111,"Yellowstone County, MT","County or equivalent",2005,136447,1920,679,1897,1218,1359,24,1335,-118
"13780",NA,NA,"Binghamton, NY","Metropolitan Statistical Area",2005,246835,-1517,125,2593,2468,-1436,322,-1758,-206
"13780",NA,36007,"Broome County, NY","County or equivalent",2005,196127,-1326,-61,2038,2099,-1089,304,-1393,-176
"13780",NA,36107,"Tioga County, NY","County or equivalent",2005,50708,-191,186,555,369,-347,18,-365,-30
"13820",NA,NA,"Birmingham-Hoover, AL","Metropolitan Statistical Area",2005,1088303,8097,3863,14953,11090,4443,1070,3373,-209
"13820",NA,1007,"Bibb County, AL","County or equivalent",2005,21375,166,32,251,219,153,5,148,-19
"13820",NA,1009,"Blount County, AL","County or equivalent",2005,54915,534,143,685,542,442,80,362,-51
"13820",NA,1021,"Chilton County, AL","County or equivalent",2005,41431,314,90,558,468,264,30,234,-40
"13820",NA,1073,"Jefferson County, AL","County or equivalent",2005,658114,-793,1907,9107,7200,-2618,777,-3395,-82
"13820",NA,1115,"St. Clair County, AL","County or equivalent",2005,71969,2029,239,940,701,1846,11,1835,-56
"13820",NA,1117,"Shelby County, AL","County or equivalent",2005,171374,5877,1542,2548,1006,4231,141,4090,104
"13820",NA,1127,"Walker County, AL","County or equivalent",2005,69125,-30,-90,864,954,125,26,99,-65
"13900",NA,NA,"Bismarck, ND","Metropolitan Statistical Area",2005,99388,1644,580,1269,689,1154,33,1121,-90
"13900",NA,38015,"Burleigh County, ND","County or equivalent",2005,74136,1510,490,960,470,1087,26,1061,-67
"13900",NA,38059,"Morton County, ND","County or equivalent",2005,25252,134,90,309,219,67,7,60,-23
"13980",NA,NA,"Blacksburg-Christiansburg-Radford, VA","Metropolitan Statistical Area",2005,154416,1257,187,1453,1266,1211,332,879,-141
"13980",NA,51071,"Giles County, VA","County or equivalent",2005,16989,184,-48,177,225,244,0,244,-12
"13980",NA,51121,"Montgomery County, VA","County or equivalent",2005,86890,952,284,812,528,751,315,436,-83
"13980",NA,51155,"Pulaski County, VA","County or equivalent",2005,34688,-96,-61,336,397,-1,4,-5,-34
"13980",NA,51750,"Radford city, VA","County or equivalent",2005,15849,217,12,128,116,217,13,204,-12
"14020",NA,NA,"Bloomington, IN","Metropolitan Statistical Area",2005,179954,711,588,1904,1316,283,392,-109,-160
"14020",NA,18055,"Greene County, IN","County or equivalent",2005,33042,-130,32,381,349,-136,3,-139,-26
"14020",NA,18105,"Monroe County, IN","County or equivalent",2005,124545,991,526,1269,743,579,388,191,-114
"14020",NA,18119,"Owen County, IN","County or equivalent",2005,22367,-150,30,254,224,-160,1,-161,-20
"14060",NA,NA,"Bloomington-Normal, IL","Metropolitan Statistical Area",2005,159349,980,1236,2242,1006,-111,234,-345,-145
"14060",NA,17113,"McLean County, IL","County or equivalent",2005,159349,980,1236,2242,1006,-111,234,-345,-145
"14260",NA,NA,"Boise City-Nampa, ID","Metropolitan Statistical Area",2005,543918,20321,5394,8898,3504,15292,992,14300,-365
"14260",NA,16001,"Ada County, ID","County or equivalent",2005,346749,13427,3210,5287,2077,10449,604,9845,-232
"14260",NA,16015,"Boise County, ID","County or equivalent",2005,7225,10,8,53,45,5,4,1,-3
"14260",NA,16027,"Canyon County, ID","County or equivalent",2005,163239,6634,2078,3186,1108,4670,322,4348,-114
"14260",NA,16045,"Gem County, ID","County or equivalent",2005,16010,314,30,210,180,293,22,271,-9
"14260",NA,16073,"Owyhee County, ID","County or equivalent",2005,10695,-64,68,162,94,-125,40,-165,-7
"14460",NA,NA,"Boston-Cambridge-Quincy, MA-NH","Metropolitan Statistical Area",2005,4454959,995,20211,55300,35089,-26286,19802,-46088,7070
"14460",14484,NA,"Boston-Quincy, MA","Metropolitan Division",2005,1850525,1571,8248,23120,14872,-14409,9284,-23693,7732
"14460",14484,25021,"Norfolk County, MA","County or equivalent",2005,651429,-1376,2156,7765,5609,-2992,1988,-4980,-540
"14460",14484,25023,"Plymouth County, MA","County or equivalent",2005,487765,1585,2035,6092,4057,-33,665,-698,-417
"14460",14484,25025,"Suffolk County, MA","County or equivalent",2005,711331,1362,4057,9263,5206,-11384,6631,-18015,8689
"14460",15764,NA,"Cambridge-Newton-Framingham, MA","Metropolitan Division",2005,1462024,-3123,6637,17706,11069,-10181,7929,-18110,421
"14460",15764,25017,"Middlesex County, MA","County or equivalent",2005,1462024,-3123,6637,17706,11069,-10181,7929,-18110,421
"14460",37764,NA,"Peabody, MA","Metropolitan Division",2005,730552,-654,2839,9178,6339,-2804,2297,-5101,-689
"14460",37764,25009,"Essex County, MA","County or equivalent",2005,730552,-654,2839,9178,6339,-2804,2297,-5101,-689
"14460",40484,NA,"Rockingham County-Strafford County, NH","Metropolitan Division",2005,411858,3201,2487,5296,2809,1108,292,816,-394
"14460",40484,33015,"Rockingham County, NH","County or equivalent",2005,292877,2406,1954,3910,1956,735,189,546,-283
"14460",40484,33017,"Strafford County, NH","County or equivalent",2005,118981,795,533,1386,853,373,103,270,-111
"14500",NA,NA,"Boulder, CO /1","Metropolitan Statistical Area",2005,282115,1066,2125,3511,1386,-806,1289,-2095,-253
"14500",NA,8013,"Boulder County, CO /1","County or equivalent",2005,282115,1066,2125,3511,1386,-806,1289,-2095,-253
"14540",NA,NA,"Bowling Green, KY","Metropolitan Statistical Area",2005,111360,2155,631,1539,908,1618,304,1314,-94
"14540",NA,21061,"Edmonson County, KY","County or equivalent",2005,11918,166,17,127,110,160,4,156,-11
"14540",NA,21227,"Warren County, KY","County or equivalent",2005,99442,1989,614,1412,798,1458,300,1158,-83
"14600",NA,NA,"Bradenton-Sarasota-Venice, FL","Metropolitan Statistical Area",2005,667574,19020,-1736,6538,8274,21393,1616,19777,-637
"14600",NA,12081,"Manatee County, FL","County or equivalent",2005,304353,9986,222,3586,3364,10057,747,9310,-293
"14600",NA,12115,"Sarasota County, FL","County or equivalent",2005,363221,9034,-1958,2952,4910,11336,869,10467,-344
"14740",NA,NA,"Bremerton-Silverdale, WA","Metropolitan Statistical Area",2005,236024,-3155,1135,2932,1797,-4118,55,-4173,-172
"14740",NA,53035,"Kitsap County, WA","County or equivalent",2005,236024,-3155,1135,2932,1797,-4118,55,-4173,-172
"14860",NA,NA,"Bridgeport-Stamford-Norwalk, CT","Metropolitan Statistical Area",2005,891838,-1108,5029,11816,6787,-5435,5446,-10881,-702
"14860",NA,9001,"Fairfield County, CT","County or equivalent",2005,891838,-1108,5029,11816,6787,-5435,5446,-10881,-702
"15180",NA,NA,"Brownsville-Harlingen, TX","Metropolitan Statistical Area",2005,371492,6683,6724,8734,2010,324,1728,-1404,-365
"15180",NA,48061,"Cameron County, TX","County or equivalent",2005,371492,6683,6724,8734,2010,324,1728,-1404,-365
"15260",NA,NA,"Brunswick, GA","Metropolitan Statistical Area",2005,97553,876,372,1343,971,584,105,479,-80
"15260",NA,13025,"Brantley County, GA","County or equivalent",2005,15276,49,56,181,125,6,0,6,-13
"15260",NA,13127,"Glynn County, GA","County or equivalent",2005,71368,888,292,1025,733,655,105,550,-59
"15260",NA,13191,"McIntosh County, GA","County or equivalent",2005,10909,-61,24,137,113,-77,0,-77,-8
"15380",NA,NA,"Buffalo-Niagara Falls, NY","Metropolitan Statistical Area",2005,1140309,-9060,-78,12195,12273,-8009,1176,-9185,-973
"15380",NA,36029,"Erie County, NY","County or equivalent",2005,924748,-7889,-30,9952,9982,-7092,1034,-8126,-767
"15380",NA,36063,"Niagara County, NY","County or equivalent",2005,215561,-1171,-48,2243,2291,-917,142,-1059,-206
"15500",NA,NA,"Burlington, NC","Metropolitan Statistical Area",2005,139480,1733,427,1793,1366,1434,549,885,-128
"15500",NA,37001,"Alamance County, NC","County or equivalent",2005,139480,1733,427,1793,1366,1434,549,885,-128
"15540",NA,NA,"Burlington-South Burlington, VT","Metropolitan Statistical Area",2005,205348,758,937,2308,1371,-2,385,-387,-177
"15540",NA,50007,"Chittenden County, VT","County or equivalent",2005,150277,388,652,1623,971,-136,365,-501,-128
"15540",NA,50011,"Franklin County, VT","County or equivalent",2005,47503,303,266,612,346,80,21,59,-43
"15540",NA,50013,"Grand Isle County, VT","County or equivalent",2005,7568,67,19,73,54,54,-1,55,-6
"15940",NA,NA,"Canton-Massillon, OH","Metropolitan Statistical Area",2005,407555,-825,495,4690,4195,-1251,73,-1324,-69
"15940",NA,39019,"Carroll County, OH","County or equivalent",2005,28883,-232,-15,284,299,-195,3,-198,-22
"15940",NA,39151,"Stark County, OH","County or equivalent",2005,378672,-593,510,4406,3896,-1056,70,-1126,-47
"15980",NA,NA,"Cape Coral-Fort Myers, FL","Metropolitan Statistical Area",2005,541159,29200,597,6299,5702,29067,1534,27533,-464
"15980",NA,12071,"Lee County, FL","County or equivalent",2005,541159,29200,597,6299,5702,29067,1534,27533,-464
"16180",NA,NA,"Carson City, NV","Metropolitan Statistical Area",2005,55566,-104,85,745,660,-137,169,-306,-52
"16180",NA,32510,"Carson City, NV","County or equivalent",2005,55566,-104,85,745,660,-137,169,-306,-52
"16220",NA,NA,"Casper, WY","Metropolitan Statistical Area",2005,69408,771,409,1001,592,425,31,394,-63
"16220",NA,56025,"Natrona County, WY","County or equivalent",2005,69408,771,409,1001,592,425,31,394,-63
"16300",NA,NA,"Cedar Rapids, IA","Metropolitan Statistical Area",2005,247151,2145,1312,3249,1937,850,228,622,-17
"16300",NA,19011,"Benton County, IA","County or equivalent",2005,26647,153,81,316,235,73,3,70,-1
"16300",NA,19105,"Jones County, IA","County or equivalent",2005,20313,-60,40,230,190,-84,0,-84,-16
"16300",NA,19113,"Linn County, IA","County or equivalent",2005,200191,2052,1191,2703,1512,861,225,636,0
"16580",NA,NA,"Champaign-Urbana, IL","Metropolitan Statistical Area",2005,218494,1634,1162,2743,1581,676,845,-169,-204
"16580",NA,17019,"Champaign County, IL","County or equivalent",2005,188020,1561,1155,2371,1216,587,835,-248,-181
"16580",NA,17053,"Ford County, IL","County or equivalent",2005,13984,-73,-30,174,204,-34,6,-40,-9
"16580",NA,17147,"Piatt County, IL","County or equivalent",2005,16490,146,37,198,161,123,4,119,-14
"16620",NA,NA,"Charleston, WV","Metropolitan Statistical Area",2005,304477,-1464,27,3681,3654,-1212,61,-1273,-279
"16620",NA,54005,"Boone County, WV","County or equivalent",2005,25318,-145,26,319,293,-149,5,-154,-22
"16620",NA,54015,"Clay County, WV","County or equivalent",2005,10138,-151,8,120,112,-151,1,-152,-8
"16620",NA,54039,"Kanawha County, WV","County or equivalent",2005,192841,-1702,-199,2320,2519,-1323,51,-1374,-180
"16620",NA,54043,"Lincoln County, WV","County or equivalent",2005,22322,18,3,286,283,33,1,32,-18
"16620",NA,54079,"Putnam County, WV","County or equivalent",2005,53858,516,189,636,447,378,3,375,-51
"16700",NA,NA,"Charleston-North Charleston-Summerville, SC","Metropolitan Statistical Area",2005,601162,11043,3999,8521,4522,6975,653,6322,69
"16700",NA,45015,"Berkeley County, SC","County or equivalent",2005,152688,1291,1144,2155,1011,286,78,208,-139
"16700",NA,45019,"Charleston County, SC","County or equivalent",2005,336865,4304,2059,4815,2756,1946,490,1456,299
"16700",NA,45035,"Dorchester County, SC","County or equivalent",2005,111609,5448,796,1551,755,4743,85,4658,-91
"16740",NA,NA,"Charlotte-Gastonia-Concord, NC-SC","Metropolitan Statistical Area",2005,1518488,48146,12956,23545,10589,36494,5152,31342,-1304
"16740",NA,37007,"Anson County, NC","County or equivalent",2005,25480,-2,19,285,266,4,7,-3,-25
"16740",NA,37025,"Cabarrus County, NC","County or equivalent",2005,148834,3784,1153,2384,1231,2764,340,2424,-133
"16740",NA,37071,"Gaston County, NC","County or equivalent",2005,194668,2097,664,2558,1894,1618,448,1170,-185
"16740",NA,37119,"Mecklenburg County, NC","County or equivalent",2005,799794,26432,8450,13259,4809,18689,3724,14965,-707
"16740",NA,37179,"Union County, NC","County or equivalent",2005,160542,9410,1629,2572,943,7905,457,7448,-124
"16740",NA,45091,"York County, SC","County or equivalent",2005,189170,6425,1041,2487,1446,5514,176,5338,-130
"16820",NA,NA,"Charlottesville, VA","Metropolitan Statistical Area",2005,187655,2964,772,2171,1399,2317,457,1860,-125
"16820",NA,51003,"Albemarle County, VA","County or equivalent",2005,90266,1616,294,947,653,1402,295,1107,-80
"16820",NA,51065,"Fluvanna County, VA","County or equivalent",2005,24460,872,201,342,141,689,4,685,-18
"16820",NA,51079,"Greene County, VA","County or equivalent",2005,17175,270,115,260,145,170,6,164,-15
"16820",NA,51125,"Nelson County, VA","County or equivalent",2005,14949,146,-1,150,151,160,-1,161,-13
"16820",NA,51540,"Charlottesville city, VA","County or equivalent",2005,40805,60,163,472,309,-104,153,-257,1
"16860",NA,NA,"Chattanooga, TN-GA","Metropolitan Statistical Area",2005,502295,5478,957,6007,5050,2562,468,2094,1959
"16860",NA,13047,"Catoosa County, GA","County or equivalent",2005,59691,844,235,709,474,661,24,637,-52
"16860",NA,13083,"Dade County, GA","County or equivalent",2005,15871,78,-7,148,155,100,8,92,-15
"16860",NA,13295,"Walker County, GA","County or equivalent",2005,63160,548,5,734,729,601,26,575,-58
"16860",NA,47065,"Hamilton County, TN","County or equivalent",2005,323162,3699,708,3955,3247,873,399,474,2118
"16860",NA,47115,"Marion County, TN","County or equivalent",2005,27717,-35,4,318,314,-14,3,-17,-25
"16860",NA,47153,"Sequatchie County, TN","County or equivalent",2005,12694,344,12,143,131,341,8,333,-9
"16940",NA,NA,"Cheyenne, WY","Metropolitan Statistical Area",2005,85304,94,564,1271,707,-395,14,-409,-75
"16940",NA,56021,"Laramie County, WY","County or equivalent",2005,85304,94,564,1271,707,-395,14,-409,-75
"16980",NA,NA,"Chicago-Naperville-Joliet, IL-IN-WI","Metropolitan Statistical Area",2005,9390691,38744,69848,138742,68894,-30802,46934,-77736,-302
"16980",16974,NA,"Chicago-Naperville-Joliet, IL","Metropolitan Division",2005,7847302,24273,59996,117393,57397,-36245,42894,-79139,522
"16980",16974,17031,"Cook County, IL","County or equivalent",2005,5288709,-27775,36624,79244,42620,-64879,33991,-98870,480
"16980",16974,17037,"DeKalb County, IL","County or equivalent",2005,99455,2440,529,1205,676,1950,254,1696,-39
"16980",16974,17043,"DuPage County, IL","County or equivalent",2005,925156,379,6727,12422,5695,-6305,4519,-10824,-43
"16980",16974,17063,"Grundy County, IL","County or equivalent",2005,43459,2589,294,621,327,2332,34,2298,-37
"16980",16974,17089,"Kane County, IL","County or equivalent",2005,477214,9002,5877,8523,2646,3117,2468,649,8
"16980",16974,17093,"Kendall County, IL","County or equivalent",2005,79031,6723,1048,1440,392,5647,63,5584,28
"16980",16974,17111,"McHenry County, IL","County or equivalent",2005,302105,7509,2621,4276,1655,4834,638,4196,54
"16980",16974,17197,"Will County, IL","County or equivalent",2005,632173,23406,6276,9662,3386,17059,927,16132,71
"16980",23844,NA,"Gary, IN","Metropolitan Division",2005,688848,4208,2952,9242,6290,1883,654,1229,-627
"16980",23844,18073,"Jasper County, IN","County or equivalent",2005,31270,182,204,462,258,8,12,-4,-30
"16980",23844,18089,"Lake County, IN","County or equivalent",2005,487692,1720,2182,6873,4691,-18,509,-527,-444
"16980",23844,18111,"Newton County, IN","County or equivalent",2005,14196,35,-23,142,165,71,12,59,-13
"16980",23844,18127,"Porter County, IN","County or equivalent",2005,155690,2271,589,1765,1176,1822,121,1701,-140
"16980",29404,NA,"Lake County-Kenosha County, IL-WI","Metropolitan Division",2005,854541,10263,6900,12107,5207,3560,3386,174,-197
"16980",29404,17097,"Lake County, IL","County or equivalent",2005,694862,8282,6031,9973,3942,2305,3195,-890,-54
"16980",29404,55059,"Kenosha County, WI","County or equivalent",2005,159679,1981,869,2134,1265,1255,191,1064,-143
"17020",NA,NA,"Chico, CA","Metropolitan Statistical Area",2005,214873,1680,168,2363,2195,1704,374,1330,-192
"17020",NA,6007,"Butte County, CA","County or equivalent",2005,214873,1680,168,2363,2195,1704,374,1330,-192
"17140",NA,NA,"Cincinnati-Middletown, OH-KY-IN","Metropolitan Statistical Area",2005,2101215,18419,11579,29431,17852,248,2085,-1837,6592
"17140",NA,18029,"Dearborn County, IN","County or equivalent",2005,48618,319,275,658,383,90,8,82,-46
"17140",NA,18047,"Franklin County, IN","County or equivalent",2005,22931,175,143,305,162,52,1,51,-20
"17140",NA,18115,"Ohio County, IN","County or equivalent",2005,5846,40,15,64,49,28,-1,29,-3
"17140",NA,21015,"Boone County, KY","County or equivalent",2005,105436,4645,1035,1643,608,3690,158,3532,-80
"17140",NA,21023,"Bracken County, KY","County or equivalent",2005,8618,-46,22,110,88,-62,1,-63,-6
"17140",NA,21037,"Campbell County, KY","County or equivalent",2005,86963,-94,294,1145,851,-308,55,-363,-80
"17140",NA,21077,"Gallatin County, KY","County or equivalent",2005,8043,64,60,153,93,10,0,10,-6
"17140",NA,21081,"Grant County, KY","County or equivalent",2005,24426,212,203,390,187,29,9,20,-20
"17140",NA,21117,"Kenton County, KY","County or equivalent",2005,153374,541,1022,2355,1333,-340,99,-439,-141
"17140",NA,21191,"Pendleton County, KY","County or equivalent",2005,14922,76,48,183,135,40,7,33,-12
"17140",NA,39015,"Brown County, OH","County or equivalent",2005,43681,58,111,562,451,-14,6,-20,-39
"17140",NA,39017,"Butler County, OH","County or equivalent",2005,348243,3459,2117,4853,2736,1663,286,1377,-321
"17140",NA,39025,"Clermont County, OH","County or equivalent",2005,189313,2016,1204,2669,1465,978,92,886,-166
"17140",NA,39061,"Hamilton County, OH","County or equivalent",2005,846725,471,3439,11499,8060,-10651,1238,-11889,7683
"17140",NA,39165,"Warren County, OH","County or equivalent",2005,194076,6483,1591,2842,1251,5043,126,4917,-151
"17300",NA,NA,"Clarksville, TN-KY","Metropolitan Statistical Area",2005,251560,6904,2955,4765,1810,4766,-111,4877,-817
"17300",NA,21047,"Christian County, KY","County or equivalent",2005,78081,378,1066,1646,580,-28,-89,61,-660
"17300",NA,21221,"Trigg County, KY","County or equivalent",2005,13107,75,1,152,151,87,2,85,-13
"17300",NA,47125,"Montgomery County, TN","County or equivalent",2005,147495,6248,1888,2817,929,4493,-22,4515,-133
"17300",NA,47161,"Stewart County, TN","County or equivalent",2005,12877,203,0,150,150,214,-2,216,-11
"17420",NA,NA,"Cleveland, TN","Metropolitan Statistical Area",2005,107940,1051,294,1344,1050,855,97,758,-98
"17420",NA,47011,"Bradley County, TN","County or equivalent",2005,92185,1080,333,1163,830,830,96,734,-83
"17420",NA,47139,"Polk County, TN","County or equivalent",2005,15755,-29,-39,181,220,25,1,24,-15
"17460",NA,NA,"Cleveland-Elyria-Mentor, OH","Metropolitan Statistical Area",2005,2116304,-11029,4225,25816,21591,-14702,2995,-17697,-552
"17460",NA,39035,"Cuyahoga County, OH","County or equivalent",2005,1325424,-17145,1750,16577,14827,-17892,2341,-20233,-1003
"17460",NA,39055,"Geauga County, OH","County or equivalent",2005,94323,532,376,1119,743,242,25,217,-86
"17460",NA,39085,"Lake County, OH","County or equivalent",2005,232008,4,278,2513,2235,-242,356,-598,-32
"17460",NA,39093,"Lorain County, OH","County or equivalent",2005,298889,3562,974,3603,2629,1875,184,1691,713
"17460",NA,39103,"Medina County, OH","County or equivalent",2005,165660,2018,847,2004,1157,1315,89,1226,-144
"17660",NA,NA,"Coeur d'Alene, ID","Metropolitan Statistical Area",2005,126742,5121,557,1580,1023,4634,39,4595,-70
"17660",NA,16055,"Kootenai County, ID","County or equivalent",2005,126742,5121,557,1580,1023,4634,39,4595,-70
"17780",NA,NA,"College Station-Bryan, TX","Metropolitan Statistical Area",2005,196355,2638,1749,2897,1148,1058,974,84,-169
"17780",NA,48041,"Brazos County, TX","County or equivalent",2005,163608,2404,1653,2438,785,891,946,-55,-140
"17780",NA,48051,"Burleson County, TX","County or equivalent",2005,16838,125,80,239,159,59,10,49,-14
"17780",NA,48395,"Robertson County, TX","County or equivalent",2005,15909,109,16,220,204,108,18,90,-15
"17820",NA,NA,"Colorado Springs, CO","Metropolitan Statistical Area",2005,588718,8678,5415,8769,3354,3306,693,2613,-43
"17820",NA,8041,"El Paso County, CO","County or equivalent",2005,567416,8520,5309,8560,3251,3235,691,2544,-24
"17820",NA,8119,"Teller County, CO","County or equivalent",2005,21302,158,106,209,103,71,2,69,-19
"17860",NA,NA,"Columbia, MO","Metropolitan Statistical Area",2005,156080,2903,1169,2119,950,1870,353,1517,-136
"17860",NA,29019,"Boone County, MO","County or equivalent",2005,146173,2866,1144,1991,847,1849,351,1498,-127
"17860",NA,29089,"Howard County, MO","County or equivalent",2005,9907,37,25,128,103,21,2,19,-9
"17900",NA,NA,"Columbia, SC","Metropolitan Statistical Area",2005,690717,6478,3675,9249,5574,3401,892,2509,-598
"17900",NA,45017,"Calhoun County, SC","County or equivalent",2005,14862,-112,-21,151,172,-79,4,-83,-12
"17900",NA,45039,"Fairfield County, SC","County or equivalent",2005,23677,-244,9,311,302,-231,1,-232,-22
"17900",NA,45055,"Kershaw County, SC","County or equivalent",2005,55785,929,214,726,512,766,12,754,-51
"17900",NA,45063,"Lexington County, SC","County or equivalent",2005,232989,3756,1288,3109,1821,2656,319,2337,-188
"17900",NA,45079,"Richland County, SC","County or equivalent",2005,344739,2040,2123,4692,2569,225,456,-231,-308
"17900",NA,45081,"Saluda County, SC","County or equivalent",2005,18665,109,62,260,198,64,100,-36,-17
"17980",NA,NA,"Columbus, GA-AL","Metropolitan Statistical Area",2005,287991,1478,1757,4384,2627,-33,170,-203,-246
"17980",NA,1113,"Russell County, AL","County or equivalent",2005,49019,102,169,702,533,-19,34,-53,-48
"17980",NA,13053,"Chattahoochee County, GA","County or equivalent",2005,16253,-1228,213,241,28,-1438,-56,-1382,-3
"17980",NA,13145,"Harris County, GA","County or equivalent",2005,27338,818,74,301,227,765,8,757,-21
"17980",NA,13197,"Marion County, GA","County or equivalent",2005,6999,8,42,118,76,-30,18,-48,-4
"17980",NA,13215,"Muscogee County, GA","County or equivalent",2005,188382,1778,1259,3022,1763,689,166,523,-170
"18020",NA,NA,"Columbus, IN","Metropolitan Statistical Area",2005,73069,649,346,1077,731,363,191,172,-60
"18020",NA,18005,"Bartholomew County, IN","County or equivalent",2005,73069,649,346,1077,731,363,191,172,-60
"18140",NA,NA,"Columbus, OH","Metropolitan Statistical Area",2005,1712248,17519,12572,25741,13169,6319,3647,2672,-1372
"18140",NA,39041,"Delaware County, OH","County or equivalent",2005,149334,7398,1644,2374,730,5714,56,5658,40
"18140",NA,39045,"Fairfield County, OH","County or equivalent",2005,137511,2417,618,1724,1106,1917,14,1903,-118
"18140",NA,39049,"Franklin County, OH","County or equivalent",2005,1098818,4230,8909,17439,8530,-3683,3494,-7177,-996
"18140",NA,39089,"Licking County, OH","County or equivalent",2005,153974,1849,624,2010,1386,1364,43,1321,-139
"18140",NA,39097,"Madison County, OH","County or equivalent",2005,40809,73,93,443,350,19,26,-7,-39
"18140",NA,39117,"Morrow County, OH","County or equivalent",2005,34027,195,107,411,304,118,3,115,-30
"18140",NA,39129,"Pickaway County, OH","County or equivalent",2005,52384,610,139,593,454,520,1,519,-49
"18140",NA,39159,"Union County, OH","County or equivalent",2005,45391,747,438,747,309,350,10,340,-41
"18580",NA,NA,"Corpus Christi, TX","Metropolitan Statistical Area",2005,410509,3488,3324,6593,3269,533,407,126,-369
"18580",NA,48007,"Aransas County, TX","County or equivalent",2005,24380,650,-19,268,287,684,31,653,-15
"18580",NA,48355,"Nueces County, TX","County or equivalent",2005,317614,1974,2651,5110,2459,-384,375,-759,-293
"18580",NA,48409,"San Patricio County, TX","County or equivalent",2005,68515,864,692,1215,523,233,1,232,-61
"18700",NA,NA,"Corvallis, OR","Metropolitan Statistical Area",2005,79452,503,319,804,485,249,292,-43,-65
"18700",NA,41003,"Benton County, OR","County or equivalent",2005,79452,503,319,804,485,249,292,-43,-65
"19060",NA,NA,"Cumberland, MD-WV","Metropolitan Statistical Area",2005,99546,-808,-329,961,1290,-392,13,-405,-87
"19060",NA,24001,"Allegany County, MD","County or equivalent",2005,72716,-682,-328,632,960,-284,9,-293,-70
"19060",NA,54057,"Mineral County, WV","County or equivalent",2005,26830,-126,-1,329,330,-108,4,-112,-17
"19100",NA,NA,"Dallas-Fort Worth-Arlington, TX","Metropolitan Statistical Area",2005,5817696,126672,65668,99029,33361,58928,35473,23455,2076
"19100",19124,NA,"Dallas-Plano-Irving, TX","Metropolitan Division",2005,3903972,88619,46254,67368,21114,38544,27491,11053,3821
"19100",19124,48085,"Collin County, TX","County or equivalent",2005,660124,32114,8070,10423,2353,23676,2794,20882,368
"19100",19124,48113,"Dallas County, TX","County or equivalent",2005,2317174,19228,28633,42544,13911,-12791,22404,-35195,3386
"19100",19124,48119,"Delta County, TX","County or equivalent",2005,5436,-74,11,56,45,-80,0,-80,-5
"19100",19124,48121,"Denton County, TX","County or equivalent",2005,557829,24678,6952,8969,2017,17519,1567,15952,207
"19100",19124,48139,"Ellis County, TX","County or equivalent",2005,131834,4618,1098,2028,930,3616,310,3306,-96
"19100",19124,48231,"Hunt County, TX","County or equivalent",2005,81472,434,385,1138,753,129,172,-43,-80
"19100",19124,48257,"Kaufman County, TX","County or equivalent",2005,87868,3302,523,1276,753,2771,158,2613,8
"19100",19124,48397,"Rockwall County, TX","County or equivalent",2005,62235,4319,582,934,352,3704,86,3618,33
"19100",23104,NA,"Fort Worth-Arlington, TX","Metropolitan Division",2005,1913724,38053,19414,31661,12247,20384,7982,12402,-1745
"19100",23104,48251,"Johnson County, TX","County or equivalent",2005,143843,2445,964,2061,1097,1603,214,1389,-122
"19100",23104,48367,"Parker County, TX","County or equivalent",2005,101292,2415,423,1212,789,2077,71,2006,-85
"19100",23104,48439,"Tarrant County, TX","County or equivalent",2005,1612869,32065,17755,27709,9954,15802,7607,8195,-1492
"19100",23104,48497,"Wise County, TX","County or equivalent",2005,55720,1128,272,679,407,902,90,812,-46
"19140",NA,NA,"Dalton, GA","Metropolitan Statistical Area",2005,130132,1778,1509,2552,1043,386,825,-439,-117
"19140",NA,13213,"Murray County, GA","County or equivalent",2005,40120,322,394,701,307,-38,54,-92,-34
"19140",NA,13313,"Whitfield County, GA","County or equivalent",2005,90012,1456,1115,1851,736,424,771,-347,-83
"19180",NA,NA,"Danville, IL","Metropolitan Statistical Area",2005,81743,-427,113,1080,967,-464,43,-507,-76
"19180",NA,17183,"Vermilion County, IL","County or equivalent",2005,81743,-427,113,1080,967,-464,43,-507,-76
"19260",NA,NA,"Danville, VA","Metropolitan Statistical Area",2005,106618,-712,-81,1226,1307,-541,76,-617,-90
"19260",NA,51143,"Pittsylvania County, VA","County or equivalent",2005,60961,-106,21,649,628,-74,39,-113,-53
"19260",NA,51590,"Danville city, VA","County or equivalent",2005,45657,-606,-102,577,679,-467,37,-504,-37
"19340",NA,NA,"Davenport-Moline-Rock Island, IA-IL","Metropolitan Statistical Area",2005,373061,256,1561,4990,3429,-1086,456,-1542,-219
"19340",NA,17073,"Henry County, IL","County or equivalent",2005,49860,-80,33,560,527,-64,22,-86,-49
"19340",NA,17131,"Mercer County, IL","County or equivalent",2005,16568,-133,10,165,155,-128,3,-131,-15
"19340",NA,17161,"Rock Island County, IL","County or equivalent",2005,146532,-325,516,1971,1455,-705,237,-942,-136
"19340",NA,19163,"Scott County, IA","County or equivalent",2005,160101,794,1002,2294,1292,-189,194,-383,-19
"19380",NA,NA,"Dayton, OH","Metropolitan Statistical Area",2005,843079,-2155,2597,10616,8019,-4651,447,-5098,-101
"19380",NA,39057,"Greene County, OH","County or equivalent",2005,156129,717,507,1753,1246,-274,134,-408,484
"19380",NA,39109,"Miami County, OH","County or equivalent",2005,100595,585,330,1242,912,345,47,298,-90
"19380",NA,39113,"Montgomery County, OH","County or equivalent",2005,544475,-3285,1657,7115,5458,-4482,258,-4740,-460
"19380",NA,39135,"Preble County, OH","County or equivalent",2005,41880,-172,103,506,403,-240,8,-248,-35
"19460",NA,NA,"Decatur, AL","Metropolitan Statistical Area",2005,146949,753,491,1899,1408,395,155,240,-133
"19460",NA,1079,"Lawrence County, AL","County or equivalent",2005,34289,86,68,407,339,51,8,43,-33
"19460",NA,1103,"Morgan County, AL","County or equivalent",2005,112660,667,423,1492,1069,344,147,197,-100
"19500",NA,NA,"Decatur, IL","Metropolitan Statistical Area",2005,109635,-392,161,1374,1213,-451,45,-496,-102
"19500",NA,17115,"Macon County, IL","County or equivalent",2005,109635,-392,161,1374,1213,-451,45,-496,-102
"19660",NA,NA,"Deltona-Daytona Beach-Ormond Beach, FL","Metropolitan Statistical Area",2005,485716,9205,-1364,4901,6265,11052,676,10376,-483
"19660",NA,12127,"Volusia County, FL","County or equivalent",2005,485716,9205,-1364,4901,6265,11052,676,10376,-483
"19740",NA,NA,"Denver-Aurora, CO /1","Metropolitan Statistical Area",2005,2358271,33429,23643,37683,14040,10870,11299,-429,-1084
"19740",NA,8001,"Adams County, CO /1","County or equivalent",2005,398583,11190,5269,7616,2347,6301,2162,4139,-380
"19740",NA,8005,"Arapahoe County, CO /1","County or equivalent",2005,526249,5822,5059,8116,3057,1201,2257,-1056,-438
"19740",NA,8014,"Broomfield County, CO /1","County or equivalent",2005,48539,1913,449,650,201,523,100,423,941
"19740",NA,8019,"Clear Creek County, CO /1","County or equivalent",2005,9017,-36,36,96,60,-66,1,-67,-6
"19740",NA,8031,"Denver County, CO /1","County or equivalent",2005,563353,3482,6119,10396,4277,-2140,5444,-7584,-497
"19740",NA,8035,"Douglas County, CO /1","County or equivalent",2005,246076,11295,3591,4183,592,7894,343,7551,-190
"19740",NA,8039,"Elbert County, CO /1","County or equivalent",2005,22388,238,111,200,89,148,4,144,-21
"19740",NA,8047,"Gilpin County, CO /1","County or equivalent",2005,4935,77,34,54,20,47,1,46,-4
"19740",NA,8059,"Jefferson County, CO /1","County or equivalent",2005,522566,-695,2869,6206,3337,-3088,979,-4067,-476
"19740",NA,8093,"Park County, CO /1","County or equivalent",2005,16565,143,106,166,60,50,8,42,-13
"19780",NA,NA,"Des Moines-West Des Moines, IA","Metropolitan Statistical Area",2005,523604,11504,4378,8097,3719,6184,1201,4983,942
"19780",NA,19049,"Dallas County, IA","County or equivalent",2005,51796,2396,406,720,314,1983,63,1920,7
"19780",NA,19077,"Guthrie County, IA","County or equivalent",2005,11214,-147,-29,115,144,-112,2,-114,-6
"19780",NA,19121,"Madison County, IA","County or equivalent",2005,14870,177,54,172,118,136,-1,137,-13
"19780",NA,19153,"Polk County, IA","County or equivalent",2005,402762,8410,3748,6561,2813,3673,1129,2544,989
"19780",NA,19181,"Warren County, IA","County or equivalent",2005,42962,668,199,529,330,504,8,496,-35
"19820",NA,NA,"Detroit-Warren-Livonia, MI","Metropolitan Statistical Area",2005,4496480,-2611,19148,57886,38738,-27698,11029,-38727,5939
"19820",19804,NA,"Detroit-Livonia-Dearborn, MI","Metropolitan Division",2005,2024183,-11518,8784,28025,19241,-27834,5044,-32878,7532
"19820",19804,26163,"Wayne County, MI","County or equivalent",2005,2024183,-11518,8784,28025,19241,-27834,5044,-32878,7532
"19820",47644,NA,"Warren-Troy-Farmington Hills, MI","Metropolitan Division",2005,2472297,8907,10364,29861,19497,136,5985,-5849,-1593
"19820",47644,26087,"Lapeer County, MI","County or equivalent",2005,92240,706,458,1071,613,334,34,300,-86
"19820",47644,26093,"Livingston County, MI","County or equivalent",2005,179427,3688,942,1997,1055,2886,134,2752,-140
"19820",47644,26099,"Macomb County, MI","County or equivalent",2005,825228,4595,2535,9948,7413,2168,1654,514,-108
"19820",47644,26125,"Oakland County, MI","County or equivalent",2005,1205877,-59,5844,14822,8978,-4790,4093,-8883,-1113
"19820",47644,26147,"St. Clair County, MI","County or equivalent",2005,169525,-23,585,2023,1438,-462,70,-532,-146
"20020",NA,NA,"Dothan, AL","Metropolitan Statistical Area",2005,135546,1339,250,1718,1468,1197,55,1142,-108
"20020",NA,1061,"Geneva County, AL","County or equivalent",2005,25584,126,-56,281,337,208,6,202,-26
"20020",NA,1067,"Henry County, AL","County or equivalent",2005,16425,-7,-14,188,202,21,8,13,-14
"20020",NA,1069,"Houston County, AL","County or equivalent",2005,93537,1220,320,1249,929,968,41,927,-68
"20100",NA,NA,"Dover, DE","Metropolitan Statistical Area",2005,143206,4887,901,2085,1184,4085,69,4016,-99
"20100",NA,10001,"Kent County, DE","County or equivalent",2005,143206,4887,901,2085,1184,4085,69,4016,-99
"20220",NA,NA,"Dubuque, IA","Metropolitan Statistical Area",2005,90975,342,353,1207,854,-11,89,-100,0
"20220",NA,19061,"Dubuque County, IA","County or equivalent",2005,90975,342,353,1207,854,-11,89,-100,0
"20260",NA,NA,"Duluth, MN-WI","Metropolitan Statistical Area",2005,274116,-863,78,2933,2855,-685,95,-780,-256
"20260",NA,27017,"Carlton County, MN","County or equivalent",2005,33653,291,62,393,331,262,7,255,-33
"20260",NA,27137,"St. Louis County, MN","County or equivalent",2005,196552,-1187,-10,2071,2081,-998,64,-1062,-179
"20260",NA,55031,"Douglas County, WI","County or equivalent",2005,43911,33,26,469,443,51,24,27,-44
"20500",NA,NA,"Durham, NC","Metropolitan Statistical Area",2005,457943,6811,3199,6507,3308,4028,2649,1379,-416
"20500",NA,37037,"Chatham County, NC","County or equivalent",2005,57935,1003,240,748,508,816,309,507,-53
"20500",NA,37063,"Durham County, NC","County or equivalent",2005,243534,3736,2256,3954,1698,1707,1690,17,-227
"20500",NA,37135,"Orange County, NC","County or equivalent",2005,119519,1738,636,1358,722,1202,633,569,-100
"20500",NA,37145,"Person County, NC","County or equivalent",2005,36955,334,67,447,380,303,17,286,-36
"20740",NA,NA,"Eau Claire, WI","Metropolitan Statistical Area",2005,154738,1334,679,1904,1225,791,67,724,-136
"20740",NA,55017,"Chippewa County, WI","County or equivalent",2005,59178,835,218,743,525,670,13,657,-53
"20740",NA,55035,"Eau Claire County, WI","County or equivalent",2005,95560,499,461,1161,700,121,54,67,-83
"20940",NA,NA,"El Centro, CA","Metropolitan Statistical Area",2005,153285,3207,2127,3021,894,1227,935,292,-147
"20940",NA,6025,"Imperial County, CA","County or equivalent",2005,153285,3207,2127,3021,894,1227,935,292,-147
"21060",NA,NA,"Elizabethtown, KY","Metropolitan Statistical Area",2005,110207,1343,877,1721,844,570,26,544,-104
"21060",NA,21093,"Hardin County, KY","County or equivalent",2005,96719,1230,896,1575,679,426,25,401,-92
"21060",NA,21123,"Larue County, KY","County or equivalent",2005,13488,113,-19,146,165,144,1,143,-12
"21140",NA,NA,"Elkhart-Goshen, IN","Metropolitan Statistical Area",2005,193428,3480,1912,3339,1427,1755,729,1026,-187
"21140",NA,18039,"Elkhart County, IN","County or equivalent",2005,193428,3480,1912,3339,1427,1755,729,1026,-187
"21300",NA,NA,"Elmira, NY","Metropolitan Statistical Area",2005,88381,-1005,38,1013,975,-969,35,-1004,-74
"21300",NA,36015,"Chemung County, NY","County or equivalent",2005,88381,-1005,38,1013,975,-969,35,-1004,-74
"21340",NA,NA,"El Paso, TX","Metropolitan Statistical Area",2005,709992,6555,10185,14401,4216,-3017,3724,-6741,-613
"21340",NA,48141,"El Paso County, TX","County or equivalent",2005,709992,6555,10185,14401,4216,-3017,3724,-6741,-613
"21500",NA,NA,"Erie, PA","Metropolitan Statistical Area",2005,278781,-887,509,3290,2781,-1363,339,-1702,-33
"21500",NA,42049,"Erie County, PA","County or equivalent",2005,278781,-887,509,3290,2781,-1363,339,-1702,-33
"21660",NA,NA,"Eugene-Springfield, OR","Metropolitan Statistical Area",2005,335422,3432,483,3509,3026,3228,591,2637,-279
"21660",NA,41039,"Lane County, OR","County or equivalent",2005,335422,3432,483,3509,3026,3228,591,2637,-279
"21780",NA,NA,"Evansville, IN-KY","Metropolitan Statistical Area",2005,347718,880,1083,4552,3469,117,182,-65,-320
"21780",NA,18051,"Gibson County, IN","County or equivalent",2005,32918,-14,56,399,343,-42,12,-54,-28
"21780",NA,18129,"Posey County, IN","County or equivalent",2005,26496,-177,8,244,236,-163,7,-170,-22
"21780",NA,18163,"Vanderburgh County, IN","County or equivalent",2005,173623,185,629,2467,1838,-275,110,-385,-169
"21780",NA,18173,"Warrick County, IN","County or equivalent",2005,55604,793,195,657,462,645,12,633,-47
"21780",NA,21101,"Henderson County, KY","County or equivalent",2005,45107,74,158,596,438,-43,19,-62,-41
"21780",NA,21233,"Webster County, KY","County or equivalent",2005,13970,19,37,189,152,-5,22,-27,-13
"21820",NA,NA,"Fairbanks, AK","Metropolitan Statistical Area",2005,94561,2147,1209,1583,374,-196,8,-204,1134
"21820",NA,2090,"Fairbanks North Star Borough, AK","County or equivalent",2005,94561,2147,1209,1583,374,-196,8,-204,1134
"22020",NA,NA,"Fargo, ND-MN","Metropolitan Statistical Area",2005,185680,2088,1388,2486,1098,877,294,583,-177
"22020",NA,27027,"Clay County, MN","County or equivalent",2005,53318,697,305,661,356,444,29,415,-52
"22020",NA,38017,"Cass County, ND","County or equivalent",2005,132362,1391,1083,1825,742,433,265,168,-125
"22140",NA,NA,"Farmington, NM","Metropolitan Statistical Area",2005,121843,1026,1277,2052,775,-138,108,-246,-113
"22140",NA,35045,"San Juan County, NM","County or equivalent",2005,121843,1026,1277,2052,775,-138,108,-246,-113
"22180",NA,NA,"Fayetteville, NC","Metropolitan Statistical Area",2005,344855,-4142,4043,6307,2264,-7936,221,-8157,-249
"22180",NA,37051,"Cumberland County, NC","County or equivalent",2005,305209,-5767,3550,5545,1995,-9104,116,-9220,-213
"22180",NA,37093,"Hoke County, NC","County or equivalent",2005,39646,1625,493,762,269,1168,105,1063,-36
"22220",NA,NA,"Fayetteville-Springdale-Rogers, AR-MO","Metropolitan Statistical Area",2005,407794,15625,3830,6675,2845,11210,1221,9989,585
"22220",NA,5007,"Benton County, AR","County or equivalent",2005,186753,8155,1759,2999,1240,5889,421,5468,507
"22220",NA,5087,"Madison County, AR","County or equivalent",2005,14843,295,34,174,140,271,9,262,-10
"22220",NA,5143,"Washington County, AR","County or equivalent",2005,183644,6911,1878,3141,1263,4925,724,4201,108
"22220",NA,29119,"McDonald County, MO","County or equivalent",2005,22554,264,159,361,202,125,67,58,-20
"22380",NA,NA,"Flagstaff, AZ","Metropolitan Statistical Area",2005,124653,1418,1478,2111,633,51,172,-121,-111
"22380",NA,4005,"Coconino County, AZ","County or equivalent",2005,124653,1418,1478,2111,633,51,172,-121,-111
"22420",NA,NA,"Flint, MI","Metropolitan Statistical Area",2005,439113,-665,2142,6060,3918,-2423,139,-2562,-384
"22420",NA,26049,"Genesee County, MI","County or equivalent",2005,439113,-665,2142,6060,3918,-2423,139,-2562,-384
"22500",NA,NA,"Florence, SC","Metropolitan Statistical Area",2005,196670,635,698,2775,2077,116,86,30,-179
"22500",NA,45031,"Darlington County, SC","County or equivalent",2005,66862,-234,162,851,689,-336,22,-358,-60
"22500",NA,45041,"Florence County, SC","County or equivalent",2005,129808,869,536,1924,1388,452,64,388,-119
"22520",NA,NA,"Florence-Muscle Shoals, AL","Metropolitan Statistical Area",2005,141790,194,-103,1502,1605,431,51,380,-134
"22520",NA,1033,"Colbert County, AL","County or equivalent",2005,54375,-36,-3,630,633,19,10,9,-52
"22520",NA,1077,"Lauderdale County, AL","County or equivalent",2005,87415,230,-100,872,972,412,41,371,-82
"22540",NA,NA,"Fond du Lac, WI","Metropolitan Statistical Area",2005,98392,169,202,1144,942,63,89,-26,-96
"22540",NA,55039,"Fond du Lac County, WI","County or equivalent",2005,98392,169,202,1144,942,63,89,-26,-96
"22660",NA,NA,"Fort Collins-Loveland, CO","Metropolitan Statistical Area",2005,275570,3699,1791,3329,1538,2126,533,1593,-218
"22660",NA,8069,"Larimer County, CO","County or equivalent",2005,275570,3699,1791,3329,1538,2126,533,1593,-218
"22900",NA,NA,"Fort Smith, AR-OK","Metropolitan Statistical Area",2005,282291,2271,1240,4124,2884,1294,464,830,-263
"22900",NA,5033,"Crawford County, AR","County or equivalent",2005,56903,760,230,775,545,575,21,554,-45
"22900",NA,5047,"Franklin County, AR","County or equivalent",2005,17982,97,16,203,187,98,8,90,-17
"22900",NA,5131,"Sebastian County, AR","County or equivalent",2005,118358,1037,737,1866,1129,415,348,67,-115
"22900",NA,40079,"Le Flore County, OK","County or equivalent",2005,48806,227,159,716,557,115,77,38,-47
"22900",NA,40135,"Sequoyah County, OK","County or equivalent",2005,40242,150,98,564,466,91,10,81,-39
"23020",NA,NA,"Fort Walton Beach-Crestview-Destin, FL","Metropolitan Statistical Area",2005,183259,1183,1344,2783,1439,-28,-14,-14,-133
"23020",NA,12091,"Okaloosa County, FL","County or equivalent",2005,183259,1183,1344,2783,1439,-28,-14,-14,-133
"23060",NA,NA,"Fort Wayne, IN","Metropolitan Statistical Area",2005,402137,2359,2932,6049,3117,-208,657,-865,-365
"23060",NA,18003,"Allen County, IN","County or equivalent",2005,342387,2096,2762,5342,2580,-354,645,-999,-312
"23060",NA,18179,"Wells County, IN","County or equivalent",2005,27762,-16,77,313,236,-70,1,-71,-23
"23060",NA,18183,"Whitley County, IN","County or equivalent",2005,31988,279,93,394,301,216,11,205,-30
"23420",NA,NA,"Fresno, CA","Metropolitan Statistical Area",2005,870620,10891,10156,15993,5837,1568,4041,-2473,-833
"23420",NA,6019,"Fresno County, CA","County or equivalent",2005,870620,10891,10156,15993,5837,1568,4041,-2473,-833
"23460",NA,NA,"Gadsden, AL","Metropolitan Statistical Area",2005,102433,-92,-134,1228,1362,140,72,68,-98
"23460",NA,1055,"Etowah County, AL","County or equivalent",2005,102433,-92,-134,1228,1362,140,72,68,-98
"23540",NA,NA,"Gainesville, FL","Metropolitan Statistical Area",2005,247578,3877,1179,2882,1703,2901,698,2203,-203
"23540",NA,12001,"Alachua County, FL","County or equivalent",2005,231356,3374,1120,2685,1565,2442,694,1748,-188
"23540",NA,12041,"Gilchrist County, FL","County or equivalent",2005,16222,503,59,197,138,459,4,455,-15
"23580",NA,NA,"Gainesville, GA","Metropolitan Statistical Area",2005,164947,5448,2079,3111,1032,3346,1408,1938,23
"23580",NA,13139,"Hall County, GA","County or equivalent",2005,164947,5448,2079,3111,1032,3346,1408,1938,23
"24020",NA,NA,"Glens Falls, NY","Metropolitan Statistical Area",2005,127429,687,148,1293,1145,659,35,624,-120
"24020",NA,36113,"Warren County, NY","County or equivalent",2005,65350,593,55,642,587,598,28,570,-60
"24020",NA,36115,"Washington County, NY","County or equivalent",2005,62079,94,93,651,558,61,7,54,-60
"24140",NA,NA,"Goldsboro, NC","Metropolitan Statistical Area",2005,113203,-326,705,1793,1088,-938,190,-1128,-93
"24140",NA,37191,"Wayne County, NC","County or equivalent",2005,113203,-326,705,1793,1088,-938,190,-1128,-93
"24220",NA,NA,"Grand Forks, ND-MN","Metropolitan Statistical Area",2005,97236,-551,503,1258,755,-974,82,-1056,-80
"24220",NA,27119,"Polk County, MN","County or equivalent",2005,30733,-39,44,361,317,-53,8,-61,-30
"24220",NA,38035,"Grand Forks County, ND","County or equivalent",2005,66503,-512,459,897,438,-921,74,-995,-50
"24300",NA,NA,"Grand Junction, CO","Metropolitan Statistical Area",2005,129525,2394,514,1757,1243,1980,106,1874,-100
"24300",NA,8077,"Mesa County, CO","County or equivalent",2005,129525,2394,514,1757,1243,1980,106,1874,-100
"24340",NA,NA,"Grand Rapids-Wyoming, MI","Metropolitan Statistical Area",2005,767883,4039,5923,11662,5739,-1183,1850,-3033,-701
"24340",NA,26015,"Barry County, MI","County or equivalent",2005,58988,500,188,715,527,369,7,362,-57
"24340",NA,26067,"Ionia County, MI","County or equivalent",2005,63880,18,374,864,490,-301,13,-314,-55
"24340",NA,26081,"Kent County, MI","County or equivalent",2005,595662,3375,5151,9443,4292,-1230,1805,-3035,-546
"24340",NA,26123,"Newaygo County, MI","County or equivalent",2005,49353,146,210,640,430,-21,25,-46,-43
"24500",NA,NA,"Great Falls, MT","Metropolitan Statistical Area",2005,81791,101,353,1138,785,-613,-9,-604,361
"24500",NA,30013,"Cascade County, MT","County or equivalent",2005,81791,101,353,1138,785,-613,-9,-604,361
"24540",NA,NA,"Greeley, CO /1","Metropolitan Statistical Area",2005,226354,8314,2578,3851,1273,5942,753,5189,-206
"24540",NA,8123,"Weld County, CO /1","County or equivalent",2005,226354,8314,2578,3851,1273,5942,753,5189,-206
"24580",NA,NA,"Green Bay, WI","Metropolitan Statistical Area",2005,296384,2067,1804,3845,2041,531,414,117,-268
"24580",NA,55009,"Brown County, WI","County or equivalent",2005,238679,1886,1687,3233,1546,414,406,8,-215
"24580",NA,55061,"Kewaunee County, WI","County or equivalent",2005,20478,47,41,222,181,24,6,18,-18
"24580",NA,55083,"Oconto County, WI","County or equivalent",2005,37227,134,76,390,314,93,2,91,-35
"24660",NA,NA,"Greensboro-High Point, NC","Metropolitan Statistical Area",2005,673268,8625,2886,8751,5865,6365,2359,4006,-626
"24660",NA,37081,"Guilford County, NC","County or equivalent",2005,444944,6940,2217,5897,3680,5129,1669,3460,-406
"24660",NA,37151,"Randolph County, NC","County or equivalent",2005,136587,1605,645,1789,1144,1091,525,566,-131
"24660",NA,37157,"Rockingham County, NC","County or equivalent",2005,91737,80,24,1065,1041,145,165,-20,-89
"24780",NA,NA,"Greenville, NC","Metropolitan Statistical Area",2005,163927,2568,1049,2298,1249,1657,327,1330,-138
"24780",NA,37079,"Greene County, NC","County or equivalent",2005,19713,-72,82,258,176,-140,73,-213,-14
"24780",NA,37147,"Pitt County, NC","County or equivalent",2005,144214,2640,967,2040,1073,1797,254,1543,-124
"24860",NA,NA,"Greenville-Mauldin-Easley, SC","Metropolitan Statistical Area",2005,588714,6907,2895,7902,5007,4544,1336,3208,-532
"24860",NA,45045,"Greenville County, SC","County or equivalent",2005,405820,6171,2493,5775,3282,4047,1076,2971,-369
"24860",NA,45059,"Laurens County, SC","County or equivalent",2005,69328,120,42,809,767,139,72,67,-61
"24860",NA,45077,"Pickens County, SC","County or equivalent",2005,113566,616,360,1318,958,358,188,170,-102
"25060",NA,NA,"Gulfport-Biloxi, MS","Metropolitan Statistical Area",2005,256539,2253,1262,3698,2436,1219,79,1140,-228
"25060",NA,28045,"Hancock County, MS","County or equivalent",2005,46088,643,90,547,457,597,11,586,-44
"25060",NA,28047,"Harrison County, MS","County or equivalent",2005,195756,1212,1153,2978,1825,234,67,167,-175
"25060",NA,28131,"Stone County, MS","County or equivalent",2005,14695,398,19,173,154,388,1,387,-9
"25180",NA,NA,"Hagerstown-Martinsburg, MD-WV","Metropolitan Statistical Area",2005,249510,6545,805,3110,2305,5963,80,5883,-223
"25180",NA,24043,"Washington County, MD","County or equivalent",2005,141119,2412,354,1710,1356,2193,60,2133,-135
"25180",NA,54003,"Berkeley County, WV","County or equivalent",2005,92538,3919,491,1237,746,3504,13,3491,-76
"25180",NA,54065,"Morgan County, WV","County or equivalent",2005,15853,214,-40,163,203,266,7,259,-12
"25260",NA,NA,"Hanford-Corcoran, CA","Metropolitan Statistical Area",2005,143507,1117,1866,2617,751,-619,465,-1084,-130
"25260",NA,6031,"Kings County, CA","County or equivalent",2005,143507,1117,1866,2617,751,-619,465,-1084,-130
"25420",NA,NA,"Harrisburg-Carlisle, PA","Metropolitan Statistical Area",2005,519747,2493,1249,6286,5037,1695,620,1075,-451
"25420",NA,42041,"Cumberland County, PA","County or equivalent",2005,222538,1877,212,2359,2147,1853,237,1616,-188
"25420",NA,42043,"Dauphin County, PA","County or equivalent",2005,252721,392,874,3365,2491,-261,382,-643,-221
"25420",NA,42099,"Perry County, PA","County or equivalent",2005,44488,224,163,562,399,103,1,102,-42
"25500",NA,NA,"Harrisonburg, VA","Metropolitan Statistical Area",2005,114156,1770,517,1390,873,883,336,547,370
"25500",NA,51165,"Rockingham County, VA","County or equivalent",2005,71557,1422,270,867,597,749,105,644,403
"25500",NA,51660,"Harrisonburg city, VA","County or equivalent",2005,42599,348,247,523,276,134,231,-97,-33
"25540",NA,NA,"Hartford-West Hartford-East Hartford, CT","Metropolitan Statistical Area",2005,1178810,3379,3374,13601,10227,1111,3129,-2018,-1106
"25540",NA,9003,"Hartford County, CT","County or equivalent",2005,870496,2078,2451,10474,8023,452,2710,-2258,-825
"25540",NA,9007,"Middlesex County, CT","County or equivalent",2005,161930,631,430,1730,1300,352,214,138,-151
"25540",NA,9013,"Tolland County, CT","County or equivalent",2005,146384,670,493,1397,904,307,205,102,-130
"25620",NA,NA,"Hattiesburg, MS","Metropolitan Statistical Area",2005,131739,1971,849,1986,1137,1232,95,1137,-110
"25620",NA,28035,"Forrest County, MS","County or equivalent",2005,75585,851,432,1126,694,482,92,390,-63
"25620",NA,28073,"Lamar County, MS","County or equivalent",2005,44150,1285,372,697,325,950,4,946,-37
"25620",NA,28111,"Perry County, MS","County or equivalent",2005,12004,-165,45,163,118,-200,-1,-199,-10
"25860",NA,NA,"Hickory-Lenoir-Morganton, NC","Metropolitan Statistical Area",2005,353532,2753,1075,4406,3331,1943,814,1129,-265
"25860",NA,37003,"Alexander County, NC","County or equivalent",2005,35590,413,105,417,312,340,30,310,-32
"25860",NA,37023,"Burke County, NC","County or equivalent",2005,88583,-75,109,1010,901,-104,177,-281,-80
"25860",NA,37027,"Caldwell County, NC","County or equivalent",2005,78734,372,190,947,757,193,80,113,-11
"25860",NA,37035,"Catawba County, NC","County or equivalent",2005,150625,2043,671,2032,1361,1514,527,987,-142
"25980",NA,NA,"Hinesville-Fort Stewart, GA","Metropolitan Statistical Area",2005,73822,1040,1365,1700,335,-262,-14,-248,-63
"25980",NA,13179,"Liberty County, GA","County or equivalent",2005,62936,889,1242,1514,272,-299,-46,-253,-54
"25980",NA,13183,"Long County, GA","County or equivalent",2005,10886,151,123,186,63,37,32,5,-9
"26100",NA,NA,"Holland-Grand Haven, MI","Metropolitan Statistical Area",2005,254231,2002,1991,3503,1512,248,294,-46,-237
"26100",NA,26139,"Ottawa County, MI","County or equivalent",2005,254231,2002,1991,3503,1512,248,294,-46,-237
"26180",NA,NA,"Honolulu, HI","Metropolitan Statistical Area",2005,899673,5794,6713,13048,6335,-99,2925,-3024,-820
"26180",NA,15003,"Honolulu County, HI","County or equivalent",2005,899673,5794,6713,13048,6335,-99,2925,-3024,-820
"26300",NA,NA,"Hot Springs, AR","Metropolitan Statistical Area",2005,93197,1210,-229,1090,1319,1521,55,1466,-82
"26300",NA,5051,"Garland County, AR","County or equivalent",2005,93197,1210,-229,1090,1319,1521,55,1466,-82
"26380",NA,NA,"Houma-Bayou Cane-Thibodaux, LA","Metropolitan Statistical Area",2005,197514,471,1280,2871,1591,-625,94,-719,-184
"26380",NA,22057,"Lafourche Parish, LA","County or equivalent",2005,91347,-261,453,1184,731,-633,47,-680,-81
"26380",NA,22109,"Terrebonne Parish, LA","County or equivalent",2005,106167,732,827,1687,860,8,47,-39,-103
"26420",NA,NA,"Houston-Sugar Land-Baytown, TX","Metropolitan Statistical Area",2005,5302908,109879,59937,90064,30127,38470,32283,6187,11472
"26420",NA,48015,"Austin County, TX","County or equivalent",2005,25744,243,38,332,294,227,51,176,-22
"26420",NA,48039,"Brazoria County, TX","County or equivalent",2005,274122,6199,2515,4327,1812,3925,601,3324,-241
"26420",NA,48071,"Chambers County, TX","County or equivalent",2005,28000,346,153,356,203,218,46,172,-25
"26420",NA,48157,"Fort Bend County, TX","County or equivalent",2005,458516,20632,4661,6377,1716,15673,1581,14092,298
"26420",NA,48167,"Galveston County, TX","County or equivalent",2005,274618,4948,1579,3952,2373,3606,687,2919,-237
"26420",NA,48201,"Harris County, TX","County or equivalent",2005,3735075,62384,47234,67523,20289,3434,28108,-24674,11716
"26420",NA,48291,"Liberty County, TX","County or equivalent",2005,74455,72,356,1027,671,-220,95,-315,-64
"26420",NA,48339,"Montgomery County, TX","County or equivalent",2005,373511,15151,3093,5380,2287,11962,1006,10956,96
"26420",NA,48407,"San Jacinto County, TX","County or equivalent",2005,24332,115,35,243,208,100,20,80,-20
"26420",NA,48473,"Waller County, TX","County or equivalent",2005,34535,-211,273,547,274,-455,88,-543,-29
"26580",NA,NA,"Huntington-Ashland, WV-KY-OH","Metropolitan Statistical Area",2005,284392,-764,-118,3364,3482,-402,62,-464,-244
"26580",NA,21019,"Boyd County, KY","County or equivalent",2005,48783,-274,-34,568,602,-203,7,-210,-37
"26580",NA,21089,"Greenup County, KY","County or equivalent",2005,36960,34,62,446,384,7,-1,8,-35
"26580",NA,39087,"Lawrence County, OH","County or equivalent",2005,62443,290,29,763,734,318,10,308,-57
"26580",NA,54011,"Cabell County, WV","County or equivalent",2005,94304,-534,-127,1134,1261,-320,39,-359,-87
"26580",NA,54099,"Wayne County, WV","County or equivalent",2005,41902,-280,-48,453,501,-204,7,-211,-28
"26620",NA,NA,"Huntsville, AL","Metropolitan Statistical Area",2005,369168,6605,1763,4676,2913,4913,414,4499,-71
"26620",NA,1083,"Limestone County, AL","County or equivalent",2005,69759,1386,300,889,589,1149,34,1115,-63
"26620",NA,1089,"Madison County, AL","County or equivalent",2005,299409,5219,1463,3787,2324,3764,380,3384,-8
"26820",NA,NA,"Idaho Falls, ID","Metropolitan Statistical Area",2005,111915,2698,1503,2228,725,1291,124,1167,-96
"26820",NA,16019,"Bonneville County, ID","County or equivalent",2005,90693,1977,1184,1783,599,870,92,778,-77
"26820",NA,16051,"Jefferson County, ID","County or equivalent",2005,21222,721,319,445,126,421,32,389,-19
"26900",NA,NA,"Indianapolis-Carmel, IN","Metropolitan Statistical Area",2005,1643072,21593,12230,25104,12874,10197,2477,7720,-834
"26900",NA,18011,"Boone County, IN","County or equivalent",2005,51399,1118,340,718,378,823,15,808,-45
"26900",NA,18013,"Brown County, IN","County or equivalent",2005,14898,-181,-26,91,117,-145,4,-149,-10
"26900",NA,18057,"Hamilton County, IN","County or equivalent",2005,241796,10228,2586,3645,1059,7594,241,7353,48
"26900",NA,18059,"Hancock County, IN","County or equivalent",2005,62413,1986,330,869,539,1703,5,1698,-47
"26900",NA,18063,"Hendricks County, IN","County or equivalent",2005,126243,3497,763,1561,798,2842,56,2786,-108
"26900",NA,18081,"Johnson County, IN","County or equivalent",2005,129249,2889,594,1729,1135,2056,76,1980,239
"26900",NA,18097,"Marion County, IN","County or equivalent",2005,867476,1547,7123,14709,7586,-4799,1996,-6795,-777
"26900",NA,18109,"Morgan County, IN","County or equivalent",2005,69174,434,292,854,562,208,10,198,-66
"26900",NA,18133,"Putnam County, IN","County or equivalent",2005,36996,116,111,390,279,35,13,22,-30
"26900",NA,18145,"Shelby County, IN","County or equivalent",2005,43428,-41,117,538,421,-120,61,-181,-38
"26980",NA,NA,"Iowa City, IA","Metropolitan Statistical Area",2005,142293,1500,952,1733,781,575,443,132,-27
"26980",NA,19103,"Johnson County, IA","County or equivalent",2005,121236,1472,915,1454,539,565,433,132,-8
"26980",NA,19183,"Washington County, IA","County or equivalent",2005,21057,28,37,279,242,10,10,0,-19
"27060",NA,NA,"Ithaca, NY","Metropolitan Statistical Area",2005,99887,17,281,914,633,-175,586,-761,-89
"27060",NA,36109,"Tompkins County, NY","County or equivalent",2005,99887,17,281,914,633,-175,586,-761,-89
"27100",NA,NA,"Jackson, MI","Metropolitan Statistical Area",2005,162573,783,510,2124,1614,428,81,347,-155
"27100",NA,26075,"Jackson County, MI","County or equivalent",2005,162573,783,510,2124,1614,428,81,347,-155
"27140",NA,NA,"Jackson, MS","Metropolitan Statistical Area",2005,521330,5451,3441,7924,4483,2429,222,2207,-419
"27140",NA,28029,"Copiah County, MS","County or equivalent",2005,28914,-80,123,443,320,-175,1,-176,-28
"27140",NA,28049,"Hinds County, MS","County or equivalent",2005,248920,-518,1861,3914,2053,-2176,92,-2268,-203
"27140",NA,28089,"Madison County, MS","County or equivalent",2005,84407,2443,215,1217,1002,2268,41,2227,-40
"27140",NA,28121,"Rankin County, MS","County or equivalent",2005,131276,3306,1120,1942,822,2308,72,2236,-122
"27140",NA,28127,"Simpson County, MS","County or equivalent",2005,27813,300,122,408,286,204,16,188,-26
"27180",NA,NA,"Jackson, TN","Metropolitan Statistical Area",2005,110663,748,470,1523,1053,376,124,252,-98
"27180",NA,47023,"Chester County, TN","County or equivalent",2005,15863,87,30,169,139,72,2,70,-15
"27180",NA,47113,"Madison County, TN","County or equivalent",2005,94800,661,440,1354,914,304,122,182,-83
"27260",NA,NA,"Jacksonville, FL","Metropolitan Statistical Area",2005,1247794,25640,7478,17714,10236,19221,1440,17781,-1059
"27260",NA,12003,"Baker County, FL","County or equivalent",2005,24418,596,216,377,161,401,3,398,-21
"27260",NA,12019,"Clay County, FL","County or equivalent",2005,168121,5773,850,2137,1287,5062,106,4956,-139
"27260",NA,12031,"Duval County, FL","County or equivalent",2005,830399,9088,5867,12815,6948,3960,1196,2764,-739
"27260",NA,12089,"Nassau County, FL","County or equivalent",2005,64508,1611,157,749,592,1508,28,1480,-54
"27260",NA,12109,"St. Johns County, FL","County or equivalent",2005,160348,8572,388,1636,1248,8290,107,8183,-106
"27340",NA,NA,"Jacksonville, NC","Metropolitan Statistical Area",2005,158926,-2318,2437,3293,856,-4649,-155,-4494,-106
"27340",NA,37133,"Onslow County, NC","County or equivalent",2005,158926,-2318,2437,3293,856,-4649,-155,-4494,-106
"27500",NA,NA,"Janesville, WI","Metropolitan Statistical Area",2005,156394,1012,622,1977,1355,540,228,312,-150
"27500",NA,55105,"Rock County, WI","County or equivalent",2005,156394,1012,622,1977,1355,540,228,312,-150
"27620",NA,NA,"Jefferson City, MO","Metropolitan Statistical Area",2005,143407,1600,758,1951,1193,968,107,861,-126
"27620",NA,29027,"Callaway County, MO","County or equivalent",2005,42503,925,220,539,319,744,23,721,-39
"27620",NA,29051,"Cole County, MO","County or equivalent",2005,72527,399,388,991,603,70,81,-11,-59
"27620",NA,29135,"Moniteau County, MO","County or equivalent",2005,15058,180,76,224,148,119,3,116,-15
"27620",NA,29151,"Osage County, MO","County or equivalent",2005,13319,96,74,197,123,35,0,35,-13
"27740",NA,NA,"Johnson City, TN","Metropolitan Statistical Area",2005,188794,1685,76,2135,2059,1766,108,1658,-157
"27740",NA,47019,"Carter County, TN","County or equivalent",2005,58628,245,-18,623,641,315,18,297,-52
"27740",NA,47171,"Unicoi County, TN","County or equivalent",2005,17561,-72,-45,194,239,-10,-1,-9,-17
"27740",NA,47179,"Washington County, TN","County or equivalent",2005,112605,1512,139,1318,1179,1461,91,1370,-88
"27780",NA,NA,"Johnstown, PA","Metropolitan Statistical Area",2005,146764,-964,-397,1518,1915,-437,37,-474,-130
"27780",NA,42021,"Cambria County, PA","County or equivalent",2005,146764,-964,-397,1518,1915,-437,37,-474,-130
"27860",NA,NA,"Jonesboro, AR","Metropolitan Statistical Area",2005,112500,1159,496,1655,1159,756,111,645,-93
"27860",NA,5031,"Craighead County, AR","County or equivalent",2005,87408,1134,448,1295,847,756,98,658,-70
"27860",NA,5111,"Poinsett County, AR","County or equivalent",2005,25092,25,48,360,312,0,13,-13,-23
"27900",NA,NA,"Joplin, MO","Metropolitan Statistical Area",2005,165875,2075,994,2550,1556,1233,159,1074,-152
"27900",NA,29097,"Jasper County, MO","County or equivalent",2005,110936,1454,771,1801,1030,781,133,648,-98
"27900",NA,29145,"Newton County, MO","County or equivalent",2005,54939,621,223,749,526,452,26,426,-54
"28020",NA,NA,"Kalamazoo-Portage, MI","Metropolitan Statistical Area",2005,320457,498,1479,4106,2627,-690,488,-1178,-291
"28020",NA,26077,"Kalamazoo County, MI","County or equivalent",2005,242533,585,1149,3039,1890,-343,439,-782,-221
"28020",NA,26159,"Van Buren County, MI","County or equivalent",2005,77924,-87,330,1067,737,-347,49,-396,-70
"28100",NA,NA,"Kankakee-Bradley, IL","Metropolitan Statistical Area",2005,108431,1032,391,1503,1112,646,119,527,-5
"28100",NA,17091,"Kankakee County, IL","County or equivalent",2005,108431,1032,391,1503,1112,646,119,527,-5
"28140",NA,NA,"Kansas City, MO-KS","Metropolitan Statistical Area",2005,1937398,17013,13254,28818,15564,4892,3491,1401,-1133
"28140",NA,20059,"Franklin County, KS","County or equivalent",2005,25998,36,138,362,224,-102,14,-116,0
"28140",NA,20091,"Johnson County, KS","County or equivalent",2005,505329,9177,4395,7474,3079,5223,1069,4154,-441
"28140",NA,20103,"Leavenworth County, KS","County or equivalent",2005,71756,355,328,880,552,93,10,83,-66
"28140",NA,20107,"Linn County, KS","County or equivalent",2005,9844,155,20,102,82,143,0,143,-8
"28140",NA,20121,"Miami County, KS","County or equivalent",2005,29912,423,150,392,242,301,4,297,-28
"28140",NA,20209,"Wyandotte County, KS","County or equivalent",2005,153897,-577,1335,2829,1494,-1797,827,-2624,-115
"28140",NA,29013,"Bates County, MO","County or equivalent",2005,16945,-10,17,216,199,-13,6,-19,-14
"28140",NA,29025,"Caldwell County, MO","County or equivalent",2005,9160,19,20,121,101,7,0,7,-8
"28140",NA,29037,"Cass County, MO","County or equivalent",2005,92756,1790,475,1224,749,1402,44,1358,-87
"28140",NA,29047,"Clay County, MO","County or equivalent",2005,200959,3964,1519,2949,1430,2626,217,2409,-181
"28140",NA,29049,"Clinton County, MO","County or equivalent",2005,20540,11,-49,232,281,72,0,72,-12
"28140",NA,29095,"Jackson County, MO","County or equivalent",2005,661857,350,4222,10265,6043,-3831,1181,-5012,-41
"28140",NA,29107,"Lafayette County, MO","County or equivalent",2005,32875,86,82,438,356,37,3,34,-33
"28140",NA,29165,"Platte County, MO","County or equivalent",2005,82103,1396,597,1072,475,876,117,759,-77
"28140",NA,29177,"Ray County, MO","County or equivalent",2005,23467,-162,5,262,257,-145,-1,-144,-22
"28420",NA,NA,"Kennewick-Pasco-Richland, WA","Metropolitan Statistical Area",2005,218357,5060,2232,3588,1356,3016,911,2105,-188
"28420",NA,53005,"Benton County, WA","County or equivalent",2005,155930,1654,1079,2147,1068,709,419,290,-134
"28420",NA,53021,"Franklin County, WA","County or equivalent",2005,62427,3406,1153,1441,288,2307,492,1815,-54
"28660",NA,NA,"Killeen-Temple-Fort Hood, TX","Metropolitan Statistical Area",2005,354257,5982,4087,6348,2261,1947,71,1876,-52
"28660",NA,48027,"Bell County, TX","County or equivalent",2005,261620,6165,3559,5248,1689,2602,167,2435,4
"28660",NA,48099,"Coryell County, TX","County or equivalent",2005,73090,471,469,854,385,54,-117,171,-52
"28660",NA,48281,"Lampasas County, TX","County or equivalent",2005,19547,-654,59,246,187,-709,21,-730,-4
"28700",NA,NA,"Kingsport-Bristol-Bristol, TN-VA","Metropolitan Statistical Area",2005,300088,1317,-368,3147,3515,1969,109,1860,-284
"28700",NA,47073,"Hawkins County, TN","County or equivalent",2005,55966,587,76,641,565,559,12,547,-48
"28700",NA,47163,"Sullivan County, TN","County or equivalent",2005,151959,367,-168,1590,1758,683,78,605,-148
"28700",NA,51169,"Scott County, VA","County or equivalent",2005,22801,51,-108,221,329,181,4,177,-22
"28700",NA,51191,"Washington County, VA","County or equivalent",2005,51938,366,-84,513,597,501,10,491,-51
"28700",NA,51520,"Bristol city, VA","County or equivalent",2005,17424,-54,-84,182,266,45,5,40,-15
"28740",NA,NA,"Kingston, NY","Metropolitan Statistical Area",2005,181421,387,159,1728,1569,405,175,230,-177
"28740",NA,36111,"Ulster County, NY","County or equivalent",2005,181421,387,159,1728,1569,405,175,230,-177
"28940",NA,NA,"Knoxville, TN","Metropolitan Statistical Area",2005,657525,9653,1794,7971,6177,8054,538,7516,-195
"28940",NA,47001,"Anderson County, TN","County or equivalent",2005,71725,406,84,870,786,391,75,316,-69
"28940",NA,47009,"Blount County, TN","County or equivalent",2005,115152,2119,188,1329,1141,2019,74,1945,-88
"28940",NA,47093,"Knox County, TN","County or equivalent",2005,408809,5979,1388,5009,3621,4591,359,4232,0
"28940",NA,47105,"Loudon County, TN","County or equivalent",2005,43194,1079,51,509,458,1053,31,1022,-25
"28940",NA,47173,"Union County, TN","County or equivalent",2005,18645,70,83,254,171,0,-1,1,-13
"29020",NA,NA,"Kokomo, IN","Metropolitan Statistical Area",2005,100550,-70,291,1293,1002,-271,53,-324,-90
"29020",NA,18067,"Howard County, IN","County or equivalent",2005,84311,58,266,1104,838,-134,50,-184,-74
"29020",NA,18159,"Tipton County, IN","County or equivalent",2005,16239,-128,25,189,164,-137,3,-140,-16
"29100",NA,NA,"La Crosse, WI-MN","Metropolitan Statistical Area",2005,129279,489,436,1494,1058,165,62,103,-112
"29100",NA,27055,"Houston County, MN","County or equivalent",2005,19656,1,37,235,198,-19,3,-22,-17
"29100",NA,55063,"La Crosse County, WI","County or equivalent",2005,109623,488,399,1259,860,184,59,125,-95
"29140",NA,NA,"Lafayette, IN","Metropolitan Statistical Area",2005,184850,2307,1149,2410,1261,1323,793,530,-165
"29140",NA,18007,"Benton County, IN","County or equivalent",2005,8841,-116,37,129,92,-146,0,-146,-7
"29140",NA,18015,"Carroll County, IN","County or equivalent",2005,20054,75,65,228,163,28,18,10,-18
"29140",NA,18157,"Tippecanoe County, IN","County or equivalent",2005,155955,2348,1047,2053,1006,1441,775,666,-140
"29180",NA,NA,"Lafayette, LA","Metropolitan Statistical Area",2005,247214,1833,1875,3754,1879,189,205,-16,-231
"29180",NA,22055,"Lafayette Parish, LA","County or equivalent",2005,197212,1698,1501,2971,1470,384,200,184,-187
"29180",NA,22099,"St. Martin Parish, LA","County or equivalent",2005,50002,135,374,783,409,-195,5,-200,-44
"29340",NA,NA,"Lake Charles, LA","Metropolitan Statistical Area",2005,193961,253,962,2830,1868,-526,72,-598,-183
"29340",NA,22019,"Calcasieu Parish, LA","County or equivalent",2005,184401,319,946,2743,1797,-452,64,-516,-175
"29340",NA,22023,"Cameron Parish, LA","County or equivalent",2005,9560,-66,16,87,71,-74,8,-82,-8
"29420",NA,NA,"Lake Havasu City-Kingman, AZ","Metropolitan Statistical Area",2005,185843,7599,-145,2300,2445,7910,259,7651,-166
"29420",NA,4015,"Mohave County, AZ","County or equivalent",2005,185843,7599,-145,2300,2445,7910,259,7651,-166
"29460",NA,NA,"Lakeland-Winter Haven, FL","Metropolitan Statistical Area",2005,537863,17413,1769,7400,5631,16143,1039,15104,-499
"29460",NA,12105,"Polk County, FL","County or equivalent",2005,537863,17413,1769,7400,5631,16143,1039,15104,-499
"29540",NA,NA,"Lancaster, PA","Metropolitan Statistical Area",2005,488884,3483,2216,6724,4508,1689,430,1259,-422
"29540",NA,42071,"Lancaster County, PA","County or equivalent",2005,488884,3483,2216,6724,4508,1689,430,1259,-422
"29620",NA,NA,"Lansing-East Lansing, MI","Metropolitan Statistical Area",2005,456330,-297,2310,5665,3355,-2200,1043,-3243,-407
"29620",NA,26037,"Clinton County, MI","County or equivalent",2005,68857,511,304,808,504,272,11,261,-65
"29620",NA,26045,"Eaton County, MI","County or equivalent",2005,107139,345,299,1167,868,149,70,79,-103
"29620",NA,26065,"Ingham County, MI","County or equivalent",2005,280334,-1153,1707,3690,1983,-2621,962,-3583,-239
"29700",NA,NA,"Laredo, TX","Metropolitan Statistical Area",2005,221165,5256,5052,6000,948,417,1417,-1000,-213
"29700",NA,48479,"Webb County, TX","County or equivalent",2005,221165,5256,5052,6000,948,417,1417,-1000,-213
"29740",NA,NA,"Las Cruces, NM","Metropolitan Statistical Area",2005,189330,4285,2126,3362,1236,2327,626,1701,-168
"29740",NA,35013,"Dona Ana County, NM","County or equivalent",2005,189330,4285,2126,3362,1236,2327,626,1701,-168
"29820",NA,NA,"Las Vegas-Paradise, NV","Metropolitan Statistical Area",2005,1702957,60073,14459,26748,12289,47166,7980,39186,-1552
"29820",NA,32003,"Clark County, NV","County or equivalent",2005,1702957,60073,14459,26748,12289,47166,7980,39186,-1552
"29940",NA,NA,"Lawrence, KS","Metropolitan Statistical Area",2005,111519,3010,656,1229,573,330,278,52,2024
"29940",NA,20045,"Douglas County, KS","County or equivalent",2005,111519,3010,656,1229,573,330,278,52,2024
"30020",NA,NA,"Lawton, OK","Metropolitan Statistical Area",2005,111860,-1763,1111,2051,940,-2788,-74,-2714,-86
"30020",NA,40031,"Comanche County, OK","County or equivalent",2005,111860,-1763,1111,2051,940,-2788,-74,-2714,-86
"30140",NA,NA,"Lebanon, PA","Metropolitan Statistical Area",2005,124860,1236,219,1585,1366,1127,106,1021,-110
"30140",NA,42075,"Lebanon County, PA","County or equivalent",2005,124860,1236,219,1585,1366,1127,106,1021,-110
"30300",NA,NA,"Lewiston, ID-WA","Metropolitan Statistical Area",2005,58961,371,76,693,617,337,19,318,-42
"30300",NA,16069,"Nez Perce County, ID","County or equivalent",2005,38051,259,53,447,394,229,19,210,-23
"30300",NA,53003,"Asotin County, WA","County or equivalent",2005,20910,112,23,246,223,108,0,108,-19
"30340",NA,NA,"Lewiston-Auburn, ME","Metropolitan Statistical Area",2005,106584,222,283,1330,1047,26,51,-25,-87
"30340",NA,23001,"Androscoggin County, ME","County or equivalent",2005,106584,222,283,1330,1047,26,51,-25,-87
"30460",NA,NA,"Lexington-Fayette, KY","Metropolitan Statistical Area",2005,432283,5787,2878,6018,3140,3289,1101,2188,-380
"30460",NA,21017,"Bourbon County, KY","County or equivalent",2005,19717,127,37,243,206,109,33,76,-19
"30460",NA,21049,"Clark County, KY","County or equivalent",2005,34626,403,109,419,310,326,13,313,-32
"30460",NA,21067,"Fayette County, KY","County or equivalent",2005,271539,2481,1966,3876,1910,759,945,-186,-244
"30460",NA,21113,"Jessamine County, KY","County or equivalent",2005,43170,1042,263,576,313,813,27,786,-34
"30460",NA,21209,"Scott County, KY","County or equivalent",2005,39293,1503,394,608,214,1139,35,1104,-30
"30460",NA,21239,"Woodford County, KY","County or equivalent",2005,23938,231,109,296,187,143,48,95,-21
"30620",NA,NA,"Lima, OH","Metropolitan Statistical Area",2005,105550,-243,459,1480,1021,-608,25,-633,-94
"30620",NA,39003,"Allen County, OH","County or equivalent",2005,105550,-243,459,1480,1021,-608,25,-633,-94
"30700",NA,NA,"Lincoln, NE","Metropolitan Statistical Area",2005,284600,3553,2480,4318,1838,1347,802,545,-274
"30700",NA,31109,"Lancaster County, NE","County or equivalent",2005,267987,3636,2478,4137,1659,1416,795,621,-258
"30700",NA,31159,"Seward County, NE","County or equivalent",2005,16613,-83,2,181,179,-69,7,-76,-16
"30780",NA,NA,"Little Rock-North Little Rock-Conway, AR","Metropolitan Statistical Area",2005,645263,8352,3853,9392,5539,4654,429,4225,-155
"30780",NA,5045,"Faulkner County, AR","County or equivalent",2005,98564,2933,706,1410,704,2241,69,2172,-14
"30780",NA,5053,"Grant County, AR","County or equivalent",2005,17260,214,23,194,171,208,-1,209,-17
"30780",NA,5085,"Lonoke County, AR","County or equivalent",2005,59703,1656,318,822,504,1408,0,1408,-70
"30780",NA,5105,"Perry County, AR","County or equivalent",2005,10268,-16,13,111,98,-22,0,-22,-7
"30780",NA,5119,"Pulaski County, AR","County or equivalent",2005,369221,1744,2533,5837,3304,-820,336,-1156,31
"30780",NA,5125,"Saline County, AR","County or equivalent",2005,90247,1821,260,1018,758,1639,25,1614,-78
"30860",NA,NA,"Logan, UT-ID","Metropolitan Statistical Area",2005,116604,2443,2223,2680,457,-487,334,-821,707
"30860",NA,16041,"Franklin County, ID","County or equivalent",2005,12009,103,153,226,73,-38,22,-60,-12
"30860",NA,49005,"Cache County, UT","County or equivalent",2005,104595,2340,2070,2454,384,-449,312,-761,719
"30980",NA,NA,"Longview, TX","Metropolitan Statistical Area",2005,199377,1061,827,2998,2171,417,324,93,-183
"30980",NA,48183,"Gregg County, TX","County or equivalent",2005,114380,640,631,1862,1231,115,224,-109,-106
"30980",NA,48401,"Rusk County, TX","County or equivalent",2005,47604,119,138,647,509,24,86,-62,-43
"30980",NA,48459,"Upshur County, TX","County or equivalent",2005,37393,302,58,489,431,278,14,264,-34
"31020",NA,NA,"Longview, WA","Metropolitan Statistical Area",2005,96231,903,252,1261,1009,730,117,613,-79
"31020",NA,53015,"Cowlitz County, WA","County or equivalent",2005,96231,903,252,1261,1009,730,117,613,-79
"31100",NA,NA,"Los Angeles-Long Beach-Santa Ana, CA","Metropolitan Statistical Area",2005,12815345,8567,121043,196418,75375,-101928,98800,-200728,-10548
"31100",31084,NA,"Los Angeles-Long Beach-Glendale, CA","Metropolitan Division",2005,9846010,4793,92865,151645,58780,-80152,77268,-157420,-7920
"31100",31084,6037,"Los Angeles County, CA","County or equivalent",2005,9846010,4793,92865,151645,58780,-80152,77268,-157420,-7920
"31100",42044,NA,"Santa Ana-Anaheim-Irvine, CA","Metropolitan Division",2005,2969335,3774,28178,44773,16595,-21776,21532,-43308,-2628
"31100",42044,6059,"Orange County, CA","County or equivalent",2005,2969335,3774,28178,44773,16595,-21776,21532,-43308,-2628
"31140",NA,NA,"Louisville/Jefferson County, KY-IN","Metropolitan Statistical Area",2005,1207215,9080,5256,16017,10761,4231,1415,2816,-407
"31140",NA,18019,"Clark County, IN","County or equivalent",2005,101406,1243,378,1345,967,955,79,876,-90
"31140",NA,18043,"Floyd County, IN","County or equivalent",2005,71789,408,210,888,678,259,12,247,-61
"31140",NA,18061,"Harrison County, IN","County or equivalent",2005,36444,433,136,438,302,326,14,312,-29
"31140",NA,18175,"Washington County, IN","County or equivalent",2005,27610,-22,121,360,239,-118,3,-121,-25
"31140",NA,21029,"Bullitt County, KY","County or equivalent",2005,71098,2184,322,716,394,1222,2,1220,640
"31140",NA,21103,"Henry County, KY","County or equivalent",2005,15578,61,41,208,167,35,11,24,-15
"31140",NA,21111,"Jefferson County, KY","County or equivalent",2005,699913,1091,3073,9823,6750,-1313,1148,-2461,-669
"31140",NA,21163,"Meade County, KY","County or equivalent",2005,27866,70,59,257,198,36,-4,40,-25
"31140",NA,21179,"Nelson County, KY","County or equivalent",2005,40825,680,303,600,297,415,26,389,-38
"31140",NA,21185,"Oldham County, KY","County or equivalent",2005,52737,1226,228,538,310,1040,24,1016,-42
"31140",NA,21211,"Shelby County, KY","County or equivalent",2005,37879,1117,287,554,267,862,97,765,-32
"31140",NA,21215,"Spencer County, KY","County or equivalent",2005,15263,628,81,180,99,561,2,559,-14
"31140",NA,21223,"Trimble County, KY","County or equivalent",2005,8807,-39,17,110,93,-49,1,-50,-7
"31180",NA,NA,"Lubbock, TX","Metropolitan Statistical Area",2005,262596,1633,1994,4118,2124,-336,239,-575,-25
"31180",NA,48107,"Crosby County, TX","County or equivalent",2005,6527,-107,1,99,98,-103,3,-106,-5
"31180",NA,48303,"Lubbock County, TX","County or equivalent",2005,256069,1740,1993,4019,2026,-233,236,-469,-20
"31340",NA,NA,"Lynchburg, VA","Metropolitan Statistical Area",2005,235969,3306,375,2555,2180,3128,171,2957,-197
"31340",NA,51009,"Amherst County, VA","County or equivalent",2005,31886,154,26,319,293,159,17,142,-31
"31340",NA,51011,"Appomattox County, VA","County or equivalent",2005,13809,27,3,156,153,36,9,27,-12
"31340",NA,51019,"Bedford County, VA","County or equivalent",2005,64123,1098,148,620,472,1004,24,980,-54
"31340",NA,51031,"Campbell County, VA","County or equivalent",2005,51938,506,137,566,429,416,18,398,-47
"31340",NA,51515,"Bedford city, VA","County or equivalent",2005,6247,14,-49,57,106,67,-1,68,-4
"31340",NA,51680,"Lynchburg city, VA","County or equivalent",2005,67966,1507,110,837,727,1446,104,1342,-49
"31420",NA,NA,"Macon, GA","Metropolitan Statistical Area",2005,227582,596,1070,3385,2315,-280,143,-423,-194
"31420",NA,13021,"Bibb County, GA","County or equivalent",2005,154279,-107,783,2448,1665,-754,122,-876,-136
"31420",NA,13079,"Crawford County, GA","County or equivalent",2005,12613,37,56,170,114,-9,1,-10,-10
"31420",NA,13169,"Jones County, GA","County or equivalent",2005,26658,553,135,356,221,441,9,432,-23
"31420",NA,13207,"Monroe County, GA","County or equivalent",2005,23564,320,68,280,212,269,12,257,-17
"31420",NA,13289,"Twiggs County, GA","County or equivalent",2005,10468,-207,28,131,103,-227,-1,-226,-8
"31460",NA,NA,"Madera, CA","Metropolitan Statistical Area",2005,140049,3266,1445,2375,930,1942,711,1231,-121
"31460",NA,6039,"Madera County, CA","County or equivalent",2005,140049,3266,1445,2375,930,1942,711,1231,-121
"31540",NA,NA,"Madison, WI","Metropolitan Statistical Area",2005,539865,6518,3740,7083,3343,3275,1500,1775,-497
"31540",NA,55021,"Columbia County, WI","County or equivalent",2005,54568,205,156,662,506,101,17,84,-52
"31540",NA,55025,"Dane County, WI","County or equivalent",2005,461932,6111,3463,6107,2644,3074,1484,1590,-426
"31540",NA,55049,"Iowa County, WI","County or equivalent",2005,23365,202,121,314,193,100,-1,101,-19
"31700",NA,NA,"Manchester-Nashua, NH","Metropolitan Statistical Area",2005,398193,2173,2465,5286,2821,91,1020,-929,-383
"31700",NA,33011,"Hillsborough County, NH","County or equivalent",2005,398193,2173,2465,5286,2821,91,1020,-929,-383
"31900",NA,NA,"Mansfield, OH","Metropolitan Statistical Area",2005,126935,-516,227,1529,1302,-630,41,-671,-113
"31900",NA,39139,"Richland County, OH","County or equivalent",2005,126935,-516,227,1529,1302,-630,41,-671,-113
"32580",NA,NA,"McAllen-Edinburg-Mission, TX","Metropolitan Statistical Area",2005,667154,19383,13460,16653,3193,6577,4055,2522,-654
"32580",NA,48215,"Hidalgo County, TX","County or equivalent",2005,667154,19383,13460,16653,3193,6577,4055,2522,-654
"32780",NA,NA,"Medford, OR","Metropolitan Statistical Area",2005,194268,2452,333,2174,1841,2275,221,2054,-156
"32780",NA,41029,"Jackson County, OR","County or equivalent",2005,194268,2452,333,2174,1841,2275,221,2054,-156
"32820",NA,NA,"Memphis, TN-MS-AR","Metropolitan Statistical Area",2005,1252785,10423,8742,19419,10677,2693,1571,1122,-1012
"32820",NA,5035,"Crittenden County, AR","County or equivalent",2005,51440,201,390,882,492,-223,25,-248,34
"32820",NA,28033,"DeSoto County, MS","County or equivalent",2005,135966,5918,1066,2034,968,4954,101,4853,-102
"32820",NA,28093,"Marshall County, MS","County or equivalent",2005,35766,236,150,509,359,109,5,104,-23
"32820",NA,28137,"Tate County, MS","County or equivalent",2005,26311,236,146,375,229,111,1,110,-21
"32820",NA,28143,"Tunica County, MS","County or equivalent",2005,10159,140,101,205,104,48,6,42,-9
"32820",NA,47047,"Fayette County, TN","County or equivalent",2005,33993,853,124,437,313,754,6,748,-25
"32820",NA,47157,"Shelby County, TN","County or equivalent",2005,904000,1596,6510,14236,7726,-4097,1418,-5515,-817
"32820",NA,47167,"Tipton County, TN","County or equivalent",2005,55150,1243,255,741,486,1037,9,1028,-49
"32900",NA,NA,"Merced, CA","Metropolitan Statistical Area",2005,238034,4563,2954,4412,1458,1825,1091,734,-216
"32900",NA,6047,"Merced County, CA","County or equivalent",2005,238034,4563,2954,4412,1458,1825,1091,734,-216
"33100",NA,NA,"Miami-Fort Lauderdale-Pompano Beach, FL","Metropolitan Statistical Area",2005,5375410,64155,22857,70298,47441,40964,50887,-9923,334
"33100",22744,NA,"Fort Lauderdale-Pompano Beach-Deerfield Beach, FL","Metropolitan Division",2005,1763706,24036,7728,23182,15454,16373,12626,3747,-65
"33100",22744,12011,"Broward County, FL","County or equivalent",2005,1763706,24036,7728,23182,15454,16373,12626,3747,-65
"33100",33124,NA,"Miami-Miami Beach-Kendall, FL","Metropolitan Division",2005,2356697,19316,13754,32024,18270,3967,31970,-28003,1595
"33100",33124,12086,"Miami-Dade County, FL","County or equivalent",2005,2356697,19316,13754,32024,18270,3967,31970,-28003,1595
"33100",48424,NA,"West Palm Beach-Boca Raton-Boynton Beach, FL","Metropolitan Division",2005,1255007,20803,1375,15092,13717,20624,6291,14333,-1196
"33100",48424,12099,"Palm Beach County, FL","County or equivalent",2005,1255007,20803,1375,15092,13717,20624,6291,14333,-1196
"33140",NA,NA,"Michigan City-La Porte, IN","Metropolitan Statistical Area",2005,109145,564,278,1326,1048,393,79,314,-107
"33140",NA,18091,"LaPorte County, IN","County or equivalent",2005,109145,564,278,1326,1048,393,79,314,-107
"33260",NA,NA,"Midland, TX","Metropolitan Statistical Area",2005,120501,1356,1088,1957,869,381,160,221,-113
"33260",NA,48329,"Midland County, TX","County or equivalent",2005,120501,1356,1088,1957,869,381,160,221,-113
"33340",NA,NA,"Milwaukee-Waukesha-West Allis, WI","Metropolitan Statistical Area",2005,1534162,2406,8355,21123,12768,-10084,2819,-12903,4135
"33340",NA,55079,"Milwaukee County, WI","County or equivalent",2005,949251,-987,6120,14631,8511,-11784,2425,-14209,4677
"33340",NA,55089,"Ozaukee County, WI","County or equivalent",2005,84995,90,242,880,638,-74,63,-137,-78
"33340",NA,55131,"Washington County, WI","County or equivalent",2005,124992,1516,590,1442,852,1039,63,976,-113
"33340",NA,55133,"Waukesha County, WI","County or equivalent",2005,374924,1787,1403,4170,2767,735,268,467,-351
"33460",NA,NA,"Minneapolis-St. Paul-Bloomington, MN-WI","Metropolitan Statistical Area",2005,3131632,26011,27059,46085,19026,1531,8755,-7224,-2579
"33460",NA,27003,"Anoka County, MN","County or equivalent",2005,320213,3272,2880,4344,1464,664,350,314,-272
"33460",NA,27019,"Carver County, MN","County or equivalent",2005,83882,2919,949,1287,338,2037,117,1920,-67
"33460",NA,27025,"Chisago County, MN","County or equivalent",2005,48616,882,409,705,296,513,2,511,-40
"33460",NA,27037,"Dakota County, MN","County or equivalent",2005,381027,4490,3556,5464,1908,1293,565,728,-359
"33460",NA,27053,"Hennepin County, MN","County or equivalent",2005,1121369,-1066,8852,16617,7765,-8968,5435,-14403,-950
"33460",NA,27059,"Isanti County, MN","County or equivalent",2005,37205,968,213,474,261,784,8,776,-29
"33460",NA,27123,"Ramsey County, MN","County or equivalent",2005,497047,-3703,3402,7238,3836,-6721,1912,-8633,-384
"33460",NA,27139,"Scott County, MN","County or equivalent",2005,118482,4837,1640,2105,465,3287,116,3171,-90
"33460",NA,27141,"Sherburne County, MN","County or equivalent",2005,81194,3036,905,1292,387,2118,19,2099,13
"33460",NA,27163,"Washington County, MN","County or equivalent",2005,217377,3539,1793,2884,1091,1951,178,1773,-205
"33460",NA,27171,"Wright County, MN","County or equivalent",2005,109624,3438,1398,1974,576,2137,29,2108,-97
"33460",NA,55093,"Pierce County, WI","County or equivalent",2005,38997,445,228,464,236,254,6,248,-37
"33460",NA,55109,"St. Croix County, WI","County or equivalent",2005,76599,2954,834,1237,403,2182,18,2164,-62
"33540",NA,NA,"Missoula, MT","Metropolitan Statistical Area",2005,102140,1330,479,1172,693,940,63,877,-89
"33540",NA,30063,"Missoula County, MT","County or equivalent",2005,102140,1330,479,1172,693,940,63,877,-89
"33660",NA,NA,"Mobile, AL","Metropolitan Statistical Area",2005,397909,735,1863,5792,3929,-755,370,-1125,-373
"33660",NA,1097,"Mobile County, AL","County or equivalent",2005,397909,735,1863,5792,3929,-755,370,-1125,-373
"33700",NA,NA,"Modesto, CA","Metropolitan Statistical Area",2005,499822,7380,4827,8348,3521,3025,1804,1221,-472
"33700",NA,6099,"Stanislaus County, CA","County or equivalent",2005,499822,7380,4827,8348,3521,3025,1804,1221,-472
"33740",NA,NA,"Monroe, LA","Metropolitan Statistical Area",2005,170899,-220,1009,2647,1638,-1074,49,-1123,-155
"33740",NA,22073,"Ouachita Parish, LA","County or equivalent",2005,148181,-280,905,2299,1394,-1052,37,-1089,-133
"33740",NA,22111,"Union Parish, LA","County or equivalent",2005,22718,60,104,348,244,-22,12,-34,-22
"33780",NA,NA,"Monroe, MI","Metropolitan Statistical Area",2005,152242,1201,479,1702,1223,861,91,770,-139
"33780",NA,26115,"Monroe County, MI","County or equivalent",2005,152242,1201,479,1702,1223,861,91,770,-139
"33860",NA,NA,"Montgomery, AL","Metropolitan Statistical Area",2005,356110,2860,1823,5121,3298,1366,59,1307,-329
"33860",NA,1001,"Autauga County, AL","County or equivalent",2005,47882,941,267,674,407,718,-5,723,-44
"33860",NA,1051,"Elmore County, AL","County or equivalent",2005,73254,1968,366,994,628,1666,-3,1669,-64
"33860",NA,1085,"Lowndes County, AL","County or equivalent",2005,12903,-135,15,176,161,-138,-1,-137,-12
"33860",NA,1101,"Montgomery County, AL","County or equivalent",2005,222071,86,1175,3277,2102,-880,68,-948,-209
"34060",NA,NA,"Morgantown, WV","Metropolitan Statistical Area",2005,115918,1054,203,1171,968,957,198,759,-106
"34060",NA,54061,"Monongalia County, WV","County or equivalent",2005,86129,851,223,870,647,706,198,508,-78
"34060",NA,54077,"Preston County, WV","County or equivalent",2005,29789,203,-20,301,321,251,0,251,-28
"34100",NA,NA,"Morristown, TN","Metropolitan Statistical Area",2005,129798,1754,295,1656,1361,1576,322,1254,-117
"34100",NA,47057,"Grainger County, TN","County or equivalent",2005,22090,391,24,256,232,388,15,373,-21
"34100",NA,47063,"Hamblen County, TN","County or equivalent",2005,59847,756,232,853,621,578,261,317,-54
"34100",NA,47089,"Jefferson County, TN","County or equivalent",2005,47861,607,39,547,508,610,46,564,-42
"34580",NA,NA,"Mount Vernon-Anacortes, WA","Metropolitan Statistical Area",2005,111963,1887,502,1467,965,1477,324,1153,-92
"34580",NA,53057,"Skagit County, WA","County or equivalent",2005,111963,1887,502,1467,965,1477,324,1153,-92
"34620",NA,NA,"Muncie, IN","Metropolitan Statistical Area",2005,116600,-1098,166,1286,1120,-1163,104,-1267,-101
"34620",NA,18035,"Delaware County, IN","County or equivalent",2005,116600,-1098,166,1286,1120,-1163,104,-1267,-101
"34740",NA,NA,"Muskegon-Norton Shores, MI","Metropolitan Statistical Area",2005,173925,865,714,2338,1624,319,89,230,-168
"34740",NA,26121,"Muskegon County, MI","County or equivalent",2005,173925,865,714,2338,1624,319,89,230,-168
"34820",NA,NA,"Myrtle Beach-North Myrtle Beach-Conway, SC","Metropolitan Statistical Area",2005,228254,10364,728,2833,2105,9776,354,9422,-140
"34820",NA,45051,"Horry County, SC","County or equivalent",2005,228254,10364,728,2833,2105,9776,354,9422,-140
"34900",NA,NA,"Napa, CA","Metropolitan Statistical Area",2005,130056,-93,325,1597,1272,-298,684,-982,-120
"34900",NA,6055,"Napa County, CA","County or equivalent",2005,130056,-93,325,1597,1272,-298,684,-982,-120
"34940",NA,NA,"Naples-Marco Island, FL","Metropolitan Statistical Area",2005,305481,10849,1510,4015,2505,9602,1975,7627,-263
"34940",NA,12021,"Collier County, FL","County or equivalent",2005,305481,10849,1510,4015,2505,9602,1975,7627,-263
"34980",NA,NA,"Nashville-Davidson--Murfreesboro--Franklin, TN","Metropolitan Statistical Area",2005,1449403,33479,9806,20817,11011,19674,3069,16605,3999
"34980",NA,47015,"Cannon County, TN","County or equivalent",2005,13145,34,-18,135,153,63,5,58,-11
"34980",NA,47021,"Cheatham County, TN","County or equivalent",2005,38024,451,192,487,295,295,8,287,-36
"34980",NA,47037,"Davidson County, TN","County or equivalent",2005,607413,10150,4294,9167,4873,1173,2239,-1066,4683
"34980",NA,47043,"Dickson County, TN","County or equivalent",2005,45678,491,258,674,416,275,4,271,-42
"34980",NA,47081,"Hickman County, TN","County or equivalent",2005,23376,-9,30,267,237,-17,0,-17,-22
"34980",NA,47111,"Macon County, TN","County or equivalent",2005,21208,98,16,267,251,102,30,72,-20
"34980",NA,47147,"Robertson County, TN","County or equivalent",2005,59847,1098,422,975,553,733,110,623,-57
"34980",NA,47149,"Rutherford County, TN","County or equivalent",2005,219552,9084,2212,3424,1212,7037,279,6758,-165
"34980",NA,47159,"Smith County, TN","County or equivalent",2005,18459,200,-6,222,228,223,8,215,-17
"34980",NA,47165,"Sumner County, TN","County or equivalent",2005,143727,2925,727,1844,1117,2313,140,2173,-115
"34980",NA,47169,"Trousdale County, TN","County or equivalent",2005,7414,126,-3,93,96,134,7,127,-5
"34980",NA,47187,"Williamson County, TN","County or equivalent",2005,151871,6096,1110,1935,825,5103,197,4906,-117
"34980",NA,47189,"Wilson County, TN","County or equivalent",2005,99689,2735,572,1327,755,2240,42,2198,-77
"35300",NA,NA,"New Haven-Milford, CT","Metropolitan Statistical Area",2005,840117,1303,2343,10179,7836,-231,2458,-2689,-809
"35300",NA,9009,"New Haven County, CT","County or equivalent",2005,840117,1303,2343,10179,7836,-231,2458,-2689,-809
"35380",NA,NA,"New Orleans-Metairie-Kenner, LA","Metropolitan Statistical Area",2005,1312400,-1342,6054,18587,12533,-7075,1239,-8314,-321
"35380",NA,22051,"Jefferson Parish, LA","County or equivalent",2005,450848,-1268,2104,6335,4231,-3336,671,-4007,-36
"35380",NA,22071,"Orleans Parish, LA","County or equivalent",2005,455046,-6554,1822,6738,4916,-8387,409,-8796,11
"35380",NA,22075,"Plaquemines Parish, LA","County or equivalent",2005,28565,-50,173,405,232,-198,-4,-194,-25
"35380",NA,22087,"St. Bernard Parish, LA","County or equivalent",2005,64890,-486,32,832,800,-512,15,-527,-6
"35380",NA,22089,"St. Charles Parish, LA","County or equivalent",2005,50116,594,337,689,352,304,37,267,-47
"35380",NA,22095,"St. John the Baptist Parish, LA","County or equivalent",2005,45568,543,321,688,367,260,22,238,-38
"35380",NA,22103,"St. Tammany Parish, LA","County or equivalent",2005,217367,5879,1265,2900,1635,4794,89,4705,-180
"35620",NA,NA,"New York-Northern New Jersey-Long Island, NY-NJ-PA","Metropolitan Statistical Area",2005,18812037,54696,113965,254199,140234,-151704,132549,-284253,92435
"35620",20764,NA,"Edison-New Brunswick, NJ","Metropolitan Division",2005,2294668,13902,9669,29575,19906,3129,10641,-7512,1104
"35620",20764,34023,"Middlesex County, NJ","County or equivalent",2005,780529,4394,4759,10384,5625,326,6677,-6351,-691
"35620",20764,34025,"Monmouth County, NJ","County or equivalent",2005,641823,1893,2171,7370,5199,-2382,1604,-3986,2104
"35620",20764,34029,"Ocean County, NJ","County or equivalent",2005,556696,4792,643,7608,6965,4194,546,3648,-45
"35620",20764,34035,"Somerset County, NJ","County or equivalent",2005,315620,2823,2096,4213,2117,991,1814,-823,-264
"35620",35004,NA,"Nassau-Suffolk, NY","Metropolitan Division",2005,2860241,3968,12581,34499,21918,-22341,7557,-29898,13728
"35620",35004,36059,"Nassau County, NY","County or equivalent",2005,1355794,-1073,4603,15185,10582,-11789,3981,-15770,6113
"35620",35004,36103,"Suffolk County, NY","County or equivalent",2005,1504447,5041,7978,19314,11336,-10552,3576,-14128,7615
"35620",35084,NA,"Newark-Union, NJ-PA","Metropolitan Division",2005,2122182,-3328,11664,28267,16603,-13376,11445,-24821,-1616
"35620",35084,34013,"Essex County, NJ","County or equivalent",2005,780189,-6157,5061,11584,6523,-10695,5158,-15853,-523
"35620",35084,34019,"Hunterdon County, NJ","County or equivalent",2005,128605,544,527,1356,829,123,183,-60,-106
"35620",35084,34027,"Morris County, NJ","County or equivalent",2005,484003,1241,2494,5948,3454,-823,2252,-3075,-430
"35620",35084,34037,"Sussex County, NJ","County or equivalent",2005,150729,411,537,1587,1050,9,135,-126,-135
"35620",35084,34039,"Union County, NJ","County or equivalent",2005,523303,-1314,3022,7406,4384,-3965,3709,-7674,-371
"35620",35084,42103,"Pike County, PA","County or equivalent",2005,55353,1947,23,386,363,1975,8,1967,-51
"35620",35644,NA,"New York-White Plains-Wayne, NY-NJ","Metropolitan Division",2005,11534946,40154,80051,161858,81807,-119116,102906,-222022,79219
"35620",35644,34003,"Bergen County, NJ","County or equivalent",2005,890237,-2192,2404,9707,7303,-3929,5963,-9892,-667
"35620",35644,34017,"Hudson County, NJ","County or equivalent",2005,598496,-2934,4266,8575,4309,-6848,7573,-14421,-352
"35620",35644,34031,"Passaic County, NJ","County or equivalent",2005,490749,-947,3803,7675,3872,-4348,3669,-8017,-402
"35620",35644,36005,"Bronx County, NY","County or equivalent",2005,1364566,4815,12563,22045,9482,-23031,10729,-33760,15283
"35620",35644,36047,"Kings County, NY","County or equivalent",2005,2511408,13549,22274,39645,17371,-38061,24589,-62650,29336
"35620",35644,36061,"New York County, NY","County or equivalent",2005,1606275,15364,9522,20430,10908,-2712,13704,-16416,8554
"35620",35644,36079,"Putnam County, NY","County or equivalent",2005,99270,47,516,1103,587,-379,187,-566,-90
"35620",35644,36081,"Queens County, NY","County or equivalent",2005,2256576,5858,14902,30240,15338,-28917,27868,-56785,19873
"35620",35644,36085,"Richmond County, NY","County or equivalent",2005,475014,3902,2097,5689,3592,-1077,1615,-2692,2882
"35620",35644,36087,"Rockland County, NY","County or equivalent",2005,294636,1843,2736,4648,1912,-3111,1258,-4369,2218
"35620",35644,36119,"Westchester County, NY","County or equivalent",2005,947719,849,4968,12101,7133,-6703,5751,-12454,2584
"35660",NA,NA,"Niles-Benton Harbor, MI","Metropolitan Statistical Area",2005,160034,-1032,465,2096,1631,-1351,286,-1637,-146
"35660",NA,26021,"Berrien County, MI","County or equivalent",2005,160034,-1032,465,2096,1631,-1351,286,-1637,-146
"35980",NA,NA,"Norwich-New London, CT","Metropolitan Statistical Area",2005,265204,-1468,875,3112,2237,-2110,276,-2386,-233
"35980",NA,9011,"New London County, CT","County or equivalent",2005,265204,-1468,875,3112,2237,-2110,276,-2386,-233
"36100",NA,NA,"Ocala, FL","Metropolitan Statistical Area",2005,301436,11824,-475,3338,3813,12467,290,12177,-168
"36100",NA,12083,"Marion County, FL","County or equivalent",2005,301436,11824,-475,3338,3813,12467,290,12177,-168
"36140",NA,NA,"Ocean City, NJ","Metropolitan Statistical Area",2005,98557,-1358,-429,898,1327,-857,42,-899,-72
"36140",NA,34009,"Cape May County, NJ","County or equivalent",2005,98557,-1358,-429,898,1327,-857,42,-899,-72
"36220",NA,NA,"Odessa, TX","Metropolitan Statistical Area",2005,124350,990,1199,2292,1093,-95,180,-275,-114
"36220",NA,48135,"Ector County, TX","County or equivalent",2005,124350,990,1199,2292,1093,-95,180,-275,-114
"36260",NA,NA,"Ogden-Clearfield, UT","Metropolitan Statistical Area",2005,491436,10380,6945,9669,2724,2379,712,1667,1056
"36260",NA,49011,"Davis County, UT","County or equivalent",2005,269739,7057,4306,5545,1239,2347,185,2162,404
"36260",NA,49029,"Morgan County, UT","County or equivalent",2005,7762,205,88,128,40,121,2,119,-4
"36260",NA,49057,"Weber County, UT","County or equivalent",2005,213935,3118,2551,3996,1445,-89,525,-614,656
"36420",NA,NA,"Oklahoma City, OK","Metropolitan Statistical Area",2005,1154487,14198,7831,17744,9913,7392,2440,4952,-1025
"36420",NA,40017,"Canadian County, OK","County or equivalent",2005,97069,2636,635,1354,719,2093,70,2023,-92
"36420",NA,40027,"Cleveland County, OK","County or equivalent",2005,225552,3408,1295,2662,1367,2311,358,1953,-198
"36420",NA,40051,"Grady County, OK","County or equivalent",2005,48967,1017,151,649,498,909,4,905,-43
"36420",NA,40081,"Lincoln County, OK","County or equivalent",2005,32006,-70,67,420,353,-110,6,-116,-27
"36420",NA,40083,"Logan County, OK","County or equivalent",2005,35406,434,166,485,319,303,9,294,-35
"36420",NA,40087,"McClain County, OK","County or equivalent",2005,29892,878,130,409,279,775,23,752,-27
"36420",NA,40109,"Oklahoma County, OK","County or equivalent",2005,685595,5895,5387,11765,6378,1111,1970,-859,-603
"36500",NA,NA,"Olympia, WA","Metropolitan Statistical Area",2005,227476,4059,870,2584,1714,3347,253,3094,-158
"36500",NA,53067,"Thurston County, WA","County or equivalent",2005,227476,4059,870,2584,1714,3347,253,3094,-158
"36540",NA,NA,"Omaha-Council Bluffs, NE-IA","Metropolitan Statistical Area",2005,810155,10000,7226,13020,5794,3543,1379,2164,-769
"36540",NA,19085,"Harrison County, IA","County or equivalent",2005,15530,-19,-30,165,195,26,3,23,-15
"36540",NA,19129,"Mills County, IA","County or equivalent",2005,14853,152,64,199,135,102,1,101,-14
"36540",NA,19155,"Pottawattamie County, IA","County or equivalent",2005,88981,197,354,1178,824,-80,42,-122,-77
"36540",NA,31025,"Cass County, NE","County or equivalent",2005,25373,125,134,333,199,13,4,9,-22
"36540",NA,31055,"Douglas County, NE","County or equivalent",2005,486497,5593,4771,8291,3520,1297,1280,17,-475
"36540",NA,31153,"Sarpy County, NE","County or equivalent",2005,139094,3572,1797,2399,602,1905,26,1879,-130
"36540",NA,31155,"Saunders County, NE","County or equivalent",2005,20201,156,73,238,165,100,8,92,-17
"36540",NA,31177,"Washington County, NE","County or equivalent",2005,19626,224,63,217,154,180,15,165,-19
"36740",NA,NA,"Orlando-Kissimmee, FL","Metropolitan Statistical Area",2005,1935502,71943,13119,27138,14019,60082,8143,51939,-1258
"36740",NA,12069,"Lake County, FL","County or equivalent",2005,275098,14652,-168,3035,3203,14848,306,14542,-28
"36740",NA,12095,"Orange County, FL","County or equivalent",2005,1027259,35247,9373,15940,6567,26816,5357,21459,-942
"36740",NA,12097,"Osceola County, FL","County or equivalent",2005,230777,11432,1954,3428,1474,9413,1384,8029,65
"36740",NA,12117,"Seminole County, FL","County or equivalent",2005,402368,10612,1960,4735,2775,9005,1096,7909,-353
"36780",NA,NA,"Oshkosh-Neenah, WI","Metropolitan Statistical Area",2005,159448,913,556,1850,1294,505,155,350,-148
"36780",NA,55139,"Winnebago County, WI","County or equivalent",2005,159448,913,556,1850,1294,505,155,350,-148
"36980",NA,NA,"Owensboro, KY","Metropolitan Statistical Area",2005,110753,324,458,1565,1107,-31,40,-71,-103
"36980",NA,21059,"Daviess County, KY","County or equivalent",2005,92427,235,417,1331,914,-97,29,-126,-85
"36980",NA,21091,"Hancock County, KY","County or equivalent",2005,8538,125,51,127,76,83,2,81,-9
"36980",NA,21149,"McLean County, KY","County or equivalent",2005,9788,-36,-10,107,117,-17,9,-26,-9
"37100",NA,NA,"Oxnard-Thousand Oaks-Ventura, CA","Metropolitan Statistical Area",2005,788565,-1105,7429,12027,4598,-7862,3328,-11190,-672
"37100",NA,6111,"Ventura County, CA","County or equivalent",2005,788565,-1105,7429,12027,4598,-7862,3328,-11190,-672
"37340",NA,NA,"Palm Bay-Melbourne-Titusville, FL","Metropolitan Statistical Area",2005,526080,10176,-353,5330,5683,11014,514,10500,-485
"37340",NA,12009,"Brevard County, FL","County or equivalent",2005,526080,10176,-353,5330,5683,11014,514,10500,-485
"37380",NA,NA,"Palm Coast, FL","Metropolitan Statistical Area",2005,75338,7166,-88,669,757,7287,59,7228,-33
"37380",NA,12035,"Flagler County, FL","County or equivalent",2005,75338,7166,-88,669,757,7287,59,7228,-33
"37460",NA,NA,"Panama City-Lynn Haven, FL","Metropolitan Statistical Area",2005,161458,3720,904,2376,1472,2960,48,2912,-144
"37460",NA,12005,"Bay County, FL","County or equivalent",2005,161458,3720,904,2376,1472,2960,48,2912,-144
"37620",NA,NA,"Parkersburg-Marietta-Vienna, WV-OH","Metropolitan Statistical Area",2005,161635,-709,22,1782,1760,-585,19,-604,-146
"37620",NA,39167,"Washington County, OH","County or equivalent",2005,61971,-496,-33,678,711,-411,2,-413,-52
"37620",NA,54073,"Pleasants County, WV","County or equivalent",2005,7278,-81,-25,58,83,-50,2,-52,-6
"37620",NA,54105,"Wirt County, WV","County or equivalent",2005,5777,9,1,62,61,13,1,12,-5
"37620",NA,54107,"Wood County, WV","County or equivalent",2005,86609,-141,79,984,905,-137,14,-151,-83
"37700",NA,NA,"Pascagoula, MS","Metropolitan Statistical Area",2005,155081,652,730,2169,1439,60,97,-37,-138
"37700",NA,28039,"George County, MS","County or equivalent",2005,20838,403,112,331,219,307,12,295,-16
"37700",NA,28059,"Jackson County, MS","County or equivalent",2005,134243,249,618,1838,1220,-247,85,-332,-122
"37860",NA,NA,"Pensacola-Ferry Pass-Brent, FL","Metropolitan Statistical Area",2005,444595,4763,1730,5696,3966,3435,132,3303,-402
"37860",NA,12033,"Escambia County, FL","County or equivalent",2005,302292,682,1099,4003,2904,-131,104,-235,-286
"37860",NA,12113,"Santa Rosa County, FL","County or equivalent",2005,142303,4081,631,1693,1062,3566,28,3538,-116
"37900",NA,NA,"Peoria, IL","Metropolitan Statistical Area",2005,367354,1324,1044,4867,3823,590,263,327,-310
"37900",NA,17123,"Marshall County, IL","County or equivalent",2005,12938,-61,-48,137,185,-1,2,-3,-12
"37900",NA,17143,"Peoria County, IL","County or equivalent",2005,182040,66,749,2595,1846,-511,217,-728,-172
"37900",NA,17175,"Stark County, IL","County or equivalent",2005,6097,-46,-11,68,79,-30,1,-31,-5
"37900",NA,17179,"Tazewell County, IL","County or equivalent",2005,129250,845,272,1616,1344,694,37,657,-121
"37900",NA,17203,"Woodford County, IL","County or equivalent",2005,37029,520,82,451,369,438,6,432,0
"37980",NA,NA,"Philadelphia-Camden-Wilmington, PA-NJ-DE-MD","Metropolitan Statistical Area",2005,5786636,14939,21811,75469,53658,-2690,11305,-13995,-4182
"37980",15804,NA,"Camden, NJ","Metropolitan Division",2005,1237740,6383,4557,15323,10766,2014,1512,502,-188
"37980",15804,34005,"Burlington County, NJ","County or equivalent",2005,446534,491,1565,5285,3720,-657,462,-1119,-417
"37980",15804,34007,"Camden County, NJ","County or equivalent",2005,514702,2254,2196,6898,4702,-120,919,-1039,178
"37980",15804,34015,"Gloucester County, NJ","County or equivalent",2005,276504,3638,796,3140,2344,2791,131,2660,51
"37980",37964,NA,"Philadelphia, PA","Metropolitan Division",2005,3866993,2332,13887,51042,37155,-8205,8401,-16606,-3350
"37980",37964,42017,"Bucks County, PA","County or equivalent",2005,615853,2287,1638,6839,5201,1218,773,445,-569
"37980",37964,42029,"Chester County, PA","County or equivalent",2005,470473,7376,2672,6109,3437,5119,787,4332,-415
"37980",37964,42045,"Delaware County, PA","County or equivalent",2005,551479,242,1307,6806,5499,-570,1003,-1573,-495
"37980",37964,42091,"Montgomery County, PA","County or equivalent",2005,772038,1368,2270,9497,7227,-150,1255,-1405,-752
"37980",37964,42101,"Philadelphia County, PA","County or equivalent",2005,1457150,-8941,6000,21791,15791,-13822,4583,-18405,-1119
"37980",48864,NA,"Wilmington, DE-MD-NJ","Metropolitan Division",2005,681903,6224,3367,9104,5737,3501,1392,2109,-644
"37980",48864,10003,"New Castle County, DE","County or equivalent",2005,519824,3721,2863,7131,4268,1349,1293,56,-491
"37980",48864,24015,"Cecil County, MD","County or equivalent",2005,96626,1953,499,1237,738,1545,43,1502,-91
"37980",48864,34033,"Salem County, NJ","County or equivalent",2005,65453,550,5,736,731,607,56,551,-62
"38060",NA,NA,"Phoenix-Mesa-Scottsdale, AZ","Metropolitan Statistical Area",2005,3873404,157432,38951,64995,26044,119183,20484,98699,-702
"38060",NA,4013,"Maricopa County, AZ","County or equivalent",2005,3636250,140797,37374,61672,24298,106425,20028,86397,-3002
"38060",NA,4021,"Pinal County, AZ","County or equivalent",2005,237154,16635,1577,3323,1746,12758,456,12302,2300
"38220",NA,NA,"Pine Bluff, AR","Metropolitan Statistical Area",2005,103636,-870,290,1415,1125,-1082,51,-1133,-78
"38220",NA,5025,"Cleveland County, AR","County or equivalent",2005,8733,86,19,111,92,76,1,75,-9
"38220",NA,5069,"Jefferson County, AR","County or equivalent",2005,80803,-912,271,1165,894,-1126,50,-1176,-57
"38220",NA,5079,"Lincoln County, AR","County or equivalent",2005,14100,-44,0,139,139,-32,0,-32,-12
"38300",NA,NA,"Pittsburgh, PA","Metropolitan Statistical Area",2005,2372356,-15526,-4163,24197,28360,-9273,1875,-11148,-2090
"38300",NA,42003,"Allegheny County, PA","County or equivalent",2005,1232587,-13417,-1916,12998,14914,-10470,1683,-12153,-1031
"38300",NA,42005,"Armstrong County, PA","County or equivalent",2005,69839,-962,-186,680,866,-712,-1,-711,-64
"38300",NA,42007,"Beaver County, PA","County or equivalent",2005,175355,-1508,-326,1743,2069,-1033,35,-1068,-149
"38300",NA,42019,"Butler County, PA","County or equivalent",2005,179990,647,148,1993,1845,654,62,592,-155
"38300",NA,42051,"Fayette County, PA","County or equivalent",2005,145305,-565,-259,1445,1704,-176,13,-189,-130
"38300",NA,42125,"Washington County, PA","County or equivalent",2005,204905,1158,-506,2006,2512,1862,38,1824,-198
"38300",NA,42129,"Westmoreland County, PA","County or equivalent",2005,364375,-879,-1118,3332,4450,602,45,557,-363
"38340",NA,NA,"Pittsfield, MA","Metropolitan Statistical Area",2005,131193,-792,-321,1237,1558,-343,109,-452,-128
"38340",NA,25003,"Berkshire County, MA","County or equivalent",2005,131193,-792,-321,1237,1558,-343,109,-452,-128
"38540",NA,NA,"Pocatello, ID","Metropolitan Statistical Area",2005,86144,389,1039,1662,623,-649,82,-731,-1
"38540",NA,16005,"Bannock County, ID","County or equivalent",2005,78591,411,977,1535,558,-564,55,-619,-2
"38540",NA,16077,"Power County, ID","County or equivalent",2005,7553,-22,62,127,65,-85,27,-112,1
"38860",NA,NA,"Portland-South Portland-Biddeford, ME","Metropolitan Statistical Area",2005,511089,1886,1035,5488,4453,1327,357,970,-476
"38860",NA,23005,"Cumberland County, ME","County or equivalent",2005,273907,737,609,2960,2351,381,292,89,-253
"38860",NA,23023,"Sagadahoc County, ME","County or equivalent",2005,36333,-264,24,395,371,-256,3,-259,-32
"38860",NA,23031,"York County, ME","County or equivalent",2005,200849,1413,402,2133,1731,1202,62,1140,-191
"38900",NA,NA,"Portland-Vancouver-Beaverton, OR-WA","Metropolitan Statistical Area",2005,2087066,32153,13221,28349,15128,20647,8312,12335,-1715
"38900",NA,41005,"Clackamas County, OR","County or equivalent",2005,365612,4781,1188,3960,2772,3881,784,3097,-288
"38900",NA,41009,"Columbia County, OR","County or equivalent",2005,47008,767,110,506,396,693,10,683,-36
"38900",NA,41051,"Multnomah County, OR","County or equivalent",2005,675175,2515,3856,9465,5609,-717,3420,-4137,-624
"38900",NA,41067,"Washington County, OR","County or equivalent",2005,498151,12115,4775,7615,2840,7749,2604,5145,-409
"38900",NA,41071,"Yamhill County, OR","County or equivalent",2005,91176,1485,369,1154,785,1184,268,916,-68
"38900",NA,53011,"Clark County, WA","County or equivalent",2005,399660,10431,2921,5562,2641,7790,1223,6567,-280
"38900",NA,53059,"Skamania County, WA","County or equivalent",2005,10284,59,2,87,85,67,3,64,-10
"38940",NA,NA,"Port St. Lucie, FL","Metropolitan Statistical Area",2005,375661,13682,34,4232,4198,14000,765,13235,-352
"38940",NA,12085,"Martin County, FL","County or equivalent",2005,138230,1403,-434,1296,1730,1954,273,1681,-117
"38940",NA,12111,"St. Lucie County, FL","County or equivalent",2005,237431,12279,468,2936,2468,12046,492,11554,-235
"39100",NA,NA,"Poughkeepsie-Newburgh-Middletown, NY","Metropolitan Statistical Area",2005,662140,3624,3740,8355,4615,505,1171,-666,-621
"39100",NA,36027,"Dutchess County, NY","County or equivalent",2005,291835,1023,962,3152,2190,334,568,-234,-273
"39100",NA,36071,"Orange County, NY","County or equivalent",2005,370305,2601,2778,5203,2425,171,603,-432,-348
"39140",NA,NA,"Prescott, AZ","Metropolitan Statistical Area",2005,197367,7956,-196,2026,2222,8279,277,8002,-127
"39140",NA,4025,"Yavapai County, AZ","County or equivalent",2005,197367,7956,-196,2026,2222,8279,277,8002,-127
"39300",NA,NA,"Providence-New Bedford-Fall River, RI-MA","Metropolitan Statistical Area",2005,1609938,-7361,4115,18991,14876,-10047,3483,-13530,-1429
"39300",NA,25005,"Bristol County, MA","County or equivalent",2005,545499,-705,1731,6618,4887,-1935,658,-2593,-501
"39300",NA,44001,"Bristol County, RI","County or equivalent",2005,50553,-314,-67,459,526,-200,23,-223,-47
"39300",NA,44003,"Kent County, RI","County or equivalent",2005,170438,-618,-1,1762,1763,-454,128,-582,-163
"39300",NA,44005,"Newport County, RI","County or equivalent",2005,82765,-1720,65,821,756,-1715,53,-1768,-70
"39300",NA,44007,"Providence County, RI","County or equivalent",2005,633103,-3502,2186,8144,5958,-5156,2534,-7690,-532
"39300",NA,44009,"Washington County, RI","County or equivalent",2005,127580,-502,201,1187,986,-587,87,-674,-116
"39340",NA,NA,"Provo-Orem, UT","Metropolitan Statistical Area",2005,463733,20837,9449,11211,1762,3550,1178,2372,7838
"39340",NA,49023,"Juab County, UT","County or equivalent",2005,8894,112,89,165,76,30,1,29,-7
"39340",NA,49049,"Utah County, UT","County or equivalent",2005,454839,20725,9360,11046,1686,3520,1177,2343,7845
"39380",NA,NA,"Pueblo, CO","Metropolitan Statistical Area",2005,149703,1106,444,1997,1553,801,142,659,-139
"39380",NA,8101,"Pueblo County, CO","County or equivalent",2005,149703,1106,444,1997,1553,801,142,659,-139
"39460",NA,NA,"Punta Gorda, FL","Metropolitan Statistical Area",2005,153142,-2915,-1190,1105,2295,-1778,147,-1925,53
"39460",NA,12015,"Charlotte County, FL","County or equivalent",2005,153142,-2915,-1190,1105,2295,-1778,147,-1925,53
"39540",NA,NA,"Racine, WI","Metropolitan Statistical Area",2005,196798,2097,1046,2594,1548,594,226,368,457
"39540",NA,55101,"Racine County, WI","County or equivalent",2005,196798,2097,1046,2594,1548,594,226,368,457
"39580",NA,NA,"Raleigh-Cary, NC","Metropolitan Statistical Area",2005,953093,36468,9723,14890,5167,26790,4104,22686,-45
"39580",NA,37069,"Franklin County, NC","County or equivalent",2005,54233,1138,266,692,426,922,120,802,-50
"39580",NA,37101,"Johnston County, NC","County or equivalent",2005,145271,4558,1263,2352,1089,3423,437,2986,-128
"39580",NA,37183,"Wake County, NC","County or equivalent",2005,753589,30772,8194,11846,3652,22445,3547,18898,133
"39660",NA,NA,"Rapid City, SD","Metropolitan Statistical Area",2005,118031,488,989,1909,920,-398,23,-421,-103
"39660",NA,46093,"Meade County, SD","County or equivalent",2005,24490,-125,115,357,242,-221,-8,-213,-19
"39660",NA,46103,"Pennington County, SD","County or equivalent",2005,93541,613,874,1552,678,-177,31,-208,-84
"39740",NA,NA,"Reading, PA","Metropolitan Statistical Area",2005,393305,4470,1393,4999,3606,3462,531,2931,-385
"39740",NA,42011,"Berks County, PA","County or equivalent",2005,393305,4470,1393,4999,3606,3462,531,2931,-385
"39820",NA,NA,"Redding, CA","Metropolitan Statistical Area",2005,177541,1075,168,2092,1924,1082,101,981,-175
"39820",NA,6089,"Shasta County, CA","County or equivalent",2005,177541,1075,168,2092,1924,1082,101,981,-175
"39900",NA,NA,"Reno-Sparks, NV","Metropolitan Statistical Area",2005,393746,9504,2544,5535,2991,7287,1488,5799,-327
"39900",NA,32029,"Storey County, NV","County or equivalent",2005,4016,346,2,24,22,345,3,342,-1
"39900",NA,32031,"Washoe County, NV","County or equivalent",2005,389730,9158,2542,5511,2969,6942,1485,5457,-326
"40060",NA,NA,"Richmond, VA","Metropolitan Statistical Area",2005,1173091,18978,5675,15569,9894,14270,1581,12689,-967
"40060",NA,51007,"Amelia County, VA","County or equivalent",2005,12091,256,-5,127,132,271,1,270,-10
"40060",NA,51033,"Caroline County, VA","County or equivalent",2005,25242,1491,147,361,214,1366,4,1362,-22
"40060",NA,51036,"Charles City County, VA","County or equivalent",2005,7041,4,-2,75,77,12,2,10,-6
"40060",NA,51041,"Chesterfield County, VA","County or equivalent",2005,285891,6648,1951,3673,1722,4960,398,4562,-263
"40060",NA,51049,"Cumberland County, VA","County or equivalent",2005,9330,212,21,105,84,198,10,188,-7
"40060",NA,51053,"Dinwiddie County, VA","County or equivalent",2005,25171,155,25,272,247,150,4,146,-20
"40060",NA,51075,"Goochland County, VA","County or equivalent",2005,19227,730,45,190,145,702,13,689,-17
"40060",NA,51085,"Hanover County, VA","County or equivalent",2005,96458,1044,414,1099,685,712,36,676,-82
"40060",NA,51087,"Henrico County, VA","County or equivalent",2005,281169,5173,1660,4019,2359,3742,756,2986,-229
"40060",NA,51097,"King and Queen County, VA","County or equivalent",2005,6732,39,-2,77,79,48,-1,49,-7
"40060",NA,51101,"King William County, VA","County or equivalent",2005,14502,350,61,183,122,300,4,296,-11
"40060",NA,51109,"Louisa County, VA","County or equivalent",2005,29848,1264,135,382,247,1151,5,1146,-22
"40060",NA,51127,"New Kent County, VA","County or equivalent",2005,15946,628,49,169,120,589,0,589,-10
"40060",NA,51145,"Powhatan County, VA","County or equivalent",2005,26275,785,109,268,159,695,1,694,-19
"40060",NA,51149,"Prince George County, VA","County or equivalent",2005,36327,-81,168,353,185,-223,-54,-169,-26
"40060",NA,51183,"Sussex County, VA","County or equivalent",2005,11838,-101,-18,111,129,-72,7,-79,-11
"40060",NA,51570,"Colonial Heights city, VA","County or equivalent",2005,17516,78,-7,222,229,99,12,87,-14
"40060",NA,51670,"Hopewell city, VA","County or equivalent",2005,22514,202,59,346,287,163,12,151,-20
"40060",NA,51730,"Petersburg city, VA","County or equivalent",2005,32387,-291,-2,494,496,-261,11,-272,-28
"40060",NA,51760,"Richmond city, VA","County or equivalent",2005,197586,392,867,3043,2176,-332,360,-692,-143
"40140",NA,NA,"Riverside-San Bernardino-Ontario, CA","Metropolitan Statistical Area",2005,3871591,118510,37605,62988,25383,84410,11908,72502,-3505
"40140",NA,6065,"Riverside County, CA","County or equivalent",2005,1922386,73008,16923,30506,13583,57735,5997,51738,-1650
"40140",NA,6071,"San Bernardino County, CA","County or equivalent",2005,1949205,45502,20682,32482,11800,26675,5911,20764,-1855
"40220",NA,NA,"Roanoke, VA","Metropolitan Statistical Area",2005,291810,1638,191,3357,3166,1695,274,1421,-248
"40220",NA,51023,"Botetourt County, VA","County or equivalent",2005,31505,-22,-21,244,265,20,1,19,-21
"40220",NA,51045,"Craig County, VA","County or equivalent",2005,5073,-21,-5,48,53,-12,1,-13,-4
"40220",NA,51067,"Franklin County, VA","County or equivalent",2005,49755,535,14,529,515,566,8,558,-45
"40220",NA,51161,"Roanoke County, VA","County or equivalent",2005,88365,859,405,1242,837,543,91,452,-89
"40220",NA,51770,"Roanoke city, VA","County or equivalent",2005,92341,23,-168,1065,1233,257,155,102,-66
"40220",NA,51775,"Salem city, VA","County or equivalent",2005,24771,264,-34,229,263,321,18,303,-23
"40340",NA,NA,"Rochester, MN","Metropolitan Statistical Area",2005,175929,1902,1617,2728,1111,452,558,-106,-167
"40340",NA,27039,"Dodge County, MN","County or equivalent",2005,19268,200,172,286,114,45,15,30,-17
"40340",NA,27109,"Olmsted County, MN","County or equivalent",2005,134902,1748,1352,2161,809,526,520,6,-130
"40340",NA,27157,"Wabasha County, MN","County or equivalent",2005,21759,-46,93,281,188,-119,23,-142,-20
"40380",NA,NA,"Rochester, NY","Metropolitan Statistical Area",2005,1034772,-4201,2666,11701,9035,-5947,1603,-7550,-920
"40380",NA,36051,"Livingston County, NY","County or equivalent",2005,63518,-438,145,611,466,-527,7,-534,-56
"40380",NA,36055,"Monroe County, NY","County or equivalent",2005,732992,-3608,2046,8477,6431,-5003,1490,-6493,-651
"40380",NA,36069,"Ontario County, NY","County or equivalent",2005,103299,660,138,1084,946,615,63,552,-93
"40380",NA,36073,"Orleans County, NY","County or equivalent",2005,42747,-390,60,453,393,-412,13,-425,-38
"40380",NA,36117,"Wayne County, NY","County or equivalent",2005,92216,-425,277,1076,799,-620,30,-650,-82
"40420",NA,NA,"Rockford, IL","Metropolitan Statistical Area",2005,339194,4421,1717,4655,2938,2303,815,1488,401
"40420",NA,17007,"Boone County, IL","County or equivalent",2005,49556,1803,339,703,364,1504,123,1381,-40
"40420",NA,17201,"Winnebago County, IL","County or equivalent",2005,289638,2618,1378,3952,2574,799,692,107,441
"40580",NA,NA,"Rocky Mount, NC","Metropolitan Statistical Area",2005,143804,131,431,1999,1568,-240,170,-410,-60
"40580",NA,37065,"Edgecombe County, NC","County or equivalent",2005,53394,-392,139,742,603,-538,72,-610,7
"40580",NA,37127,"Nash County, NC","County or equivalent",2005,90410,523,292,1257,965,298,98,200,-67
"40660",NA,NA,"Rome, GA","Metropolitan Statistical Area",2005,94193,328,366,1326,960,52,212,-160,-90
"40660",NA,13115,"Floyd County, GA","County or equivalent",2005,94193,328,366,1326,960,52,212,-160,-90
"40900",NA,NA,"Sacramento--Arden-Arcade--Roseville, CA","Metropolitan Statistical Area",2005,2032386,25517,14754,29219,14465,12492,7735,4757,-1729
"40900",NA,6017,"El Dorado County, CA","County or equivalent",2005,173410,3001,618,1874,1256,2492,259,2233,-109
"40900",NA,6061,"Placer County, CA","County or equivalent",2005,314775,10297,1510,3878,2368,8966,431,8535,-179
"40900",NA,6067,"Sacramento County, CA","County or equivalent",2005,1357916,11239,11410,21083,9673,1115,5781,-4666,-1286
"40900",NA,6113,"Yolo County, CA","County or equivalent",2005,186285,980,1216,2384,1168,-81,1264,-1345,-155
"40980",NA,NA,"Saginaw-Saginaw Township North, MI","Metropolitan Statistical Area",2005,206457,-1327,496,2629,2133,-1635,126,-1761,-188
"40980",NA,26145,"Saginaw County, MI","County or equivalent",2005,206457,-1327,496,2629,2133,-1635,126,-1761,-188
"41060",NA,NA,"St. Cloud, MN","Metropolitan Statistical Area",2005,181334,1991,1375,2464,1089,625,144,481,-9
"41060",NA,27009,"Benton County, MN","County or equivalent",2005,38641,485,289,601,312,194,23,171,2
"41060",NA,27145,"Stearns County, MN","County or equivalent",2005,142693,1506,1086,1863,777,431,121,310,-11
"41100",NA,NA,"St. George, UT","Metropolitan Statistical Area",2005,119076,8823,1496,2287,791,7363,141,7222,-36
"41100",NA,49053,"Washington County, UT","County or equivalent",2005,119076,8823,1496,2287,791,7363,141,7222,-36
"41140",NA,NA,"St. Joseph, MO-KS","Metropolitan Statistical Area",2005,123572,112,182,1506,1324,-330,31,-361,260
"41140",NA,20043,"Doniphan County, KS","County or equivalent",2005,7717,-174,-16,69,85,-152,-1,-151,-6
"41140",NA,29003,"Andrew County, MO","County or equivalent",2005,16505,-74,15,192,177,-74,0,-74,-15
"41140",NA,29021,"Buchanan County, MO","County or equivalent",2005,87097,463,198,1129,931,-26,28,-54,291
"41140",NA,29063,"DeKalb County, MO","County or equivalent",2005,12253,-103,-15,116,131,-78,4,-82,-10
"41180",NA,NA,"St. Louis, MO-IL","Metropolitan Statistical Area",2005,2773156,14093,11397,36328,24931,-4515,3365,-7880,7211
"41180",NA,17005,"Bond County, IL","County or equivalent",2005,18134,-118,19,186,167,-122,3,-125,-15
"41180",NA,17013,"Calhoun County, IL","County or equivalent",2005,5119,13,-18,55,73,35,1,34,-4
"41180",NA,17027,"Clinton County, IL","County or equivalent",2005,36012,39,137,435,298,-65,12,-77,-33
"41180",NA,17083,"Jersey County, IL","County or equivalent",2005,22185,55,-10,236,246,84,2,82,-19
"41180",NA,17117,"Macoupin County, IL","County or equivalent",2005,48437,-211,-23,575,598,-142,5,-147,-46
"41180",NA,17119,"Madison County, IL","County or equivalent",2005,264825,866,793,3436,2643,113,83,30,-40
"41180",NA,17133,"Monroe County, IL","County or equivalent",2005,31291,639,142,382,240,446,5,441,51
"41180",NA,17163,"St. Clair County, IL","County or equivalent",2005,258776,438,1154,3696,2542,-870,143,-1013,154
"41180",NA,29071,"Franklin County, MO","County or equivalent",2005,98159,889,441,1315,874,533,6,527,-85
"41180",NA,29099,"Jefferson County, MO","County or equivalent",2005,210633,2445,1346,2899,1553,1292,64,1228,-193
"41180",NA,29113,"Lincoln County, MO","County or equivalent",2005,47418,2044,366,701,335,1713,8,1705,-35
"41180",NA,29183,"St. Charles County, MO","County or equivalent",2005,327375,8818,2700,4544,1844,6377,154,6223,-259
"41180",NA,29189,"St. Louis County, MO","County or equivalent",2005,999817,-4649,2623,12064,9441,-6383,1484,-7867,-889
"41180",NA,29219,"Warren County, MO","County or equivalent",2005,28585,1007,181,406,225,851,8,843,-25
"41180",NA,29221,"Washington County, MO","County or equivalent",2005,23818,-49,67,334,267,-99,5,-104,-17
"41180",NA,29510,"St. Louis city, MO","County or equivalent",2005,352572,1867,1479,5064,3585,-8278,1382,-9660,8666
"41420",NA,NA,"Salem, OR","Metropolitan Statistical Area",2005,371779,5099,2519,5485,2966,2890,1571,1319,-310
"41420",NA,41047,"Marion County, OR","County or equivalent",2005,301699,2776,2293,4709,2416,756,1412,-656,-273
"41420",NA,41053,"Polk County, OR","County or equivalent",2005,70080,2323,226,776,550,2134,159,1975,-37
"41500",NA,NA,"Salinas, CA","Metropolitan Statistical Area",2005,406887,-3336,5199,7499,2300,-8262,3342,-11604,-273
"41500",NA,6053,"Monterey County, CA","County or equivalent",2005,406887,-3336,5199,7499,2300,-8262,3342,-11604,-273
"41540",NA,NA,"Salisbury, MD","Metropolitan Statistical Area",2005,115860,1706,401,1482,1081,1394,147,1247,-89
"41540",NA,24039,"Somerset County, MD","County or equivalent",2005,25530,-83,6,259,253,-67,24,-91,-22
"41540",NA,24045,"Wicomico County, MD","County or equivalent",2005,90330,1789,395,1223,828,1461,123,1338,-67
"41620",NA,NA,"Salt Lake City, UT","Metropolitan Statistical Area",2005,1045905,14599,14290,19885,5595,2651,4797,-2146,-2342
"41620",NA,49035,"Salt Lake County, UT","County or equivalent",2005,961098,12189,13066,18305,5239,1391,4607,-3216,-2268
"41620",NA,49043,"Summit County, UT","County or equivalent",2005,34659,976,448,553,105,560,126,434,-32
"41620",NA,49045,"Tooele County, UT","County or equivalent",2005,50148,1434,776,1027,251,700,64,636,-42
"41660",NA,NA,"San Angelo, TX","Metropolitan Statistical Area",2005,106645,153,605,1609,1004,-349,67,-416,-103
"41660",NA,48235,"Irion County, TX","County or equivalent",2005,1699,-2,-8,6,14,7,1,6,-1
"41660",NA,48451,"Tom Green County, TX","County or equivalent",2005,104946,155,613,1603,990,-356,66,-422,-102
"41700",NA,NA,"San Antonio, TX","Metropolitan Statistical Area",2005,1879129,34525,16907,30304,13397,19366,3761,15605,-1748
"41700",NA,48013,"Atascosa County, TX","County or equivalent",2005,42444,375,351,650,299,62,32,30,-38
"41700",NA,48019,"Bandera County, TX","County or equivalent",2005,19491,191,4,175,171,202,14,188,-15
"41700",NA,48029,"Bexar County, TX","County or equivalent",2005,1512654,24390,14985,25520,10535,10870,3423,7447,-1465
"41700",NA,48091,"Comal County, TX","County or equivalent",2005,94626,3676,372,1164,792,3377,88,3289,-73
"41700",NA,48187,"Guadalupe County, TX","County or equivalent",2005,102259,3276,691,1391,700,2669,153,2516,-84
"41700",NA,48259,"Kendall County, TX","County or equivalent",2005,28391,1324,93,361,268,1237,32,1205,-6
"41700",NA,48325,"Medina County, TX","County or equivalent",2005,42349,488,242,581,339,285,15,270,-39
"41700",NA,48493,"Wilson County, TX","County or equivalent",2005,36915,805,169,462,293,664,4,660,-28
"41740",NA,NA,"San Diego-Carlsbad-San Marcos, CA","Metropolitan Statistical Area",2005,2931689,1636,26970,46090,19120,-22809,13251,-36060,-2525
"41740",NA,6073,"San Diego County, CA","County or equivalent",2005,2931689,1636,26970,46090,19120,-22809,13251,-36060,-2525
"41780",NA,NA,"Sandusky, OH","Metropolitan Statistical Area",2005,77786,-579,-4,869,873,-506,22,-528,-69
"41780",NA,39043,"Erie County, OH","County or equivalent",2005,77786,-579,-4,869,873,-506,22,-528,-69
"41860",NA,NA,"San Francisco-Oakland-Fremont, CA","Metropolitan Statistical Area",2005,4157603,7983,26904,55305,28401,-20948,30288,-51236,2027
"41860",36084,NA,"Oakland-Fremont-Hayward, CA","Metropolitan Division",2005,2441794,2588,17830,34012,16182,-13082,16396,-29478,-2160
"41860",36084,6001,"Alameda County, CA","County or equivalent",2005,1439743,-4619,11332,20767,9435,-14762,11866,-26628,-1189
"41860",36084,6013,"Contra Costa County, CA","County or equivalent",2005,1002051,7207,6498,13245,6747,1680,4530,-2850,-971
"41860",41884,NA,"San Francisco-San Mateo-Redwood City, CA","Metropolitan Division",2005,1715809,5395,9074,21293,12219,-7866,13892,-21758,4187
"41860",41884,6041,"Marin County, CA","County or equivalent",2005,244520,484,1018,2787,1769,-304,1172,-1476,-230
"41860",41884,6075,"San Francisco County, CA","County or equivalent",2005,776614,4197,2700,8535,5835,-3501,6804,-10305,4998
"41860",41884,6081,"San Mateo County, CA","County or equivalent",2005,694675,714,5356,9971,4615,-4061,5916,-9977,-581
"41940",NA,NA,"San Jose-Sunnyvale-Santa Clara, CA","Metropolitan Statistical Area",2005,1742883,14503,18425,27291,8866,-2426,19728,-22154,-1496
"41940",NA,6069,"San Benito County, CA","County or equivalent",2005,54927,-155,645,900,255,-757,267,-1024,-43
"41940",NA,6085,"Santa Clara County, CA","County or equivalent",2005,1687956,14658,17780,26391,8611,-1669,19461,-21130,-1453
"42020",NA,NA,"San Luis Obispo-Paso Robles, CA","Metropolitan Statistical Area",2005,257779,1529,734,2648,1914,1044,492,552,-249
"42020",NA,6079,"San Luis Obispo County, CA","County or equivalent",2005,257779,1529,734,2648,1914,1044,492,552,-249
"42060",NA,NA,"Santa Barbara-Santa Maria-Goleta, CA","Metropolitan Statistical Area",2005,401576,-552,3358,6315,2957,-3582,2211,-5793,-328
"42060",NA,6083,"Santa Barbara County, CA","County or equivalent",2005,401576,-552,3358,6315,2957,-3582,2211,-5793,-328
"42100",NA,NA,"Santa Cruz-Watsonville, CA","Metropolitan Statistical Area",2005,249603,-1302,1847,3418,1571,-2940,1182,-4122,-209
"42100",NA,6087,"Santa Cruz County, CA","County or equivalent",2005,249603,-1302,1847,3418,1571,-2940,1182,-4122,-209
"42140",NA,NA,"Santa Fe, NM","Metropolitan Statistical Area",2005,139190,1423,769,1614,845,775,592,183,-121
"42140",NA,35049,"Santa Fe County, NM","County or equivalent",2005,139190,1423,769,1614,845,775,592,183,-121
"42220",NA,NA,"Santa Rosa-Petaluma, CA","Metropolitan Statistical Area",2005,462299,-1616,2101,5746,3645,-3311,1938,-5249,-406
"42220",NA,6097,"Sonoma County, CA","County or equivalent",2005,462299,-1616,2101,5746,3645,-3311,1938,-5249,-406
"42340",NA,NA,"Savannah, GA","Metropolitan Statistical Area",2005,314178,3888,2174,4863,2689,2004,341,1663,-290
"42340",NA,13029,"Bryan County, GA","County or equivalent",2005,27802,764,234,436,202,554,2,552,-24
"42340",NA,13051,"Chatham County, GA","County or equivalent",2005,239861,901,1550,3765,2215,-419,329,-748,-230
"42340",NA,13103,"Effingham County, GA","County or equivalent",2005,46515,2223,390,662,272,1869,10,1859,-36
"42540",NA,NA,"Scranton--Wilkes-Barre, PA","Metropolitan Statistical Area",2005,548256,-559,-1590,5712,7302,1579,236,1343,-548
"42540",NA,42069,"Lackawanna County, PA","County or equivalent",2005,209015,-246,-498,2271,2769,461,101,360,-209
"42540",NA,42079,"Luzerne County, PA","County or equivalent",2005,311331,-222,-1120,3128,4248,1211,132,1079,-313
"42540",NA,42131,"Wyoming County, PA","County or equivalent",2005,27910,-91,28,313,285,-93,3,-96,-26
"42660",NA,NA,"Seattle-Tacoma-Bellevue, WA","Metropolitan Statistical Area",2005,3197370,36833,20418,41640,21222,17830,12705,5125,-1415
"42660",42644,NA,"Seattle-Bellevue-Everett, WA","Metropolitan Division",2005,2448168,28873,15687,31496,15809,13909,11465,2444,-723
"42660",42644,53033,"King County, WA","County or equivalent",2005,1799085,19180,11340,22817,11477,7969,9708,-1739,-129
"42660",42644,53061,"Snohomish County, WA","County or equivalent",2005,649083,9693,4347,8679,4332,5940,1757,4183,-594
"42660",45104,NA,"Tacoma, WA","Metropolitan Division",2005,749202,7960,4731,10144,5413,3921,1240,2681,-692
"42660",45104,53053,"Pierce County, WA","County or equivalent",2005,749202,7960,4731,10144,5413,3921,1240,2681,-692
"42680",NA,NA,"Sebastian-Vero Beach, FL","Metropolitan Statistical Area",2005,126578,2619,-578,1281,1859,3318,234,3084,-121
"42680",NA,12061,"Indian River County, FL","County or equivalent",2005,126578,2619,-578,1281,1859,3318,234,3084,-121
"43100",NA,NA,"Sheboygan, WI","Metropolitan Statistical Area",2005,113663,437,401,1442,1041,148,142,6,-112
"43100",NA,55117,"Sheboygan County, WI","County or equivalent",2005,113663,437,401,1442,1041,148,142,6,-112
"43300",NA,NA,"Sherman-Denison, TX","Metropolitan Statistical Area",2005,115577,645,350,1583,1233,400,188,212,-105
"43300",NA,48181,"Grayson County, TX","County or equivalent",2005,115577,645,350,1583,1233,400,188,212,-105
"43340",NA,NA,"Shreveport-Bossier City, LA","Metropolitan Statistical Area",2005,381391,1970,1897,5694,3797,427,83,344,-354
"43340",NA,22015,"Bossier Parish, LA","County or equivalent",2005,105257,1611,774,1628,854,936,-1,937,-99
"43340",NA,22017,"Caddo Parish, LA","County or equivalent",2005,250188,312,1057,3700,2643,-515,79,-594,-230
"43340",NA,22031,"De Soto Parish, LA","County or equivalent",2005,25946,47,66,366,300,6,5,1,-25
"43580",NA,NA,"Sioux City, IA-NE-SD","Metropolitan Statistical Area",2005,140817,-1102,982,2218,1236,-1976,465,-2441,-108
"43580",NA,19193,"Woodbury County, IA","County or equivalent",2005,101388,-1068,661,1567,906,-1643,317,-1960,-86
"43580",NA,31043,"Dakota County, NE","County or equivalent",2005,19989,-251,250,411,161,-491,121,-612,-10
"43580",NA,31051,"Dixon County, NE","County or equivalent",2005,6138,72,-7,65,72,79,7,72,0
"43580",NA,46127,"Union County, SD","County or equivalent",2005,13302,145,78,175,97,79,20,59,-12
"43620",NA,NA,"Sioux Falls, SD","Metropolitan Statistical Area",2005,214671,5991,1871,3365,1494,3103,368,2735,1017
"43620",NA,46083,"Lincoln County, SD","County or equivalent",2005,33703,2034,427,640,213,1541,19,1522,66
"43620",NA,46087,"McCook County, SD","County or equivalent",2005,5823,-7,16,86,70,-18,-1,-17,-5
"43620",NA,46099,"Minnehaha County, SD","County or equivalent",2005,166740,4068,1455,2561,1106,1649,350,1299,964
"43620",NA,46125,"Turner County, SD","County or equivalent",2005,8405,-104,-27,78,105,-69,0,-69,-8
"43780",NA,NA,"South Bend-Mishawaka, IN-MI","Metropolitan Statistical Area",2005,315464,-7,1244,4295,3051,-977,531,-1508,-274
"43780",NA,18141,"St. Joseph County, IN","County or equivalent",2005,264532,217,1247,3793,2546,-781,518,-1299,-249
"43780",NA,26027,"Cass County, MI","County or equivalent",2005,50932,-224,-3,502,505,-196,13,-209,-25
"43900",NA,NA,"Spartanburg, SC","Metropolitan Statistical Area",2005,265282,2732,758,3441,2683,2183,386,1797,-209
"43900",NA,45083,"Spartanburg County, SC","County or equivalent",2005,265282,2732,758,3441,2683,2183,386,1797,-209
"44060",NA,NA,"Spokane, WA","Metropolitan Statistical Area",2005,440431,5206,1764,5490,3726,3804,635,3169,-362
"44060",NA,53063,"Spokane County, WA","County or equivalent",2005,440431,5206,1764,5490,3726,3804,635,3169,-362
"44100",NA,NA,"Springfield, IL","Metropolitan Statistical Area",2005,204976,229,715,2706,1991,-463,93,-556,-23
"44100",NA,17129,"Menard County, IL","County or equivalent",2005,12399,-121,3,136,133,-116,3,-119,-8
"44100",NA,17167,"Sangamon County, IL","County or equivalent",2005,192577,350,712,2570,1858,-347,90,-437,-15
"44140",NA,NA,"Springfield, MA","Metropolitan Statistical Area",2005,685931,117,1299,7528,6229,-551,1501,-2052,-631
"44140",NA,25011,"Franklin County, MA","County or equivalent",2005,71937,-13,24,664,640,31,89,-58,-68
"44140",NA,25013,"Hampden County, MA","County or equivalent",2005,460217,129,1225,5682,4457,-665,1158,-1823,-431
"44140",NA,25015,"Hampshire County, MA","County or equivalent",2005,153777,1,50,1182,1132,83,254,-171,-132
"44180",NA,NA,"Springfield, MO","Metropolitan Statistical Area",2005,400410,7695,2024,5606,3582,6003,177,5826,-332
"44180",NA,29043,"Christian County, MO","County or equivalent",2005,66409,2887,547,1035,488,2384,5,2379,-44
"44180",NA,29059,"Dallas County, MO","County or equivalent",2005,16204,36,31,213,182,21,2,19,-16
"44180",NA,29077,"Greene County, MO","County or equivalent",2005,254476,3569,1072,3429,2357,2713,145,2568,-216
"44180",NA,29167,"Polk County, MO","County or equivalent",2005,29042,543,76,394,318,492,19,473,-25
"44180",NA,29225,"Webster County, MO","County or equivalent",2005,34279,660,298,535,237,393,6,387,-31
"44220",NA,NA,"Springfield, OH","Metropolitan Statistical Area",2005,141554,-14,72,1747,1675,38,24,14,-124
"44220",NA,39023,"Clark County, OH","County or equivalent",2005,141554,-14,72,1747,1675,38,24,14,-124
"44300",NA,NA,"State College, PA","Metropolitan Statistical Area",2005,141439,436,350,1218,868,215,530,-315,-129
"44300",NA,42027,"Centre County, PA","County or equivalent",2005,141439,436,350,1218,868,215,530,-315,-129
"44700",NA,NA,"Stockton, CA","Metropolitan Statistical Area",2005,655866,13817,6585,11230,4645,7833,2582,5251,-601
"44700",NA,6077,"San Joaquin County, CA","County or equivalent",2005,655866,13817,6585,11230,4645,7833,2582,5251,-601
"44940",NA,NA,"Sumter, SC","Metropolitan Statistical Area",2005,104749,-393,698,1647,949,-999,46,-1045,-92
"44940",NA,45085,"Sumter County, SC","County or equivalent",2005,104749,-393,698,1647,949,-999,46,-1045,-92
"45060",NA,NA,"Syracuse, NY","Metropolitan Statistical Area",2005,646452,-2791,1963,7650,5687,-4204,877,-5081,-550
"45060",NA,36053,"Madison County, NY","County or equivalent",2005,69539,-322,171,750,579,-434,21,-455,-59
"45060",NA,36067,"Onondaga County, NY","County or equivalent",2005,454900,-1653,1457,5543,4086,-2725,835,-3560,-385
"45060",NA,36075,"Oswego County, NY","County or equivalent",2005,122013,-816,335,1357,1022,-1045,21,-1066,-106
"45220",NA,NA,"Tallahassee, FL","Metropolitan Statistical Area",2005,341548,4587,1938,4266,2328,2937,493,2444,-288
"45220",NA,12039,"Gadsden County, FL","County or equivalent",2005,45785,337,239,682,443,135,58,77,-37
"45220",NA,12065,"Jefferson County, FL","County or equivalent",2005,14384,108,34,174,140,85,0,85,-11
"45220",NA,12073,"Leon County, FL","County or equivalent",2005,253673,3027,1562,3093,1531,1690,429,1261,-225
"45220",NA,12129,"Wakulla County, FL","County or equivalent",2005,27706,1115,103,317,214,1027,6,1021,-15
"45300",NA,NA,"Tampa-St. Petersburg-Clearwater, FL","Metropolitan Statistical Area",2005,2637036,59986,3207,31603,28396,59101,7093,52008,-2322
"45300",NA,12053,"Hernando County, FL","County or equivalent",2005,156334,7327,-744,1457,2201,8199,76,8123,-128
"45300",NA,12057,"Hillsborough County, FL","County or equivalent",2005,1131070,31921,7467,16336,8869,25426,4024,21402,-972
"45300",NA,12101,"Pasco County, FL","County or equivalent",2005,425496,20940,-643,4674,5317,21906,548,21358,-323
"45300",NA,12103,"Pinellas County, FL","County or equivalent",2005,924136,-202,-2873,9136,12009,3570,2445,1125,-899
"45460",NA,NA,"Terre Haute, IN","Metropolitan Statistical Area",2005,169112,356,243,2034,1791,265,100,165,-152
"45460",NA,18021,"Clay County, IN","County or equivalent",2005,26833,24,44,345,301,6,9,-3,-26
"45460",NA,18153,"Sullivan County, IN","County or equivalent",2005,21523,-139,0,217,217,-118,-1,-117,-21
"45460",NA,18165,"Vermillion County, IN","County or equivalent",2005,16447,52,14,200,186,54,3,51,-16
"45460",NA,18167,"Vigo County, IN","County or equivalent",2005,104309,419,185,1272,1087,323,89,234,-89
"45500",NA,NA,"Texarkana, TX-Texarkana, AR","Metropolitan Statistical Area",2005,132250,722,330,1709,1379,511,62,449,-119
"45500",NA,5091,"Miller County, AR","County or equivalent",2005,42297,435,188,588,400,287,20,267,-40
"45500",NA,48037,"Bowie County, TX","County or equivalent",2005,89953,287,142,1121,979,224,42,182,-79
"45780",NA,NA,"Toledo, OH","Metropolitan Statistical Area",2005,654360,-2131,2549,8558,6009,-4150,530,-4680,-530
"45780",NA,39051,"Fulton County, OH","County or equivalent",2005,42633,57,158,512,354,-66,9,-75,-35
"45780",NA,39095,"Lucas County, OH","County or equivalent",2005,446458,-2586,1972,6274,4302,-4180,418,-4598,-378
"45780",NA,39123,"Ottawa County, OH","County or equivalent",2005,41294,-8,-60,407,467,54,3,51,-2
"45780",NA,39173,"Wood County, OH","County or equivalent",2005,123975,406,479,1365,886,42,100,-58,-115
"45820",NA,NA,"Topeka, KS","Metropolitan Statistical Area",2005,227025,763,1067,3205,2138,-100,180,-280,-204
"45820",NA,20085,"Jackson County, KS","County or equivalent",2005,13361,285,79,190,111,219,0,219,-13
"45820",NA,20087,"Jefferson County, KS","County or equivalent",2005,18647,28,34,197,163,10,2,8,-16
"45820",NA,20139,"Osage County, KS","County or equivalent",2005,16765,2,-4,189,193,18,2,16,-12
"45820",NA,20177,"Shawnee County, KS","County or equivalent",2005,171454,375,928,2540,1612,-394,177,-571,-159
"45820",NA,20197,"Wabaunsee County, KS","County or equivalent",2005,6798,73,30,89,59,47,-1,48,-4
"45940",NA,NA,"Trenton-Ewing, NJ","Metropolitan Statistical Area",2005,362368,785,1529,4435,2906,-424,1838,-2262,-320
"45940",NA,34021,"Mercer County, NJ","County or equivalent",2005,362368,785,1529,4435,2906,-424,1838,-2262,-320
"46060",NA,NA,"Tucson, AZ","Metropolitan Statistical Area",2005,947533,24206,5202,12999,7797,14828,2660,12168,4176
"46060",NA,4019,"Pima County, AZ","County or equivalent",2005,947533,24206,5202,12999,7797,14828,2660,12168,4176
"46140",NA,NA,"Tulsa, OK","Metropolitan Statistical Area",2005,880999,4323,4815,13118,8303,275,1514,-1239,-767
"46140",NA,40037,"Creek County, OK","County or equivalent",2005,68092,-71,188,898,710,-199,5,-204,-60
"46140",NA,40111,"Okmulgee County, OK","County or equivalent",2005,39332,-217,85,590,505,-266,8,-274,-36
"46140",NA,40113,"Osage County, OK","County or equivalent",2005,44940,177,33,416,383,173,13,160,-29
"46140",NA,40117,"Pawnee County, OK","County or equivalent",2005,16473,-3,19,213,194,-6,0,-6,-16
"46140",NA,40131,"Rogers County, OK","County or equivalent",2005,79614,1090,250,897,647,912,29,883,-72
"46140",NA,40143,"Tulsa County, OK","County or equivalent",2005,569407,2200,3922,9299,5377,-1214,1425,-2639,-508
"46140",NA,40145,"Wagoner County, OK","County or equivalent",2005,63141,1147,318,805,487,875,34,841,-46
"46220",NA,NA,"Tuscaloosa, AL","Metropolitan Statistical Area",2005,198135,2693,791,2559,1768,2079,196,1883,-177
"46220",NA,1063,"Greene County, AL","County or equivalent",2005,9472,-61,-9,97,106,-45,1,-46,-7
"46220",NA,1065,"Hale County, AL","County or equivalent",2005,17904,45,36,234,198,25,1,24,-16
"46220",NA,1125,"Tuscaloosa County, AL","County or equivalent",2005,170759,2709,764,2228,1464,2099,194,1905,-154
"46340",NA,NA,"Tyler, TX","Metropolitan Statistical Area",2005,189929,3795,1250,2892,1642,2714,483,2231,-169
"46340",NA,48423,"Smith County, TX","County or equivalent",2005,189929,3795,1250,2892,1642,2714,483,2231,-169
"46540",NA,NA,"Utica-Rome, NY","Metropolitan Statistical Area",2005,294908,-1074,66,3222,3156,-866,632,-1498,-274
"46540",NA,36043,"Herkimer County, NY","County or equivalent",2005,62906,-315,-23,691,714,-238,14,-252,-54
"46540",NA,36065,"Oneida County, NY","County or equivalent",2005,232002,-759,89,2531,2442,-628,618,-1246,-220
"46660",NA,NA,"Valdosta, GA","Metropolitan Statistical Area",2005,126119,1664,941,1919,978,826,92,734,-103
"46660",NA,13027,"Brooks County, GA","County or equivalent",2005,16106,-32,-5,197,202,-14,9,-23,-13
"46660",NA,13101,"Echols County, GA","County or equivalent",2005,4075,43,69,83,14,-25,42,-67,-1
"46660",NA,13173,"Lanier County, GA","County or equivalent",2005,7405,95,45,107,62,56,4,52,-6
"46660",NA,13185,"Lowndes County, GA","County or equivalent",2005,98533,1558,832,1532,700,809,37,772,-83
"46700",NA,NA,"Vallejo-Fairfield, CA","Metropolitan Statistical Area",2005,407269,-1581,2924,5629,2705,-4150,1326,-5476,-355
"46700",NA,6095,"Solano County, CA","County or equivalent",2005,407269,-1581,2924,5629,2705,-4150,1326,-5476,-355
"47020",NA,NA,"Victoria, TX","Metropolitan Statistical Area",2005,112206,-279,664,1667,1003,-847,177,-1024,-96
"47020",NA,48057,"Calhoun County, TX","County or equivalent",2005,20239,-76,65,275,210,-124,76,-200,-17
"47020",NA,48175,"Goliad County, TX","County or equivalent",2005,6976,-16,-10,67,77,0,3,-3,-6
"47020",NA,48469,"Victoria County, TX","County or equivalent",2005,84991,-187,609,1325,716,-723,98,-821,-73
"47220",NA,NA,"Vineland-Millville-Bridgeton, NJ","Metropolitan Statistical Area",2005,152440,2280,910,2332,1422,1516,414,1102,-146
"47220",NA,34011,"Cumberland County, NJ","County or equivalent",2005,152440,2280,910,2332,1422,1516,414,1102,-146
"47260",NA,NA,"Virginia Beach-Norfolk-Newport News, VA-NC","Metropolitan Statistical Area",2005,1649404,5784,11553,23848,12295,-4707,-48,-4659,-1062
"47260",NA,37053,"Currituck County, NC","County or equivalent",2005,22874,1058,68,254,186,1009,2,1007,-19
"47260",NA,51073,"Gloucester County, VA","County or equivalent",2005,37247,525,88,390,302,468,-4,472,-31
"47260",NA,51093,"Isle of Wight County, VA","County or equivalent",2005,32893,728,58,363,305,699,4,695,-29
"47260",NA,51095,"James City County, VA","County or equivalent",2005,57187,1941,50,498,448,1938,40,1898,-47
"47260",NA,51115,"Mathews County, VA","County or equivalent",2005,8987,-63,-80,59,139,24,0,24,-7
"47260",NA,51181,"Surry County, VA","County or equivalent",2005,6882,-7,-8,48,56,7,0,7,-6
"47260",NA,51199,"York County, VA","County or equivalent",2005,60726,749,203,532,329,603,6,597,-57
"47260",NA,51550,"Chesapeake city, VA","County or equivalent",2005,216479,3310,1492,3002,1510,2019,-5,2024,-201
"47260",NA,51650,"Hampton city, VA","County or equivalent",2005,146859,1754,883,1982,1099,1006,3,1003,-135
"47260",NA,51700,"Newport News city, VA","County or equivalent",2005,182213,-1619,1824,3227,1403,-3294,75,-3369,-149
"47260",NA,51710,"Norfolk city, VA","County or equivalent",2005,237190,-4527,2051,4026,1975,-6743,-178,-6565,165
"47260",NA,51735,"Poquoson city, VA","County or equivalent",2005,11694,68,2,95,93,77,1,76,-11
"47260",NA,51740,"Portsmouth city, VA","County or equivalent",2005,100808,1006,548,1603,1055,556,-59,615,-98
"47260",NA,51800,"Suffolk city, VA","County or equivalent",2005,77883,2168,504,1156,652,1727,2,1725,-63
"47260",NA,51810,"Virginia Beach city, VA","County or equivalent",2005,437591,-1550,3784,6422,2638,-4969,45,-5014,-365
"47260",NA,51830,"Williamsburg city, VA","County or equivalent",2005,11891,243,86,191,105,166,20,146,-9
"47300",NA,NA,"Visalia-Porterville, CA","Metropolitan Statistical Area",2005,405142,9022,5508,8200,2692,3901,1997,1904,-387
"47300",NA,6107,"Tulare County, CA","County or equivalent",2005,405142,9022,5508,8200,2692,3901,1997,1904,-387
"47380",NA,NA,"Waco, TX","Metropolitan Statistical Area",2005,224011,1537,1350,3310,1960,407,505,-98,-220
"47380",NA,48309,"McLennan County, TX","County or equivalent",2005,224011,1537,1350,3310,1960,407,505,-98,-220
"47580",NA,NA,"Warner Robins, GA","Metropolitan Statistical Area",2005,125802,2042,1055,1922,867,1104,62,1042,-117
"47580",NA,13153,"Houston County, GA","County or equivalent",2005,125802,2042,1055,1922,867,1104,62,1042,-117
"47900",NA,NA,"Washington-Arlington-Alexandria, DC-VA-MD-WV","Metropolitan Statistical Area",2005,5221894,67446,48409,78746,30337,13017,29807,-16790,6020
"47900",13644,NA,"Bethesda-Frederick-Gaithersburg, MD","Metropolitan Division",2005,1149464,10138,9597,16633,7036,-1201,8003,-9204,1742
"47900",13644,24021,"Frederick County, MD","County or equivalent",2005,219178,2946,1540,3037,1497,1598,227,1371,-192
"47900",13644,24031,"Montgomery County, MD","County or equivalent",2005,930286,7192,8057,13596,5539,-2799,7776,-10575,1934
"47900",47894,NA,"Washington-Arlington-Alexandria, DC-VA-MD-WV","Metropolitan Division",2005,4072430,57308,38812,62113,23301,14218,21804,-7586,4278
"47900",47894,11001,"District of Columbia, DC","County or equivalent",2005,582049,2528,2445,7913,5468,-3735,3031,-6766,3818
"47900",47894,24009,"Calvert County, MD","County or equivalent",2005,86738,1427,450,1031,581,1049,32,1017,-72
"47900",47894,24017,"Charles County, MD","County or equivalent",2005,137144,2613,1069,1879,810,1667,30,1637,-123
"47900",47894,24033,"Prince George's County, MD","County or equivalent",2005,835588,2782,7198,12407,5209,-3746,3692,-7438,-670
"47900",47894,51013,"Arlington County, VA","County or equivalent",2005,199761,1806,1837,2867,1030,-1735,2555,-4290,1704
"47900",47894,51043,"Clarke County, VA","County or equivalent",2005,13999,356,3,138,135,367,9,358,-14
"47900",47894,51059,"Fairfax County, VA","County or equivalent",2005,1000496,4847,10903,15183,4280,-5224,8513,-13737,-832
"47900",47894,51061,"Fauquier County, VA","County or equivalent",2005,64225,1664,296,775,479,1427,58,1369,-59
"47900",47894,51107,"Loudoun County, VA","County or equivalent",2005,253053,16088,4229,4991,762,12039,720,11319,-180
"47900",47894,51153,"Prince William County, VA","County or equivalent",2005,344572,11883,5236,6488,1252,6936,917,6019,-289
"47900",47894,51177,"Spotsylvania County, VA","County or equivalent",2005,114860,4353,1102,1688,586,3348,45,3303,-97
"47900",47894,51179,"Stafford County, VA","County or equivalent",2005,116536,3372,1071,1606,535,2399,-4,2403,-98
"47900",47894,51187,"Warren County, VA","County or equivalent",2005,34987,907,177,465,288,763,6,757,-33
"47900",47894,51510,"Alexandria city, VA","County or equivalent",2005,137602,967,1669,2427,758,-2028,1593,-3621,1326
"47900",47894,51600,"Fairfax city, VA","County or equivalent",2005,21910,-110,-28,184,212,-69,243,-312,-13
"47900",47894,51610,"Falls Church city, VA","County or equivalent",2005,10790,246,21,111,90,231,64,167,-6
"47900",47894,51630,"Fredericksburg city, VA","County or equivalent",2005,21264,6,192,381,189,-176,38,-214,-10
"47900",47894,51683,"Manassas city, VA","County or equivalent",2005,36787,-168,447,642,195,-596,184,-780,-19
"47900",47894,51685,"Manassas Park city, VA","County or equivalent",2005,11562,263,250,286,36,25,62,-37,-12
"47900",47894,54037,"Jefferson County, WV","County or equivalent",2005,48507,1478,245,651,406,1276,16,1260,-43
"47940",NA,NA,"Waterloo-Cedar Falls, IA","Metropolitan Statistical Area",2005,162207,327,584,2083,1499,-106,338,-444,-151
"47940",NA,19013,"Black Hawk County, IA","County or equivalent",2005,126549,306,539,1689,1150,-117,333,-450,-116
"47940",NA,19017,"Bremer County, IA","County or equivalent",2005,23420,32,49,270,221,6,6,0,-23
"47940",NA,19075,"Grundy County, IA","County or equivalent",2005,12238,-11,-4,124,128,5,-1,6,-12
"48140",NA,NA,"Wausau, WI","Metropolitan Statistical Area",2005,127568,831,524,1482,958,431,88,343,-124
"48140",NA,55073,"Marathon County, WI","County or equivalent",2005,127568,831,524,1482,958,431,88,343,-124
"48260",NA,NA,"Weirton-Steubenville, WV-OH","Metropolitan Statistical Area",2005,125299,-1211,-429,1335,1764,-672,14,-686,-110
"48260",NA,39081,"Jefferson County, OH","County or equivalent",2005,70091,-753,-229,729,958,-459,14,-473,-65
"48260",NA,54009,"Brooke County, WV","County or equivalent",2005,24244,-264,-95,233,328,-148,0,-148,-21
"48260",NA,54029,"Hancock County, WV","County or equivalent",2005,30964,-194,-105,373,478,-65,0,-65,-24
"48300",NA,NA,"Wenatchee, WA","Metropolitan Statistical Area",2005,103235,1326,584,1402,818,816,375,441,-74
"48300",NA,53007,"Chelan County, WA","County or equivalent",2005,68892,871,348,895,547,567,250,317,-44
"48300",NA,53017,"Douglas County, WA","County or equivalent",2005,34343,455,236,507,271,249,125,124,-30
"48540",NA,NA,"Wheeling, WV-OH","Metropolitan Statistical Area",2005,147449,-1143,-423,1533,1956,-592,28,-620,-128
"48540",NA,39013,"Belmont County, OH","County or equivalent",2005,68675,-327,-232,725,957,-35,10,-45,-60
"48540",NA,54051,"Marshall County, WV","County or equivalent",2005,33883,-458,-81,329,410,-353,0,-353,-24
"48540",NA,54069,"Ohio County, WV","County or equivalent",2005,44891,-358,-110,479,589,-204,18,-222,-44
"48620",NA,NA,"Wichita, KS","Metropolitan Statistical Area",2005,583791,2569,4177,9216,5039,-1094,1168,-2262,-514
"48620",NA,20015,"Butler County, KS","County or equivalent",2005,61606,494,201,780,579,352,31,321,-59
"48620",NA,20079,"Harvey County, KS","County or equivalent",2005,33339,-28,62,410,348,-57,44,-101,-33
"48620",NA,20173,"Sedgwick County, KS","County or equivalent",2005,464424,2529,3904,7739,3835,-967,1092,-2059,-408
"48620",NA,20191,"Sumner County, KS","County or equivalent",2005,24422,-426,10,287,277,-422,1,-423,-14
"48660",NA,NA,"Wichita Falls, TX","Metropolitan Statistical Area",2005,149731,-1255,520,2071,1551,-1660,106,-1766,-115
"48660",NA,48009,"Archer County, TX","County or equivalent",2005,8957,-24,27,107,80,-45,0,-45,-6
"48660",NA,48077,"Clay County, TX","County or equivalent",2005,11369,43,-6,109,115,55,0,55,-6
"48660",NA,48485,"Wichita County, TX","County or equivalent",2005,129405,-1274,499,1855,1356,-1670,106,-1776,-103
"48700",NA,NA,"Williamsport, PA","Metropolitan Statistical Area",2005,117683,-389,41,1334,1293,-316,11,-327,-114
"48700",NA,42081,"Lycoming County, PA","County or equivalent",2005,117683,-389,41,1334,1293,-316,11,-327,-114
"48900",NA,NA,"Wilmington, NC","Metropolitan Statistical Area",2005,316271,12287,962,3745,2783,11582,376,11206,-257
"48900",NA,37019,"Brunswick County, NC","County or equivalent",2005,88287,4585,97,957,860,4558,90,4468,-70
"48900",NA,37129,"New Hanover County, NC","County or equivalent",2005,182246,6329,728,2272,1544,5751,217,5534,-150
"48900",NA,37141,"Pender County, NC","County or equivalent",2005,45738,1373,137,516,379,1273,69,1204,-37
"49020",NA,NA,"Winchester, VA-WV","Metropolitan Statistical Area",2005,115773,2993,596,1558,962,2499,148,2351,-102
"49020",NA,51069,"Frederick County, VA","County or equivalent",2005,68492,2161,381,895,514,1841,39,1802,-61
"49020",NA,51840,"Winchester city, VA","County or equivalent",2005,25561,387,194,439,245,213,107,106,-20
"49020",NA,54027,"Hampshire County, WV","County or equivalent",2005,21720,445,21,224,203,445,2,443,-21
"49180",NA,NA,"Winston-Salem, NC","Metropolitan Statistical Area",2005,445761,6488,2036,6067,4031,4873,1363,3510,-421
"49180",NA,37059,"Davie County, NC","County or equivalent",2005,38694,1038,69,433,364,1001,64,937,-32
"49180",NA,37067,"Forsyth County, NC","County or equivalent",2005,324430,4989,1838,4686,2848,3469,1188,2281,-318
"49180",NA,37169,"Stokes County, NC","County or equivalent",2005,45361,204,5,449,444,237,36,201,-38
"49180",NA,37197,"Yadkin County, NC","County or equivalent",2005,37276,257,124,499,375,166,75,91,-33
"49340",NA,NA,"Worcester, MA","Metropolitan Statistical Area",2005,777629,2375,2964,9820,6856,161,2136,-1975,-750
"49340",NA,25027,"Worcester County, MA","County or equivalent",2005,777629,2375,2964,9820,6856,161,2136,-1975,-750
"49420",NA,NA,"Yakima, WA","Metropolitan Statistical Area",2005,228222,1115,2319,4123,1804,-995,925,-1920,-209
"49420",NA,53077,"Yakima County, WA","County or equivalent",2005,228222,1115,2319,4123,1804,-995,925,-1920,-209
"49620",NA,NA,"York-Hanover, PA","Metropolitan Statistical Area",2005,406121,6968,1419,4905,3486,5930,233,5697,-381
"49620",NA,42133,"York County, PA","County or equivalent",2005,406121,6968,1419,4905,3486,5930,233,5697,-381
"49660",NA,NA,"Youngstown-Warren-Boardman, OH-PA","Metropolitan Statistical Area",2005,580874,-4918,-749,6244,6993,-3668,162,-3830,-501
"49660",NA,39099,"Mahoning County, OH","County or equivalent",2005,245669,-2507,-480,2623,3103,-1829,98,-1927,-198
"49660",NA,39155,"Trumbull County, OH","County or equivalent",2005,217111,-1792,-13,2448,2461,-1587,41,-1628,-192
"49660",NA,42085,"Mercer County, PA","County or equivalent",2005,118094,-619,-256,1173,1429,-252,23,-275,-111
"49700",NA,NA,"Yuba City, CA","Metropolitan Statistical Area",2005,154678,4664,1438,2679,1241,3373,638,2735,-147
"49700",NA,6101,"Sutter County, CA","County or equivalent",2005,87659,2014,749,1456,707,1350,448,902,-85
"49700",NA,6115,"Yuba County, CA","County or equivalent",2005,67019,2650,689,1223,534,2023,190,1833,-62
"49740",NA,NA,"Yuma, AZ","Metropolitan Statistical Area",2005,180009,6094,2219,3406,1187,4036,880,3156,-161
"49740",NA,4027,"Yuma County, AZ","County or equivalent",2005,180009,6094,2219,3406,1187,4036,880,3156,-161
" ",NA,NA,"","",2005,NA,NA,NA,NA,NA,NA,NA,NA,NA
" ",NA,NA,"Micropolitan Statistical Area","",2005,NA,NA,NA,NA,NA,NA,NA,NA,NA
" ",NA,NA,"","",2005,NA,NA,NA,NA,NA,NA,NA,NA,NA
"10020",NA,NA,"Abbeville, LA","Micropolitan Statistical Area",2005,54876,540,321,816,495,273,45,228,-54
"10020",NA,22113,"Vermilion Parish, LA","County or equivalent",2005,54876,540,321,816,495,273,45,228,-54
"10100",NA,NA,"Aberdeen, SD","Micropolitan Statistical Area",2005,38954,13,76,508,432,-27,8,-35,-36
"10100",NA,46013,"Brown County, SD","County or equivalent",2005,34875,6,78,454,376,-38,7,-45,-34
"10100",NA,46045,"Edmunds County, SD","County or equivalent",2005,4079,7,-2,54,56,11,1,10,-2
"10140",NA,NA,"Aberdeen, WA","Micropolitan Statistical Area",2005,70109,503,52,872,820,512,82,430,-61
"10140",NA,53027,"Grays Harbor County, WA","County or equivalent",2005,70109,503,52,872,820,512,82,430,-61
"10220",NA,NA,"Ada, OK","Micropolitan Statistical Area",2005,35461,207,84,485,401,154,13,141,-31
"10220",NA,40123,"Pontotoc County, OK","County or equivalent",2005,35461,207,84,485,401,154,13,141,-31
"10300",NA,NA,"Adrian, MI","Micropolitan Statistical Area",2005,100983,38,394,1220,826,-265,40,-305,-91
"10300",NA,26091,"Lenawee County, MI","County or equivalent",2005,100983,38,394,1220,826,-265,40,-305,-91
"10460",NA,NA,"Alamogordo, NM","Micropolitan Statistical Area",2005,63119,-106,335,863,528,-388,276,-664,-53
"10460",NA,35035,"Otero County, NM","County or equivalent",2005,63119,-106,335,863,528,-388,276,-664,-53
"10540",NA,NA,"Albany-Lebanon, OR","Micropolitan Statistical Area",2005,108336,1381,273,1367,1094,1186,85,1101,-78
"10540",NA,41043,"Linn County, OR","County or equivalent",2005,108336,1381,273,1367,1094,1186,85,1101,-78
"10620",NA,NA,"Albemarle, NC","Micropolitan Statistical Area",2005,58433,184,147,697,550,92,75,17,-55
"10620",NA,37167,"Stanly County, NC","County or equivalent",2005,58433,184,147,697,550,92,75,17,-55
"10660",NA,NA,"Albert Lea, MN","Micropolitan Statistical Area",2005,31490,-287,-4,374,378,-255,31,-286,-28
"10660",NA,27047,"Freeborn County, MN","County or equivalent",2005,31490,-287,-4,374,378,-255,31,-286,-28
"10700",NA,NA,"Albertville, AL","Micropolitan Statistical Area",2005,84892,1014,463,1451,988,628,213,415,-77
"10700",NA,1095,"Marshall County, AL","County or equivalent",2005,84892,1014,463,1451,988,628,213,415,-77
"10760",NA,NA,"Alexander City, AL","Micropolitan Statistical Area",2005,51402,-352,-158,544,702,-154,3,-157,-40
"10760",NA,1037,"Coosa County, AL","County or equivalent",2005,10989,-191,-58,94,152,-123,0,-123,-10
"10760",NA,1123,"Tallapoosa County, AL","County or equivalent",2005,40413,-161,-100,450,550,-31,3,-34,-30
"10820",NA,NA,"Alexandria, MN","Micropolitan Statistical Area",2005,35156,554,116,440,324,471,2,469,-33
"10820",NA,27041,"Douglas County, MN","County or equivalent",2005,35156,554,116,440,324,471,2,469,-33
"10860",NA,NA,"Alice, TX","Micropolitan Statistical Area",2005,40627,169,318,663,345,-113,13,-126,-36
"10860",NA,48249,"Jim Wells County, TX","County or equivalent",2005,40627,169,318,663,345,-113,13,-126,-36
"10880",NA,NA,"Allegan, MI","Micropolitan Statistical Area",2005,111930,802,607,1496,889,298,94,204,-103
"10880",NA,26005,"Allegan County, MI","County or equivalent",2005,111930,802,607,1496,889,298,94,204,-103
"10940",NA,NA,"Alma, MI","Micropolitan Statistical Area",2005,42158,-169,3,481,478,-136,9,-145,-36
"10940",NA,26057,"Gratiot County, MI","County or equivalent",2005,42158,-169,3,481,478,-136,9,-145,-36
"10980",NA,NA,"Alpena, MI","Micropolitan Statistical Area",2005,30168,-312,-82,287,369,-202,9,-211,-28
"10980",NA,26007,"Alpena County, MI","County or equivalent",2005,30168,-312,-82,287,369,-202,9,-211,-28
"11060",NA,NA,"Altus, OK","Micropolitan Statistical Area",2005,26443,-721,135,448,313,-841,19,-860,-15
"11060",NA,40065,"Jackson County, OK","County or equivalent",2005,26443,-721,135,448,313,-841,19,-860,-15
"11140",NA,NA,"Americus, GA","Micropolitan Statistical Area",2005,36317,-197,192,564,372,-361,34,-395,-28
"11140",NA,13249,"Schley County, GA","County or equivalent",2005,3941,122,6,51,45,119,3,116,-3
"11140",NA,13261,"Sumter County, GA","County or equivalent",2005,32376,-319,186,513,327,-480,31,-511,-25
"11220",NA,NA,"Amsterdam, NY","Micropolitan Statistical Area",2005,48668,-119,27,610,583,-101,17,-118,-45
"11220",NA,36057,"Montgomery County, NY","County or equivalent",2005,48668,-119,27,610,583,-101,17,-118,-45
"11380",NA,NA,"Andrews, TX","Micropolitan Statistical Area",2005,12696,-62,103,214,111,-155,12,-167,-10
"11380",NA,48003,"Andrews County, TX","County or equivalent",2005,12696,-62,103,214,111,-155,12,-167,-10
"11420",NA,NA,"Angola, IN","Micropolitan Statistical Area",2005,33529,128,166,453,287,-8,19,-27,-30
"11420",NA,18151,"Steuben County, IN","County or equivalent",2005,33529,128,166,453,287,-8,19,-27,-30
"11580",NA,NA,"Arcadia, FL","Micropolitan Statistical Area",2005,34082,-24,175,477,302,-190,333,-523,-9
"11580",NA,12027,"DeSoto County, FL","County or equivalent",2005,34082,-24,175,477,302,-190,333,-523,-9
"11620",NA,NA,"Ardmore, OK","Micropolitan Statistical Area",2005,55676,122,58,776,718,114,32,82,-50
"11620",NA,40019,"Carter County, OK","County or equivalent",2005,46642,34,25,651,626,50,23,27,-41
"11620",NA,40085,"Love County, OK","County or equivalent",2005,9034,88,33,125,92,64,9,55,-9
"11660",NA,NA,"Arkadelphia, AR","Micropolitan Statistical Area",2005,23172,-36,45,288,243,-65,24,-89,-16
"11660",NA,5019,"Clark County, AR","County or equivalent",2005,23172,-36,45,288,243,-65,24,-89,-16
"11740",NA,NA,"Ashland, OH","Micropolitan Statistical Area",2005,53978,354,230,689,459,174,15,159,-50
"11740",NA,39005,"Ashland County, OH","County or equivalent",2005,53978,354,230,689,459,174,15,159,-50
"11780",NA,NA,"Ashtabula, OH","Micropolitan Statistical Area",2005,102005,-230,106,1266,1160,-239,36,-275,-97
"11780",NA,39007,"Ashtabula County, OH","County or equivalent",2005,102005,-230,106,1266,1160,-239,36,-275,-97
"11820",NA,NA,"Astoria, OR","Micropolitan Statistical Area",2005,36489,407,7,382,375,430,54,376,-30
"11820",NA,41007,"Clatsop County, OR","County or equivalent",2005,36489,407,7,382,375,430,54,376,-30
"11860",NA,NA,"Atchison, KS","Micropolitan Statistical Area",2005,16588,-127,30,222,192,-143,5,-148,-14
"11860",NA,20005,"Atchison County, KS","County or equivalent",2005,16588,-127,30,222,192,-143,5,-148,-14
"11900",NA,NA,"Athens, OH","Micropolitan Statistical Area",2005,63175,676,180,603,423,554,143,411,-58
"11900",NA,39009,"Athens County, OH","County or equivalent",2005,63175,676,180,603,423,554,143,411,-58
"11940",NA,NA,"Athens, TN","Micropolitan Statistical Area",2005,51024,576,53,628,575,567,29,538,-44
"11940",NA,47107,"McMinn County, TN","County or equivalent",2005,51024,576,53,628,575,567,29,538,-44
"11980",NA,NA,"Athens, TX","Micropolitan Statistical Area",2005,78501,242,99,985,886,210,83,127,-67
"11980",NA,48213,"Henderson County, TX","County or equivalent",2005,78501,242,99,985,886,210,83,127,-67
"12140",NA,NA,"Auburn, IN","Micropolitan Statistical Area",2005,41393,218,249,597,348,5,15,-10,-36
"12140",NA,18033,"DeKalb County, IN","County or equivalent",2005,41393,218,249,597,348,5,15,-10,-36
"12180",NA,NA,"Auburn, NY","Micropolitan Statistical Area",2005,80581,-299,53,816,763,-281,23,-304,-71
"12180",NA,36011,"Cayuga County, NY","County or equivalent",2005,80581,-299,53,816,763,-281,23,-304,-71
"12300",NA,NA,"Augusta-Waterville, ME","Micropolitan Statistical Area",2005,120157,428,-11,1212,1223,554,35,519,-115
"12300",NA,23011,"Kennebec County, ME","County or equivalent",2005,120157,428,-11,1212,1223,554,35,519,-115
"12380",NA,NA,"Austin, MN","Micropolitan Statistical Area",2005,38152,-347,120,536,416,-436,81,-517,-31
"12380",NA,27099,"Mower County, MN","County or equivalent",2005,38152,-347,120,536,416,-436,81,-517,-31
"12460",NA,NA,"Bainbridge, GA","Micropolitan Statistical Area",2005,27946,-160,99,393,294,-235,42,-277,-24
"12460",NA,13087,"Decatur County, GA","County or equivalent",2005,27946,-160,99,393,294,-235,42,-277,-24
"12660",NA,NA,"Baraboo, WI","Micropolitan Statistical Area",2005,57402,514,237,755,518,333,20,313,-56
"12660",NA,55111,"Sauk County, WI","County or equivalent",2005,57402,514,237,755,518,333,20,313,-56
"12740",NA,NA,"Barre, VT","Micropolitan Statistical Area",2005,58946,207,141,627,486,122,58,64,-56
"12740",NA,50023,"Washington County, VT","County or equivalent",2005,58946,207,141,627,486,122,58,64,-56
"12780",NA,NA,"Bartlesville, OK","Micropolitan Statistical Area",2005,48598,-190,-10,576,586,-134,62,-196,-46
"12780",NA,40147,"Washington County, OK","County or equivalent",2005,48598,-190,-10,576,586,-134,62,-196,-46
"12820",NA,NA,"Bastrop, LA","Micropolitan Statistical Area",2005,29421,-527,22,414,392,-527,2,-529,-22
"12820",NA,22067,"Morehouse Parish, LA","County or equivalent",2005,29421,-527,22,414,392,-527,2,-529,-22
"12860",NA,NA,"Batavia, NY","Micropolitan Statistical Area",2005,58748,-382,117,669,552,-445,27,-472,-54
"12860",NA,36037,"Genesee County, NY","County or equivalent",2005,58748,-382,117,669,552,-445,27,-472,-54
"12900",NA,NA,"Batesville, AR","Micropolitan Statistical Area",2005,34270,7,122,494,372,-83,18,-101,-32
"12900",NA,5063,"Independence County, AR","County or equivalent",2005,34270,7,122,494,372,-83,18,-101,-32
"13060",NA,NA,"Bay City, TX","Micropolitan Statistical Area",2005,37296,-244,234,559,325,-448,132,-580,-30
"13060",NA,48321,"Matagorda County, TX","County or equivalent",2005,37296,-244,234,559,325,-448,132,-580,-30
"13100",NA,NA,"Beatrice, NE","Micropolitan Statistical Area",2005,23043,-157,-13,274,287,-125,2,-127,-19
"13100",NA,31067,"Gage County, NE","County or equivalent",2005,23043,-157,-13,274,287,-125,2,-127,-19
"13180",NA,NA,"Beaver Dam, WI","Micropolitan Statistical Area",2005,87181,-152,76,937,861,-145,29,-174,-83
"13180",NA,55027,"Dodge County, WI","County or equivalent",2005,87181,-152,76,937,861,-145,29,-174,-83
"13220",NA,NA,"Beckley, WV","Micropolitan Statistical Area",2005,78575,-56,18,896,878,-3,28,-31,-71
"13220",NA,54081,"Raleigh County, WV","County or equivalent",2005,78575,-56,18,896,878,-3,28,-31,-71
"13260",NA,NA,"Bedford, IN","Micropolitan Statistical Area",2005,45962,70,39,553,514,75,11,64,-44
"13260",NA,18093,"Lawrence County, IN","County or equivalent",2005,45962,70,39,553,514,75,11,64,-44
"13300",NA,NA,"Beeville, TX","Micropolitan Statistical Area",2005,32451,-192,156,385,229,-319,4,-323,-29
"13300",NA,48025,"Bee County, TX","County or equivalent",2005,32451,-192,156,385,229,-319,4,-323,-29
"13340",NA,NA,"Bellefontaine, OH","Micropolitan Statistical Area",2005,46286,-149,122,607,485,-232,20,-252,-39
"13340",NA,39091,"Logan County, OH","County or equivalent",2005,46286,-149,122,607,485,-232,20,-252,-39
"13420",NA,NA,"Bemidji, MN","Micropolitan Statistical Area",2005,42676,599,333,667,334,300,17,283,-34
"13420",NA,27007,"Beltrami County, MN","County or equivalent",2005,42676,599,333,667,334,300,17,283,-34
"13500",NA,NA,"Bennettsville, SC","Micropolitan Statistical Area",2005,27587,-507,67,362,295,-553,3,-556,-21
"13500",NA,45069,"Marlboro County, SC","County or equivalent",2005,27587,-507,67,362,295,-553,3,-556,-21
"13540",NA,NA,"Bennington, VT","Micropolitan Statistical Area",2005,36522,-197,-58,369,427,-106,24,-130,-33
"13540",NA,50003,"Bennington County, VT","County or equivalent",2005,36522,-197,-58,369,427,-106,24,-130,-33
"13620",NA,NA,"Berlin, NH-VT","Micropolitan Statistical Area",2005,39297,26,-100,351,451,164,11,153,-38
"13620",NA,33007,"Coos County, NH","County or equivalent",2005,32804,50,-102,302,404,184,9,175,-32
"13620",NA,50009,"Essex County, VT","County or equivalent",2005,6493,-24,2,49,47,-20,2,-22,-6
"13660",NA,NA,"Big Rapids, MI","Micropolitan Statistical Area",2005,42303,233,133,451,318,135,39,96,-35
"13660",NA,26107,"Mecosta County, MI","County or equivalent",2005,42303,233,133,451,318,135,39,96,-35
"13700",NA,NA,"Big Spring, TX","Micropolitan Statistical Area",2005,32044,-347,62,449,387,-382,20,-402,-27
"13700",NA,48227,"Howard County, TX","County or equivalent",2005,32044,-347,62,449,387,-382,20,-402,-27
"13860",NA,NA,"Bishop, CA","Micropolitan Statistical Area",2005,17717,-244,10,211,201,-251,25,-276,-3
"13860",NA,6027,"Inyo County, CA","County or equivalent",2005,17717,-244,10,211,201,-251,25,-276,-3
"13940",NA,NA,"Blackfoot, ID","Micropolitan Statistical Area",2005,42835,388,541,828,287,-113,61,-174,-40
"13940",NA,16011,"Bingham County, ID","County or equivalent",2005,42835,388,541,828,287,-113,61,-174,-40
"14100",NA,NA,"Bloomsburg-Berwick, PA","Micropolitan Statistical Area",2005,82443,-90,-74,824,898,63,22,41,-79
"14100",NA,42037,"Columbia County, PA","County or equivalent",2005,64536,-46,-23,632,655,38,17,21,-61
"14100",NA,42093,"Montour County, PA","County or equivalent",2005,17907,-44,-51,192,243,25,5,20,-18
"14140",NA,NA,"Bluefield, WV-VA","Micropolitan Statistical Area",2005,105043,-550,-235,1169,1404,-219,22,-241,-96
"14140",NA,51185,"Tazewell County, VA","County or equivalent",2005,43852,-120,-123,467,590,43,11,32,-40
"14140",NA,54055,"Mercer County, WV","County or equivalent",2005,61191,-430,-112,702,814,-262,11,-273,-56
"14180",NA,NA,"Blytheville, AR","Micropolitan Statistical Area",2005,47126,-441,251,781,530,-657,19,-676,-35
"14180",NA,5093,"Mississippi County, AR","County or equivalent",2005,47126,-441,251,781,530,-657,19,-676,-35
"14220",NA,NA,"Bogalusa, LA","Micropolitan Statistical Area",2005,43919,171,-9,571,580,222,1,221,-42
"14220",NA,22117,"Washington Parish, LA","County or equivalent",2005,43919,171,-9,571,580,222,1,221,-42
"14300",NA,NA,"Bonham, TX","Micropolitan Statistical Area",2005,32647,410,-10,418,428,446,24,422,-26
"14300",NA,48147,"Fannin County, TX","County or equivalent",2005,32647,410,-10,418,428,446,24,422,-26
"14340",NA,NA,"Boone, IA","Micropolitan Statistical Area",2005,26334,91,42,291,249,74,4,70,-25
"14340",NA,19015,"Boone County, IA","County or equivalent",2005,26334,91,42,291,249,74,4,70,-25
"14380",NA,NA,"Boone, NC","Micropolitan Statistical Area",2005,43460,286,77,376,299,249,44,205,-40
"14380",NA,37189,"Watauga County, NC","County or equivalent",2005,43460,286,77,376,299,249,44,205,-40
"14420",NA,NA,"Borger, TX","Micropolitan Statistical Area",2005,21900,-342,43,293,250,-373,39,-412,-12
"14420",NA,48233,"Hutchinson County, TX","County or equivalent",2005,21900,-342,43,293,250,-373,39,-412,-12
"14580",NA,NA,"Bozeman, MT","Micropolitan Statistical Area",2005,80671,3263,618,979,361,2709,72,2637,-64
"14580",NA,30031,"Gallatin County, MT","County or equivalent",2005,80671,3263,618,979,361,2709,72,2637,-64
"14620",NA,NA,"Bradford, PA","Micropolitan Statistical Area",2005,43898,-458,-70,442,512,-350,2,-352,-38
"14620",NA,42083,"McKean County, PA","County or equivalent",2005,43898,-458,-70,442,512,-350,2,-352,-38
"14660",NA,NA,"Brainerd, MN","Micropolitan Statistical Area",2005,88387,1102,332,1164,832,846,10,836,-76
"14660",NA,27021,"Cass County, MN","County or equivalent",2005,28672,331,93,395,302,258,1,257,-20
"14660",NA,27035,"Crow Wing County, MN","County or equivalent",2005,59715,771,239,769,530,588,9,579,-56
"14700",NA,NA,"Branson, MO","Micropolitan Statistical Area",2005,73546,1088,123,853,730,1024,31,993,-59
"14700",NA,29209,"Stone County, MO","County or equivalent",2005,30474,154,-14,290,304,187,6,181,-19
"14700",NA,29213,"Taney County, MO","County or equivalent",2005,43072,934,137,563,426,837,25,812,-40
"14780",NA,NA,"Brenham, TX","Micropolitan Statistical Area",2005,31427,296,70,430,360,249,58,191,-23
"14780",NA,48477,"Washington County, TX","County or equivalent",2005,31427,296,70,430,360,249,58,191,-23
"14820",NA,NA,"Brevard, NC","Micropolitan Statistical Area",2005,29428,189,-94,263,357,309,27,282,-26
"14820",NA,37175,"Transylvania County, NC","County or equivalent",2005,29428,189,-94,263,357,309,27,282,-26
"14940",NA,NA,"Brigham City, UT","Micropolitan Statistical Area",2005,45925,364,581,877,296,-216,42,-258,-1
"14940",NA,49003,"Box Elder County, UT","County or equivalent",2005,45925,364,581,877,296,-216,42,-258,-1
"15020",NA,NA,"Brookhaven, MS","Micropolitan Statistical Area",2005,33671,237,122,461,339,141,5,136,-26
"15020",NA,28085,"Lincoln County, MS","County or equivalent",2005,33671,237,122,461,339,141,5,136,-26
"15060",NA,NA,"Brookings, OR","Micropolitan Statistical Area",2005,22082,144,-128,163,291,290,9,281,-18
"15060",NA,41015,"Curry County, OR","County or equivalent",2005,22082,144,-128,163,291,290,9,281,-18
"15100",NA,NA,"Brookings, SD","Micropolitan Statistical Area",2005,28474,-108,183,348,165,-268,32,-300,-23
"15100",NA,46011,"Brookings County, SD","County or equivalent",2005,28474,-108,183,348,165,-268,32,-300,-23
"15140",NA,NA,"Brownsville, TN","Micropolitan Statistical Area",2005,19381,-192,53,287,234,-228,19,-247,-17
"15140",NA,47075,"Haywood County, TN","County or equivalent",2005,19381,-192,53,287,234,-228,19,-247,-17
"15220",NA,NA,"Brownwood, TX","Micropolitan Statistical Area",2005,38193,241,-12,491,503,284,23,261,-31
"15220",NA,48049,"Brown County, TX","County or equivalent",2005,38193,241,-12,491,503,284,23,261,-31
"15340",NA,NA,"Bucyrus, OH","Micropolitan Statistical Area",2005,45164,-327,44,536,492,-336,2,-338,-35
"15340",NA,39033,"Crawford County, OH","County or equivalent",2005,45164,-327,44,536,492,-336,2,-338,-35
"15420",NA,NA,"Burley, ID","Micropolitan Statistical Area",2005,39419,-314,395,758,363,-680,110,-790,-29
"15420",NA,16031,"Cassia County, ID","County or equivalent",2005,20883,-54,231,419,188,-269,47,-316,-16
"15420",NA,16067,"Minidoka County, ID","County or equivalent",2005,18536,-260,164,339,175,-411,63,-474,-13
"15460",NA,NA,"Burlington, IA-IL","Micropolitan Statistical Area",2005,48324,-318,-2,531,533,-272,23,-295,-44
"15460",NA,17071,"Henderson County, IL","County or equivalent",2005,7784,-133,-28,59,87,-100,1,-101,-5
"15460",NA,19057,"Des Moines County, IA","County or equivalent",2005,40540,-185,26,472,446,-172,22,-194,-39
"15580",NA,NA,"Butte-Silver Bow, MT","Micropolitan Statistical Area",2005,32755,-124,-73,372,445,-25,6,-31,-26
"15580",NA,30093,"Silver Bow County, MT","County or equivalent",2005,32755,-124,-73,372,445,-25,6,-31,-26
"15620",NA,NA,"Cadillac, MI","Micropolitan Statistical Area",2005,46640,299,155,609,454,184,9,175,-40
"15620",NA,26113,"Missaukee County, MI","County or equivalent",2005,15064,-37,14,165,151,-38,-1,-37,-13
"15620",NA,26165,"Wexford County, MI","County or equivalent",2005,31576,336,141,444,303,222,10,212,-27
"15660",NA,NA,"Calhoun, GA","Micropolitan Statistical Area",2005,49514,927,396,837,441,579,171,408,-48
"15660",NA,13129,"Gordon County, GA","County or equivalent",2005,49514,927,396,837,441,579,171,408,-48
"15700",NA,NA,"Cambridge, MD","Micropolitan Statistical Area",2005,31116,262,-90,306,396,379,5,374,-27
"15700",NA,24019,"Dorchester County, MD","County or equivalent",2005,31116,262,-90,306,396,379,5,374,-27
"15740",NA,NA,"Cambridge, OH","Micropolitan Statistical Area",2005,40614,-245,55,496,441,-268,3,-271,-32
"15740",NA,39059,"Guernsey County, OH","County or equivalent",2005,40614,-245,55,496,441,-268,3,-271,-32
"15780",NA,NA,"Camden, AR","Micropolitan Statistical Area",2005,32163,-197,11,419,408,-177,15,-192,-31
"15780",NA,5013,"Calhoun County, AR","County or equivalent",2005,5533,50,-3,35,38,59,6,53,-6
"15780",NA,5103,"Ouachita County, AR","County or equivalent",2005,26630,-247,14,384,370,-236,9,-245,-25
"15820",NA,NA,"Campbellsville, KY","Micropolitan Statistical Area",2005,23601,168,15,290,275,172,5,167,-19
"15820",NA,21217,"Taylor County, KY","County or equivalent",2005,23601,168,15,290,275,172,5,167,-19
"15860",NA,NA,"Canon City, CO","Micropolitan Statistical Area",2005,46957,84,-95,403,498,220,16,204,-41
"15860",NA,8043,"Fremont County, CO","County or equivalent",2005,46957,84,-95,403,498,220,16,204,-41
"15900",NA,NA,"Canton, IL","Micropolitan Statistical Area",2005,37134,-247,-76,392,468,-138,2,-140,-33
"15900",NA,17057,"Fulton County, IL","County or equivalent",2005,37134,-247,-76,392,468,-138,2,-140,-33
"16020",NA,NA,"Cape Girardeau-Jackson, MO-IL","Micropolitan Statistical Area",2005,91908,189,144,1165,1021,113,38,75,-68
"16020",NA,17003,"Alexander County, IL","County or equivalent",2005,8633,-308,0,117,117,-303,1,-304,-5
"16020",NA,29017,"Bollinger County, MO","County or equivalent",2005,12151,-27,7,146,139,-25,1,-26,-9
"16020",NA,29031,"Cape Girardeau County, MO","County or equivalent",2005,71124,524,137,902,765,441,36,405,-54
"16060",NA,NA,"Carbondale, IL","Micropolitan Statistical Area",2005,59076,385,148,653,505,288,226,62,-51
"16060",NA,17077,"Jackson County, IL","County or equivalent",2005,59076,385,148,653,505,288,226,62,-51
"16100",NA,NA,"Carlsbad-Artesia, NM","Micropolitan Statistical Area",2005,50173,-630,139,686,547,-731,36,-767,-38
"16100",NA,35015,"Eddy County, NM","County or equivalent",2005,50173,-630,139,686,547,-731,36,-767,-38
"16260",NA,NA,"Cedar City, UT","Micropolitan Statistical Area",2005,39333,2277,661,872,211,1644,59,1585,-28
"16260",NA,49021,"Iron County, UT","County or equivalent",2005,39333,2277,661,872,211,1644,59,1585,-28
"16340",NA,NA,"Cedartown, GA","Micropolitan Statistical Area",2005,40205,330,230,692,462,138,118,20,-38
"16340",NA,13233,"Polk County, GA","County or equivalent",2005,40205,330,230,692,462,138,118,20,-38
"16380",NA,NA,"Celina, OH","Micropolitan Statistical Area",2005,40761,29,187,592,405,-119,9,-128,-39
"16380",NA,39107,"Mercer County, OH","County or equivalent",2005,40761,29,187,592,405,-119,9,-128,-39
"16420",NA,NA,"Central City, KY","Micropolitan Statistical Area",2005,31403,-42,23,380,357,-34,0,-34,-31
"16420",NA,21177,"Muhlenberg County, KY","County or equivalent",2005,31403,-42,23,380,357,-34,0,-34,-31
"16460",NA,NA,"Centralia, IL","Micropolitan Statistical Area",2005,39703,-344,18,520,502,-326,2,-328,-36
"16460",NA,17121,"Marion County, IL","County or equivalent",2005,39703,-344,18,520,502,-326,2,-328,-36
"16500",NA,NA,"Centralia, WA","Micropolitan Statistical Area",2005,71597,924,96,898,802,887,94,793,-59
"16500",NA,53041,"Lewis County, WA","County or equivalent",2005,71597,924,96,898,802,887,94,793,-59
"16540",NA,NA,"Chambersburg, PA","Micropolitan Statistical Area",2005,136887,2702,492,1789,1297,2331,107,2224,-121
"16540",NA,42055,"Franklin County, PA","County or equivalent",2005,136887,2702,492,1789,1297,2331,107,2224,-121
"16660",NA,NA,"Charleston-Mattoon, IL","Micropolitan Statistical Area",2005,62936,-387,75,685,610,-408,34,-442,-54
"16660",NA,17029,"Coles County, IL","County or equivalent",2005,52086,-334,55,541,486,-345,32,-377,-44
"16660",NA,17035,"Cumberland County, IL","County or equivalent",2005,10850,-53,20,144,124,-63,2,-65,-10
"16900",NA,NA,"Chester, SC","Micropolitan Statistical Area",2005,32887,-350,68,397,329,-395,12,-407,-23
"16900",NA,45023,"Chester County, SC","County or equivalent",2005,32887,-350,68,397,329,-395,12,-407,-23
"17060",NA,NA,"Chillicothe, OH","Micropolitan Statistical Area",2005,74808,480,215,929,714,332,20,312,-67
"17060",NA,39141,"Ross County, OH","County or equivalent",2005,74808,480,215,929,714,332,20,312,-67
"17180",NA,NA,"City of The Dalles, OR","Micropolitan Statistical Area",2005,23401,8,1,282,281,26,28,-2,-19
"17180",NA,41065,"Wasco County, OR","County or equivalent",2005,23401,8,1,282,281,26,28,-2,-19
"17200",NA,NA,"Claremont, NH","Micropolitan Statistical Area",2005,42311,238,54,481,427,215,15,200,-31
"17200",NA,33019,"Sullivan County, NH","County or equivalent",2005,42311,238,54,481,427,215,15,200,-31
"17220",NA,NA,"Clarksburg, WV","Micropolitan Statistical Area",2005,91401,171,-15,1089,1104,269,26,243,-83
"17220",NA,54017,"Doddridge County, WV","County or equivalent",2005,7297,32,-14,78,92,52,0,52,-6
"17220",NA,54033,"Harrison County, WV","County or equivalent",2005,68094,134,43,865,822,153,26,127,-62
"17220",NA,54091,"Taylor County, WV","County or equivalent",2005,16010,5,-44,146,190,64,0,64,-15
"17260",NA,NA,"Clarksdale, MS","Micropolitan Statistical Area",2005,28249,-563,131,475,344,-674,10,-684,-20
"17260",NA,28027,"Coahoma County, MS","County or equivalent",2005,28249,-563,131,475,344,-674,10,-684,-20
"17340",NA,NA,"Clearlake, CA","Micropolitan Statistical Area",2005,64132,756,-65,709,774,872,87,785,-51
"17340",NA,6033,"Lake County, CA","County or equivalent",2005,64132,756,-65,709,774,872,87,785,-51
"17380",NA,NA,"Cleveland, MS","Micropolitan Statistical Area",2005,37582,-692,189,587,398,-852,6,-858,-29
"17380",NA,28011,"Bolivar County, MS","County or equivalent",2005,37582,-692,189,587,398,-852,6,-858,-29
"17500",NA,NA,"Clewiston, FL","Micropolitan Statistical Area",2005,38331,1241,417,713,296,858,344,514,-34
"17500",NA,12051,"Hendry County, FL","County or equivalent",2005,38331,1241,417,713,296,858,344,514,-34
"17540",NA,NA,"Clinton, IA","Micropolitan Statistical Area",2005,49268,-90,69,614,545,-115,29,-144,-44
"17540",NA,19045,"Clinton County, IA","County or equivalent",2005,49268,-90,69,614,545,-115,29,-144,-44
"17580",NA,NA,"Clovis, NM","Micropolitan Statistical Area",2005,45792,59,548,946,398,-446,47,-493,-43
"17580",NA,35009,"Curry County, NM","County or equivalent",2005,45792,59,548,946,398,-446,47,-493,-43
"17700",NA,NA,"Coffeyville, KS","Micropolitan Statistical Area",2005,34250,-270,-3,468,471,-237,18,-255,-30
"17700",NA,20125,"Montgomery County, KS","County or equivalent",2005,34250,-270,-3,468,471,-237,18,-255,-30
"17740",NA,NA,"Coldwater, MI","Micropolitan Statistical Area",2005,46323,-154,166,574,408,-285,64,-349,-35
"17740",NA,26023,"Branch County, MI","County or equivalent",2005,46323,-154,166,574,408,-285,64,-349,-35
"17940",NA,NA,"Columbia, TN","Micropolitan Statistical Area",2005,75437,1345,282,988,706,1121,95,1026,-58
"17940",NA,47119,"Maury County, TN","County or equivalent",2005,75437,1345,282,988,706,1121,95,1026,-58
"18060",NA,NA,"Columbus, MS","Micropolitan Statistical Area",2005,59467,-463,281,838,557,-694,5,-699,-50
"18060",NA,28087,"Lowndes County, MS","County or equivalent",2005,59467,-463,281,838,557,-694,5,-699,-50
"18100",NA,NA,"Columbus, NE","Micropolitan Statistical Area",2005,31126,258,234,467,233,35,51,-16,-11
"18100",NA,31141,"Platte County, NE","County or equivalent",2005,31126,258,234,467,233,35,51,-16,-11
"18180",NA,NA,"Concord, NH","Micropolitan Statistical Area",2005,146207,1528,285,1530,1245,1371,129,1242,-128
"18180",NA,33013,"Merrimack County, NH","County or equivalent",2005,146207,1528,285,1530,1245,1371,129,1242,-128
"18220",NA,NA,"Connersville, IN","Micropolitan Statistical Area",2005,24590,-166,38,314,276,-182,1,-183,-22
"18220",NA,18041,"Fayette County, IN","County or equivalent",2005,24590,-166,38,314,276,-182,1,-183,-22
"18260",NA,NA,"Cookeville, TN","Micropolitan Statistical Area",2005,98427,1055,186,1255,1069,941,131,810,-72
"18260",NA,47087,"Jackson County, TN","County or equivalent",2005,10978,-88,-63,107,170,-17,3,-20,-8
"18260",NA,47133,"Overton County, TN","County or equivalent",2005,20449,84,-10,255,265,112,0,112,-18
"18260",NA,47141,"Putnam County, TN","County or equivalent",2005,67000,1059,259,893,634,846,128,718,-46
"18300",NA,NA,"Coos Bay, OR","Micropolitan Statistical Area",2005,63685,598,-264,629,893,918,32,886,-56
"18300",NA,41011,"Coos County, OR","County or equivalent",2005,63685,598,-264,629,893,918,32,886,-56
"18340",NA,NA,"Corbin, KY","Micropolitan Statistical Area",2005,37701,369,-2,398,400,398,8,390,-27
"18340",NA,21235,"Whitley County, KY","County or equivalent",2005,37701,369,-2,398,400,398,8,390,-27
"18380",NA,NA,"Cordele, GA","Micropolitan Statistical Area",2005,21745,-9,110,349,239,-98,32,-130,-21
"18380",NA,13081,"Crisp County, GA","County or equivalent",2005,21745,-9,110,349,239,-98,32,-130,-21
"18420",NA,NA,"Corinth, MS","Micropolitan Statistical Area",2005,35028,95,53,484,431,75,14,61,-33
"18420",NA,28003,"Alcorn County, MS","County or equivalent",2005,35028,95,53,484,431,75,14,61,-33
"18460",NA,NA,"Cornelia, GA","Micropolitan Statistical Area",2005,39305,645,287,596,309,391,109,282,-33
"18460",NA,13137,"Habersham County, GA","County or equivalent",2005,39305,645,287,596,309,391,109,282,-33
"18500",NA,NA,"Corning, NY","Micropolitan Statistical Area",2005,97345,-430,118,1130,1012,-458,42,-500,-90
"18500",NA,36101,"Steuben County, NY","County or equivalent",2005,97345,-430,118,1130,1012,-458,42,-500,-90
"18620",NA,NA,"Corsicana, TX","Micropolitan Statistical Area",2005,48181,471,197,671,474,311,205,106,-37
"18620",NA,48349,"Navarro County, TX","County or equivalent",2005,48181,471,197,671,474,311,205,106,-37
"18660",NA,NA,"Cortland, NY","Micropolitan Statistical Area",2005,48363,-453,88,525,437,-503,28,-531,-38
"18660",NA,36023,"Cortland County, NY","County or equivalent",2005,48363,-453,88,525,437,-503,28,-531,-38
"18740",NA,NA,"Coshocton, OH","Micropolitan Statistical Area",2005,36653,-193,85,473,388,-247,26,-273,-31
"18740",NA,39031,"Coshocton County, OH","County or equivalent",2005,36653,-193,85,473,388,-247,26,-273,-31
"18820",NA,NA,"Crawfordsville, IN","Micropolitan Statistical Area",2005,37783,232,123,485,362,146,40,106,-37
"18820",NA,18107,"Montgomery County, IN","County or equivalent",2005,37783,232,123,485,362,146,40,106,-37
"18860",NA,NA,"Crescent City, CA","Micropolitan Statistical Area",2005,28504,397,51,302,251,369,51,318,-23
"18860",NA,6015,"Del Norte County, CA","County or equivalent",2005,28504,397,51,302,251,369,51,318,-23
"18900",NA,NA,"Crossville, TN","Micropolitan Statistical Area",2005,50870,976,-40,534,574,1067,7,1060,-51
"18900",NA,47035,"Cumberland County, TN","County or equivalent",2005,50870,976,-40,534,574,1067,7,1060,-51
"18940",NA,NA,"Crowley, LA","Micropolitan Statistical Area",2005,58768,135,304,960,656,-113,7,-120,-56
"18940",NA,22001,"Acadia Parish, LA","County or equivalent",2005,58768,135,304,960,656,-113,7,-120,-56
"18980",NA,NA,"Cullman, AL","Micropolitan Statistical Area",2005,79268,637,25,933,908,683,75,608,-71
"18980",NA,1043,"Cullman County, AL","County or equivalent",2005,79268,637,25,933,908,683,75,608,-71
"19020",NA,NA,"Culpeper, VA","Micropolitan Statistical Area",2005,41893,2206,212,561,349,2023,59,1964,-29
"19020",NA,51047,"Culpeper County, VA","County or equivalent",2005,41893,2206,212,561,349,2023,59,1964,-29
"19220",NA,NA,"Danville, KY","Micropolitan Statistical Area",2005,53183,575,81,653,572,536,50,486,-42
"19220",NA,21021,"Boyle County, KY","County or equivalent",2005,28268,139,-50,289,339,207,38,169,-18
"19220",NA,21137,"Lincoln County, KY","County or equivalent",2005,24915,436,131,364,233,329,12,317,-24
"19300",NA,NA,"Daphne-Fairhope-Foley, AL","Micropolitan Statistical Area",2005,162149,5873,496,2025,1529,5314,129,5185,63
"19300",NA,1003,"Baldwin County, AL","County or equivalent",2005,162149,5873,496,2025,1529,5314,129,5185,63
"19540",NA,NA,"Decatur, IN","Micropolitan Statistical Area",2005,33754,20,326,641,315,-277,9,-286,-29
"19540",NA,18001,"Adams County, IN","County or equivalent",2005,33754,20,326,641,315,-277,9,-286,-29
"19580",NA,NA,"Defiance, OH","Micropolitan Statistical Area",2005,38597,-157,150,505,355,-271,13,-284,-36
"19580",NA,39039,"Defiance County, OH","County or equivalent",2005,38597,-157,150,505,355,-271,13,-284,-36
"19620",NA,NA,"Del Rio, TX","Micropolitan Statistical Area",2005,47041,115,672,977,305,-519,172,-691,-38
"19620",NA,48465,"Val Verde County, TX","County or equivalent",2005,47041,115,672,977,305,-519,172,-691,-38
"19700",NA,NA,"Deming, NM","Micropolitan Statistical Area",2005,26010,449,170,408,238,303,138,165,-24
"19700",NA,35029,"Luna County, NM","County or equivalent",2005,26010,449,170,408,238,303,138,165,-24
"19760",NA,NA,"De Ridder, LA","Micropolitan Statistical Area",2005,34236,525,103,436,333,453,2,451,-31
"19760",NA,22011,"Beauregard Parish, LA","County or equivalent",2005,34236,525,103,436,333,453,2,451,-31
"19860",NA,NA,"Dickinson, ND","Micropolitan Statistical Area",2005,22908,8,67,287,220,-37,13,-50,-22
"19860",NA,38007,"Billings County, ND","County or equivalent",2005,788,-17,6,10,4,-23,2,-25,0
"19860",NA,38089,"Stark County, ND","County or equivalent",2005,22120,25,61,277,216,-14,11,-25,-22
"19900",NA,NA,"Dillon, SC","Micropolitan Statistical Area",2005,30690,-113,168,486,318,-254,15,-269,-27
"19900",NA,45033,"Dillon County, SC","County or equivalent",2005,30690,-113,168,486,318,-254,15,-269,-27
"19940",NA,NA,"Dixon, IL","Micropolitan Statistical Area",2005,34885,-201,5,367,362,-175,16,-191,-31
"19940",NA,17103,"Lee County, IL","County or equivalent",2005,34885,-201,5,367,362,-175,16,-191,-31
"19980",NA,NA,"Dodge City, KS","Micropolitan Statistical Area",2005,32876,222,403,650,247,-157,353,-510,-24
"19980",NA,20057,"Ford County, KS","County or equivalent",2005,32876,222,403,650,247,-157,353,-510,-24
"20060",NA,NA,"Douglas, GA","Micropolitan Statistical Area",2005,47044,375,350,767,417,70,155,-85,-45
"20060",NA,13003,"Atkinson County, GA","County or equivalent",2005,7941,69,75,148,73,1,41,-40,-7
"20060",NA,13069,"Coffee County, GA","County or equivalent",2005,39103,306,275,619,344,69,114,-45,-38
"20140",NA,NA,"Dublin, GA","Micropolitan Statistical Area",2005,55524,260,207,807,600,102,27,75,-49
"20140",NA,13167,"Johnson County, GA","County or equivalent",2005,8901,-130,-8,106,114,-117,2,-119,-5
"20140",NA,13175,"Laurens County, GA","County or equivalent",2005,46623,390,215,701,486,219,25,194,-44
"20180",NA,NA,"DuBois, PA","Micropolitan Statistical Area",2005,82004,-183,-107,820,927,6,11,-5,-82
"20180",NA,42033,"Clearfield County, PA","County or equivalent",2005,82004,-183,-107,820,927,6,11,-5,-82
"20300",NA,NA,"Dumas, TX","Micropolitan Statistical Area",2005,19827,-174,288,442,154,-450,120,-570,-12
"20300",NA,48341,"Moore County, TX","County or equivalent",2005,19827,-174,288,442,154,-450,120,-570,-12
"20340",NA,NA,"Duncan, OK","Micropolitan Statistical Area",2005,42560,104,-12,577,589,157,1,156,-41
"20340",NA,40137,"Stephens County, OK","County or equivalent",2005,42560,104,-12,577,589,157,1,156,-41
"20380",NA,NA,"Dunn, NC","Micropolitan Statistical Area",2005,102782,2509,647,1482,835,1952,209,1743,-90
"20380",NA,37085,"Harnett County, NC","County or equivalent",2005,102782,2509,647,1482,835,1952,209,1743,-90
"20420",NA,NA,"Durango, CO","Micropolitan Statistical Area",2005,47802,893,259,505,246,672,30,642,-38
"20420",NA,8067,"La Plata County, CO","County or equivalent",2005,47802,893,259,505,246,672,30,642,-38
"20460",NA,NA,"Durant, OK","Micropolitan Statistical Area",2005,37647,288,59,522,463,263,38,225,-34
"20460",NA,40013,"Bryan County, OK","County or equivalent",2005,37647,288,59,522,463,263,38,225,-34
"20540",NA,NA,"Dyersburg, TN","Micropolitan Statistical Area",2005,37554,285,93,499,406,229,24,205,-37
"20540",NA,47045,"Dyer County, TN","County or equivalent",2005,37554,285,93,499,406,229,24,205,-37
"20580",NA,NA,"Eagle Pass, TX","Micropolitan Statistical Area",2005,50075,506,802,1067,265,-253,252,-505,-43
"20580",NA,48323,"Maverick County, TX","County or equivalent",2005,50075,506,802,1067,265,-253,252,-505,-43
"20620",NA,NA,"East Liverpool-Salem, OH","Micropolitan Statistical Area",2005,109529,-900,-96,1158,1254,-702,15,-717,-102
"20620",NA,39029,"Columbiana County, OH","County or equivalent",2005,109529,-900,-96,1158,1254,-702,15,-717,-102
"20660",NA,NA,"Easton, MD","Micropolitan Statistical Area",2005,35603,440,-80,355,435,550,27,523,-30
"20660",NA,24041,"Talbot County, MD","County or equivalent",2005,35603,440,-80,355,435,550,27,523,-30
"20700",NA,NA,"East Stroudsburg, PA","Micropolitan Statistical Area",2005,160032,3373,434,1663,1229,3077,109,2968,-138
"20700",NA,42089,"Monroe County, PA","County or equivalent",2005,160032,3373,434,1663,1229,3077,109,2968,-138
"20780",NA,NA,"Edwards, CO","Micropolitan Statistical Area",2005,55499,1432,767,879,112,711,585,126,-46
"20780",NA,8037,"Eagle County, CO","County or equivalent",2005,47893,1476,681,766,85,837,499,338,-42
"20780",NA,8065,"Lake County, CO","County or equivalent",2005,7606,-44,86,113,27,-126,86,-212,-4
"20820",NA,NA,"Effingham, IL","Micropolitan Statistical Area",2005,34405,-130,140,453,313,-242,13,-255,-28
"20820",NA,17049,"Effingham County, IL","County or equivalent",2005,34405,-130,140,453,313,-242,13,-255,-28
"20900",NA,NA,"El Campo, TX","Micropolitan Statistical Area",2005,40870,-31,279,697,418,-278,104,-382,-32
"20900",NA,48481,"Wharton County, TX","County or equivalent",2005,40870,-31,279,697,418,-278,104,-382,-32
"20980",NA,NA,"El Dorado, AR","Micropolitan Statistical Area",2005,43614,-545,-13,563,576,-494,25,-519,-38
"20980",NA,5139,"Union County, AR","County or equivalent",2005,43614,-545,-13,563,576,-494,25,-519,-38
"21020",NA,NA,"Elizabeth City, NC","Micropolitan Statistical Area",2005,58901,2053,181,779,598,1917,21,1896,-45
"21020",NA,37029,"Camden County, NC","County or equivalent",2005,8896,548,57,107,50,499,-1,500,-8
"21020",NA,37139,"Pasquotank County, NC","County or equivalent",2005,38206,1282,135,528,393,1176,22,1154,-29
"21020",NA,37143,"Perquimans County, NC","County or equivalent",2005,11799,223,-11,144,155,242,0,242,-8
"21120",NA,NA,"Elk City, OK","Micropolitan Statistical Area",2005,18625,466,76,328,252,405,8,397,-15
"21120",NA,40009,"Beckham County, OK","County or equivalent",2005,18625,466,76,328,252,405,8,397,-15
"21220",NA,NA,"Elko, NV","Micropolitan Statistical Area",2005,45780,832,366,608,242,503,130,373,-37
"21220",NA,32007,"Elko County, NV","County or equivalent",2005,44403,856,375,595,220,517,124,393,-36
"21220",NA,32011,"Eureka County, NV","County or equivalent",2005,1377,-24,-9,13,22,-14,6,-20,-1
"21260",NA,NA,"Ellensburg, WA","Micropolitan Statistical Area",2005,36955,449,103,346,243,382,59,323,-36
"21260",NA,53037,"Kittitas County, WA","County or equivalent",2005,36955,449,103,346,243,382,59,323,-36
"21380",NA,NA,"Emporia, KS","Micropolitan Statistical Area",2005,38758,-160,261,587,326,-397,156,-553,-24
"21380",NA,20017,"Chase County, KS","County or equivalent",2005,2985,-32,14,39,25,-45,3,-48,-1
"21380",NA,20111,"Lyon County, KS","County or equivalent",2005,35773,-128,247,548,301,-352,153,-505,-23
"21420",NA,NA,"Enid, OK","Micropolitan Statistical Area",2005,56961,-221,241,911,670,-415,30,-445,-47
"21420",NA,40047,"Garfield County, OK","County or equivalent",2005,56961,-221,241,911,670,-415,30,-445,-47
"21460",NA,NA,"Enterprise-Ozark, AL","Micropolitan Statistical Area",2005,93368,41,483,1366,883,-366,-27,-339,-76
"21460",NA,1031,"Coffee County, AL","County or equivalent",2005,45133,439,132,589,457,347,12,335,-40
"21460",NA,1045,"Dale County, AL","County or equivalent",2005,48235,-398,351,777,426,-713,-39,-674,-36
"21540",NA,NA,"Escanaba, MI","Micropolitan Statistical Area",2005,37833,-178,-10,405,415,-132,7,-139,-36
"21540",NA,26041,"Delta County, MI","County or equivalent",2005,37833,-178,-10,405,415,-132,7,-139,-36
"21580",NA,NA,"Espanola, NM","Micropolitan Statistical Area",2005,40454,-120,317,667,350,-402,66,-468,-35
"21580",NA,35039,"Rio Arriba County, NM","County or equivalent",2005,40454,-120,317,667,350,-402,66,-468,-35
"21640",NA,NA,"Eufaula, AL-GA","Micropolitan Statistical Area",2005,31964,46,57,398,341,-196,34,-230,185
"21640",NA,1005,"Barbour County, AL","County or equivalent",2005,29372,-30,68,369,301,-285,33,-318,187
"21640",NA,13239,"Quitman County, GA","County or equivalent",2005,2592,76,-11,29,40,89,1,88,-2
"21700",NA,NA,"Eureka-Arcata-Fortuna, CA","Micropolitan Statistical Area",2005,128963,260,340,1570,1230,36,116,-80,-116
"21700",NA,6023,"Humboldt County, CA","County or equivalent",2005,128963,260,340,1570,1230,36,116,-80,-116
"21740",NA,NA,"Evanston, WY","Micropolitan Statistical Area",2005,19429,11,161,275,114,-136,10,-146,-14
"21740",NA,56041,"Uinta County, WY","County or equivalent",2005,19429,11,161,275,114,-136,10,-146,-14
"21860",NA,NA,"Fairmont, MN","Micropolitan Statistical Area",2005,20710,-132,0,233,233,-113,5,-118,-19
"21860",NA,27091,"Martin County, MN","County or equivalent",2005,20710,-132,0,233,233,-113,5,-118,-19
"21900",NA,NA,"Fairmont, WV","Micropolitan Statistical Area",2005,56357,156,-88,596,684,297,9,288,-53
"21900",NA,54049,"Marion County, WV","County or equivalent",2005,56357,156,-88,596,684,297,9,288,-53
"21980",NA,NA,"Fallon, NV","Micropolitan Statistical Area",2005,24433,339,143,359,216,213,13,200,-17
"21980",NA,32001,"Churchill County, NV","County or equivalent",2005,24433,339,143,359,216,213,13,200,-17
"22060",NA,NA,"Faribault-Northfield, MN","Micropolitan Statistical Area",2005,60495,607,361,795,434,302,133,169,-56
"22060",NA,27131,"Rice County, MN","County or equivalent",2005,60495,607,361,795,434,302,133,169,-56
"22100",NA,NA,"Farmington, MO","Micropolitan Statistical Area",2005,61622,1304,30,742,712,1327,15,1312,-53
"22100",NA,29187,"St. Francois County, MO","County or equivalent",2005,61622,1304,30,742,712,1327,15,1312,-53
"22260",NA,NA,"Fergus Falls, MN","Micropolitan Statistical Area",2005,57022,-268,-23,600,623,-190,57,-247,-55
"22260",NA,27111,"Otter Tail County, MN","County or equivalent",2005,57022,-268,-23,600,623,-190,57,-247,-55
"22280",NA,NA,"Fernley, NV","Micropolitan Statistical Area",2005,46591,3756,115,561,446,3668,44,3624,-27
"22280",NA,32019,"Lyon County, NV","County or equivalent",2005,46591,3756,115,561,446,3668,44,3624,-27
"22300",NA,NA,"Findlay, OH","Micropolitan Statistical Area",2005,73260,-18,270,906,636,-221,70,-291,-67
"22300",NA,39063,"Hancock County, OH","County or equivalent",2005,73260,-18,270,906,636,-221,70,-291,-67
"22340",NA,NA,"Fitzgerald, GA","Micropolitan Statistical Area",2005,27300,550,107,444,337,467,42,425,-24
"22340",NA,13017,"Ben Hill County, GA","County or equivalent",2005,17190,135,98,322,224,51,26,25,-14
"22340",NA,13155,"Irwin County, GA","County or equivalent",2005,10110,415,9,122,113,416,16,400,-10
"22580",NA,NA,"Forest City, NC","Micropolitan Statistical Area",2005,62802,-33,-39,742,781,64,23,41,-58
"22580",NA,37161,"Rutherford County, NC","County or equivalent",2005,62802,-33,-39,742,781,64,23,41,-58
"22620",NA,NA,"Forrest City, AR","Micropolitan Statistical Area",2005,27457,-481,117,422,305,-578,0,-578,-20
"22620",NA,5123,"St. Francis County, AR","County or equivalent",2005,27457,-481,117,422,305,-578,0,-578,-20
"22700",NA,NA,"Fort Dodge, IA","Micropolitan Statistical Area",2005,38579,-353,14,454,440,-331,23,-354,-36
"22700",NA,19187,"Webster County, IA","County or equivalent",2005,38579,-353,14,454,440,-331,23,-354,-36
"22780",NA,NA,"Fort Leonard Wood, MO","Micropolitan Statistical Area",2005,43865,-189,411,672,261,-566,-62,-504,-34
"22780",NA,29169,"Pulaski County, MO","County or equivalent",2005,43865,-189,411,672,261,-566,-62,-504,-34
"22800",NA,NA,"Fort Madison-Keokuk, IA-MO","Micropolitan Statistical Area",2005,43338,-288,-37,497,534,-212,16,-228,-39
"22800",NA,19111,"Lee County, IA","County or equivalent",2005,36125,-269,-43,409,452,-193,16,-209,-33
"22800",NA,29045,"Clark County, MO","County or equivalent",2005,7213,-19,6,88,82,-19,0,-19,-6
"22820",NA,NA,"Fort Morgan, CO","Micropolitan Statistical Area",2005,27673,0,198,441,243,-174,155,-329,-24
"22820",NA,8087,"Morgan County, CO","County or equivalent",2005,27673,0,198,441,243,-174,155,-329,-24
"22840",NA,NA,"Fort Payne, AL","Micropolitan Statistical Area",2005,66657,264,296,992,696,29,147,-118,-61
"22840",NA,1049,"DeKalb County, AL","County or equivalent",2005,66657,264,296,992,696,29,147,-118,-61
"22860",NA,NA,"Fort Polk South, LA","Micropolitan Statistical Area",2005,50230,37,630,969,339,-549,-65,-484,-44
"22860",NA,22115,"Vernon Parish, LA","County or equivalent",2005,50230,37,630,969,339,-549,-65,-484,-44
"22980",NA,NA,"Fort Valley, GA","Micropolitan Statistical Area",2005,24478,-103,88,319,231,-170,54,-224,-21
"22980",NA,13225,"Peach County, GA","County or equivalent",2005,24478,-103,88,319,231,-170,54,-224,-21
"23140",NA,NA,"Frankfort, IN","Micropolitan Statistical Area",2005,33692,-28,148,505,357,-147,139,-286,-29
"23140",NA,18023,"Clinton County, IN","County or equivalent",2005,33692,-28,148,505,357,-147,139,-286,-29
"23180",NA,NA,"Frankfort, KY","Micropolitan Statistical Area",2005,68589,353,200,849,649,211,58,153,-58
"23180",NA,21005,"Anderson County, KY","County or equivalent",2005,20209,309,64,228,164,263,4,259,-18
"23180",NA,21073,"Franklin County, KY","County or equivalent",2005,48380,44,136,621,485,-52,54,-106,-40
"23240",NA,NA,"Fredericksburg, TX","Micropolitan Statistical Area",2005,22668,341,-78,242,320,439,30,409,-20
"23240",NA,48171,"Gillespie County, TX","County or equivalent",2005,22668,341,-78,242,320,439,30,409,-20
"23300",NA,NA,"Freeport, IL","Micropolitan Statistical Area",2005,47330,-516,-104,534,638,-369,54,-423,-43
"23300",NA,17177,"Stephenson County, IL","County or equivalent",2005,47330,-516,-104,534,638,-369,54,-423,-43
"23340",NA,NA,"Fremont, NE","Micropolitan Statistical Area",2005,35834,48,117,507,390,-40,26,-66,-29
"23340",NA,31053,"Dodge County, NE","County or equivalent",2005,35834,48,117,507,390,-40,26,-66,-29
"23380",NA,NA,"Fremont, OH","Micropolitan Statistical Area",2005,61233,-198,180,802,622,-322,12,-334,-56
"23380",NA,39143,"Sandusky County, OH","County or equivalent",2005,61233,-198,180,802,622,-322,12,-334,-56
"23500",NA,NA,"Gaffney, SC","Micropolitan Statistical Area",2005,53496,86,30,648,618,103,25,78,-47
"23500",NA,45021,"Cherokee County, SC","County or equivalent",2005,53496,86,30,648,618,103,25,78,-47
"23620",NA,NA,"Gainesville, TX","Micropolitan Statistical Area",2005,38249,335,202,566,364,165,106,59,-32
"23620",NA,48097,"Cooke County, TX","County or equivalent",2005,38249,335,202,566,364,165,106,59,-32
"23660",NA,NA,"Galesburg, IL","Micropolitan Statistical Area",2005,70457,-611,-106,798,904,-440,18,-458,-65
"23660",NA,17095,"Knox County, IL","County or equivalent",2005,52752,-556,-107,590,697,-399,13,-412,-50
"23660",NA,17187,"Warren County, IL","County or equivalent",2005,17705,-55,1,208,207,-41,5,-46,-15
"23700",NA,NA,"Gallup, NM","Micropolitan Statistical Area",2005,70541,-879,867,1335,468,-1694,37,-1731,-52
"23700",NA,35031,"McKinley County, NM","County or equivalent",2005,70541,-879,867,1335,468,-1694,37,-1731,-52
"23780",NA,NA,"Garden City, KS","Micropolitan Statistical Area",2005,40502,-14,614,821,207,-989,348,-1337,361
"23780",NA,20055,"Finney County, KS","County or equivalent",2005,40502,-14,614,821,207,-989,348,-1337,361
"23820",NA,NA,"Gardnerville Ranchos, NV","Micropolitan Statistical Area",2005,45679,130,-42,341,383,200,39,161,-28
"23820",NA,32005,"Douglas County, NV","County or equivalent",2005,45679,130,-42,341,383,200,39,161,-28
"23860",NA,NA,"Georgetown, SC","Micropolitan Statistical Area",2005,59464,323,84,725,641,281,45,236,-42
"23860",NA,45043,"Georgetown County, SC","County or equivalent",2005,59464,323,84,725,641,281,45,236,-42
"23900",NA,NA,"Gettysburg, PA","Micropolitan Statistical Area",2005,98778,1287,181,1109,928,1192,114,1078,-86
"23900",NA,42001,"Adams County, PA","County or equivalent",2005,98778,1287,181,1109,928,1192,114,1078,-86
"23940",NA,NA,"Gillette, WY","Micropolitan Statistical Area",2005,37021,797,466,624,158,364,15,349,-33
"23940",NA,56005,"Campbell County, WY","County or equivalent",2005,37021,797,466,624,158,364,15,349,-33
"23980",NA,NA,"Glasgow, KY","Micropolitan Statistical Area",2005,50081,727,161,712,551,602,23,579,-36
"23980",NA,21009,"Barren County, KY","County or equivalent",2005,39999,646,128,562,434,546,22,524,-28
"23980",NA,21169,"Metcalfe County, KY","County or equivalent",2005,10082,81,33,150,117,56,1,55,-8
"24100",NA,NA,"Gloversville, NY","Micropolitan Statistical Area",2005,54958,-9,-68,554,622,114,23,91,-55
"24100",NA,36035,"Fulton County, NY","County or equivalent",2005,54958,-9,-68,554,622,114,23,91,-55
"24180",NA,NA,"Granbury, TX","Micropolitan Statistical Area",2005,54220,1188,8,633,625,1225,54,1171,-45
"24180",NA,48221,"Hood County, TX","County or equivalent",2005,46802,1082,-15,546,561,1138,44,1094,-41
"24180",NA,48425,"Somervell County, TX","County or equivalent",2005,7418,106,23,87,64,87,10,77,-4
"24260",NA,NA,"Grand Island, NE","Micropolitan Statistical Area",2005,68626,-67,481,1115,634,-492,220,-712,-56
"24260",NA,31079,"Hall County, NE","County or equivalent",2005,54277,84,451,934,483,-321,216,-537,-46
"24260",NA,31093,"Howard County, NE","County or equivalent",2005,6527,-20,34,94,60,-50,1,-51,-4
"24260",NA,31121,"Merrick County, NE","County or equivalent",2005,7822,-131,-4,87,91,-121,3,-124,-6
"24380",NA,NA,"Grants, NM","Micropolitan Statistical Area",2005,27157,-4,213,420,207,-195,10,-205,-22
"24380",NA,35006,"Cibola County, NM","County or equivalent",2005,27157,-4,213,420,207,-195,10,-205,-22
"24420",NA,NA,"Grants Pass, OR","Micropolitan Statistical Area",2005,79877,769,-202,812,1014,1040,18,1022,-69
"24420",NA,41033,"Josephine County, OR","County or equivalent",2005,79877,769,-202,812,1014,1040,18,1022,-69
"24460",NA,NA,"Great Bend, KS","Micropolitan Statistical Area",2005,27865,140,67,356,289,17,63,-46,56
"24460",NA,20009,"Barton County, KS","County or equivalent",2005,27865,140,67,356,289,17,63,-46,56
"24620",NA,NA,"Greeneville, TN","Micropolitan Statistical Area",2005,64795,692,26,751,725,730,39,691,-64
"24620",NA,47059,"Greene County, TN","County or equivalent",2005,64795,692,26,751,725,730,39,691,-64
"24700",NA,NA,"Greensburg, IN","Micropolitan Statistical Area",2005,25031,99,82,353,271,36,29,7,-19
"24700",NA,18031,"Decatur County, IN","County or equivalent",2005,25031,99,82,353,271,36,29,7,-19
"24740",NA,NA,"Greenville, MS","Micropolitan Statistical Area",2005,57574,-633,290,935,645,-873,22,-895,-50
"24740",NA,28151,"Washington County, MS","County or equivalent",2005,57574,-633,290,935,645,-873,22,-895,-50
"24820",NA,NA,"Greenville, OH","Micropolitan Statistical Area",2005,52639,-169,144,690,546,-265,3,-268,-48
"24820",NA,39037,"Darke County, OH","County or equivalent",2005,52639,-169,144,690,546,-265,3,-268,-48
"24900",NA,NA,"Greenwood, MS","Micropolitan Statistical Area",2005,45556,-614,130,650,520,-706,16,-722,-38
"24900",NA,28015,"Carroll County, MS","County or equivalent",2005,10253,-126,-23,96,119,-94,4,-98,-9
"24900",NA,28083,"Leflore County, MS","County or equivalent",2005,35303,-488,153,554,401,-612,12,-624,-29
"24940",NA,NA,"Greenwood, SC","Micropolitan Statistical Area",2005,67595,407,205,877,672,261,132,129,-59
"24940",NA,45047,"Greenwood County, SC","County or equivalent",2005,67595,407,205,877,672,261,132,129,-59
"24980",NA,NA,"Grenada, MS","Micropolitan Statistical Area",2005,22723,44,27,322,295,38,12,26,-21
"24980",NA,28043,"Grenada County, MS","County or equivalent",2005,22723,44,27,322,295,38,12,26,-21
"25100",NA,NA,"Guymon, OK","Micropolitan Statistical Area",2005,19829,-228,244,386,142,-461,194,-655,-11
"25100",NA,40139,"Texas County, OK","County or equivalent",2005,19829,-228,244,386,142,-461,194,-655,-11
"25220",NA,NA,"Hammond, LA","Micropolitan Statistical Area",2005,106182,1468,563,1636,1073,994,23,971,-89
"25220",NA,22105,"Tangipahoa Parish, LA","County or equivalent",2005,106182,1468,563,1636,1073,994,23,971,-89
"25300",NA,NA,"Hannibal, MO","Micropolitan Statistical Area",2005,37824,211,65,493,428,181,6,175,-35
"25300",NA,29127,"Marion County, MO","County or equivalent",2005,28126,68,29,379,350,65,4,61,-26
"25300",NA,29173,"Ralls County, MO","County or equivalent",2005,9698,143,36,114,78,116,2,114,-9
"25340",NA,NA,"Harriman, TN","Micropolitan Statistical Area",2005,52569,-64,-184,501,685,166,19,147,-46
"25340",NA,47145,"Roane County, TN","County or equivalent",2005,52569,-64,-184,501,685,166,19,147,-46
"25380",NA,NA,"Harrisburg, IL","Micropolitan Statistical Area",2005,25969,-164,-64,317,381,-76,7,-83,-24
"25380",NA,17165,"Saline County, IL","County or equivalent",2005,25969,-164,-64,317,381,-76,7,-83,-24
"25460",NA,NA,"Harrison, AR","Micropolitan Statistical Area",2005,43764,501,44,519,475,496,7,489,-39
"25460",NA,5009,"Boone County, AR","County or equivalent",2005,35385,557,49,437,388,541,7,534,-33
"25460",NA,5101,"Newton County, AR","County or equivalent",2005,8379,-56,-5,82,87,-45,0,-45,-6
"25580",NA,NA,"Hastings, NE","Micropolitan Statistical Area",2005,39437,133,135,527,392,6,90,-84,-8
"25580",NA,31001,"Adams County, NE","County or equivalent",2005,32948,295,135,452,317,165,87,78,-5
"25580",NA,31035,"Clay County, NE","County or equivalent",2005,6489,-162,0,75,75,-159,3,-162,-3
"25660",NA,NA,"Havre, MT","Micropolitan Statistical Area",2005,16211,-4,122,276,154,-112,0,-112,-14
"25660",NA,30041,"Hill County, MT","County or equivalent",2005,16211,-4,122,276,154,-112,0,-112,-14
"25700",NA,NA,"Hays, KS","Micropolitan Statistical Area",2005,27105,-94,83,323,240,-157,25,-182,-20
"25700",NA,20051,"Ellis County, KS","County or equivalent",2005,27105,-94,83,323,240,-157,25,-182,-20
"25720",NA,NA,"Heber, UT","Micropolitan Statistical Area",2005,18747,904,300,390,90,612,31,581,-8
"25720",NA,49051,"Wasatch County, UT","County or equivalent",2005,18747,904,300,390,90,612,31,581,-8
"25740",NA,NA,"Helena, MT","Micropolitan Statistical Area",2005,68874,593,211,788,577,444,20,424,-62
"25740",NA,30043,"Jefferson County, MT","County or equivalent",2005,10779,205,10,97,87,206,0,206,-11
"25740",NA,30049,"Lewis and Clark County, MT","County or equivalent",2005,58095,388,201,691,490,238,20,218,-51
"25760",NA,NA,"Helena-West Helena, AR","Micropolitan Statistical Area",2005,23270,-354,113,422,309,-453,6,-459,-14
"25760",NA,5107,"Phillips County, AR","County or equivalent",2005,23270,-354,113,422,309,-453,6,-459,-14
"25780",NA,NA,"Henderson, NC","Micropolitan Statistical Area",2005,42860,-185,205,694,489,-354,96,-450,-36
"25780",NA,37181,"Vance County, NC","County or equivalent",2005,42860,-185,205,694,489,-354,96,-450,-36
"25820",NA,NA,"Hereford, TX","Micropolitan Statistical Area",2005,18290,-16,203,358,155,-204,51,-255,-15
"25820",NA,48117,"Deaf Smith County, TX","County or equivalent",2005,18290,-16,203,358,155,-204,51,-255,-15
"25900",NA,NA,"Hilo, HI","Micropolitan Statistical Area",2005,164462,4597,1095,2274,1179,3653,362,3291,-151
"25900",NA,15001,"Hawaii County, HI","County or equivalent",2005,164462,4597,1095,2274,1179,3653,362,3291,-151
"25940",NA,NA,"Hilton Head Island-Beaufort, SC","Micropolitan Statistical Area",2005,160091,4589,1144,2422,1278,3559,442,3117,-114
"25940",NA,45013,"Beaufort County, SC","County or equivalent",2005,138969,4374,993,2083,1090,3477,363,3114,-96
"25940",NA,45053,"Jasper County, SC","County or equivalent",2005,21122,215,151,339,188,82,79,3,-18
"26020",NA,NA,"Hobbs, NM","Micropolitan Statistical Area",2005,55990,382,478,953,475,-44,76,-120,-52
"26020",NA,35025,"Lea County, NM","County or equivalent",2005,55990,382,478,953,475,-44,76,-120,-52
"26140",NA,NA,"Homosassa Springs, FL","Micropolitan Statistical Area",2005,132889,3727,-1194,932,2126,5052,56,4996,-131
"26140",NA,12017,"Citrus County, FL","County or equivalent",2005,132889,3727,-1194,932,2126,5052,56,4996,-131
"26220",NA,NA,"Hood River, OR","Micropolitan Statistical Area",2005,20984,172,137,311,174,55,93,-38,-20
"26220",NA,41027,"Hood River County, OR","County or equivalent",2005,20984,172,137,311,174,55,93,-38,-20
"26260",NA,NA,"Hope, AR","Micropolitan Statistical Area",2005,32523,-97,101,451,350,-170,107,-277,-28
"26260",NA,5057,"Hempstead County, AR","County or equivalent",2005,22999,-38,79,326,247,-96,97,-193,-21
"26260",NA,5099,"Nevada County, AR","County or equivalent",2005,9524,-59,22,125,103,-74,10,-84,-7
"26340",NA,NA,"Houghton, MI","Micropolitan Statistical Area",2005,37641,-159,-26,409,435,-97,48,-145,-36
"26340",NA,26061,"Houghton County, MI","County or equivalent",2005,35505,-124,-7,393,400,-83,47,-130,-34
"26340",NA,26083,"Keweenaw County, MI","County or equivalent",2005,2136,-35,-19,16,35,-14,1,-15,-2
"26460",NA,NA,"Hudson, NY","Micropolitan Statistical Area",2005,62880,-82,-86,607,693,66,53,13,-62
"26460",NA,36021,"Columbia County, NY","County or equivalent",2005,62880,-82,-86,607,693,66,53,13,-62
"26480",NA,NA,"Humboldt, TN","Micropolitan Statistical Area",2005,47851,65,-39,600,639,150,16,134,-46
"26480",NA,47053,"Gibson County, TN","County or equivalent",2005,47851,65,-39,600,639,150,16,134,-46
"26500",NA,NA,"Huntingdon, PA","Micropolitan Statistical Area",2005,45555,-68,9,452,443,-35,0,-35,-42
"26500",NA,42061,"Huntingdon County, PA","County or equivalent",2005,45555,-68,9,452,443,-35,0,-35,-42
"26540",NA,NA,"Huntington, IN","Micropolitan Statistical Area",2005,37979,-69,71,503,432,-103,8,-111,-37
"26540",NA,18069,"Huntington County, IN","County or equivalent",2005,37979,-69,71,503,432,-103,8,-111,-37
"26660",NA,NA,"Huntsville, TX","Micropolitan Statistical Area",2005,64335,888,237,627,390,710,87,623,-59
"26660",NA,48471,"Walker County, TX","County or equivalent",2005,64335,888,237,627,390,710,87,623,-59
"26700",NA,NA,"Huron, SD","Micropolitan Statistical Area",2005,15743,-170,-38,178,216,-118,4,-122,-14
"26700",NA,46005,"Beadle County, SD","County or equivalent",2005,15743,-170,-38,178,216,-118,4,-122,-14
"26740",NA,NA,"Hutchinson, KS","Micropolitan Statistical Area",2005,63261,-105,176,842,666,-220,37,-257,-61
"26740",NA,20155,"Reno County, KS","County or equivalent",2005,63261,-105,176,842,666,-220,37,-257,-61
"26780",NA,NA,"Hutchinson, MN","Micropolitan Statistical Area",2005,36308,333,240,544,304,125,23,102,-32
"26780",NA,27085,"McLeod County, MN","County or equivalent",2005,36308,333,240,544,304,125,23,102,-32
"26860",NA,NA,"Indiana, PA","Micropolitan Statistical Area",2005,87966,-465,-41,829,870,-347,40,-387,-77
"26860",NA,42063,"Indiana County, PA","County or equivalent",2005,87966,-465,-41,829,870,-347,40,-387,-77
"26940",NA,NA,"Indianola, MS","Micropolitan Statistical Area",2005,31393,-691,150,478,328,-818,13,-831,-23
"26940",NA,28133,"Sunflower County, MS","County or equivalent",2005,31393,-691,150,478,328,-818,13,-831,-23
"27020",NA,NA,"Iron Mountain, MI-WI","Micropolitan Statistical Area",2005,32079,-209,-89,315,404,-92,4,-96,-28
"27020",NA,26043,"Dickinson County, MI","County or equivalent",2005,27217,-138,-59,280,339,-55,3,-58,-24
"27020",NA,55037,"Florence County, WI","County or equivalent",2005,4862,-71,-30,35,65,-37,1,-38,-4
"27220",NA,NA,"Jackson, WY-ID","Micropolitan Statistical Area",2005,26660,329,302,396,94,50,112,-62,-23
"27220",NA,16081,"Teton County, ID","County or equivalent",2005,7396,249,106,133,27,149,36,113,-6
"27220",NA,56039,"Teton County, WY","County or equivalent",2005,19264,80,196,263,67,-99,76,-175,-17
"27300",NA,NA,"Jacksonville, IL","Micropolitan Statistical Area",2005,41020,-345,9,457,448,-317,13,-330,-37
"27300",NA,17137,"Morgan County, IL","County or equivalent",2005,35684,-311,11,402,391,-289,12,-301,-33
"27300",NA,17171,"Scott County, IL","County or equivalent",2005,5336,-34,-2,55,57,-28,1,-29,-4
"27380",NA,NA,"Jacksonville, TX","Micropolitan Statistical Area",2005,47602,201,260,776,516,-16,162,-178,-43
"27380",NA,48073,"Cherokee County, TX","County or equivalent",2005,47602,201,260,776,516,-16,162,-178,-43
"27420",NA,NA,"Jamestown, ND","Micropolitan Statistical Area",2005,20779,-106,-4,227,231,-83,4,-87,-19
"27420",NA,38093,"Stutsman County, ND","County or equivalent",2005,20779,-106,-4,227,231,-83,4,-87,-19
"27460",NA,NA,"Jamestown-Dunkirk-Fredonia, NY","Micropolitan Statistical Area",2005,135092,-1246,-23,1426,1449,-1106,57,-1163,-117
"27460",NA,36013,"Chautauqua County, NY","County or equivalent",2005,135092,-1246,-23,1426,1449,-1106,57,-1163,-117
"27540",NA,NA,"Jasper, IN","Micropolitan Statistical Area",2005,53248,-5,242,714,472,-203,46,-249,-44
"27540",NA,18037,"Dubois County, IN","County or equivalent",2005,40710,227,231,561,330,33,45,-12,-37
"27540",NA,18125,"Pike County, IN","County or equivalent",2005,12538,-232,11,153,142,-236,1,-237,-7
"27660",NA,NA,"Jennings, LA","Micropolitan Statistical Area",2005,30901,76,101,456,355,3,3,0,-28
"27660",NA,22053,"Jefferson Davis Parish, LA","County or equivalent",2005,30901,76,101,456,355,3,3,0,-28
"27700",NA,NA,"Jesup, GA","Micropolitan Statistical Area",2005,28273,276,136,391,255,169,17,152,-29
"27700",NA,13305,"Wayne County, GA","County or equivalent",2005,28273,276,136,391,255,169,17,152,-29
"27940",NA,NA,"Juneau, AK","Micropolitan Statistical Area",2005,30843,-114,244,383,139,-333,35,-368,-25
"27940",NA,2110,"Juneau City and Borough, AK","County or equivalent",2005,30843,-114,244,383,139,-333,35,-368,-25
"27980",NA,NA,"Kahului-Wailuku, HI","Micropolitan Statistical Area",2005,138625,1893,1030,1914,884,995,461,534,-132
"27980",NA,15009,"Maui County, HI","County or equivalent",2005,138625,1893,1030,1914,884,995,461,534,-132
"28060",NA,NA,"Kalispell, MT","Micropolitan Statistical Area",2005,82530,1904,357,1083,726,1627,30,1597,-80
"28060",NA,30029,"Flathead County, MT","County or equivalent",2005,82530,1904,357,1083,726,1627,30,1597,-80
"28180",NA,NA,"Kapaa, HI","Micropolitan Statistical Area",2005,61589,652,332,780,448,374,116,258,-54
"28180",NA,15007,"Kauai County, HI","County or equivalent",2005,61589,652,332,780,448,374,116,258,-54
"28260",NA,NA,"Kearney, NE","Micropolitan Statistical Area",2005,50682,248,349,752,403,-60,31,-91,-41
"28260",NA,31019,"Buffalo County, NE","County or equivalent",2005,44029,336,332,666,334,38,32,6,-34
"28260",NA,31099,"Kearney County, NE","County or equivalent",2005,6653,-88,17,86,69,-98,-1,-97,-7
"28300",NA,NA,"Keene, NH","Micropolitan Statistical Area",2005,76826,281,175,819,644,179,27,152,-73
"28300",NA,33005,"Cheshire County, NH","County or equivalent",2005,76826,281,175,819,644,179,27,152,-73
"28340",NA,NA,"Kendallville, IN","Micropolitan Statistical Area",2005,47211,297,300,699,399,40,130,-90,-43
"28340",NA,18113,"Noble County, IN","County or equivalent",2005,47211,297,300,699,399,40,130,-90,-43
"28380",NA,NA,"Kennett, MO","Micropolitan Statistical Area",2005,32038,49,24,466,442,56,16,40,-31
"28380",NA,29069,"Dunklin County, MO","County or equivalent",2005,32038,49,24,466,442,56,16,40,-31
"28500",NA,NA,"Kerrville, TX","Micropolitan Statistical Area",2005,46143,595,-126,523,649,753,72,681,-32
"28500",NA,48265,"Kerr County, TX","County or equivalent",2005,46143,595,-126,523,649,753,72,681,-32
"28540",NA,NA,"Ketchikan, AK","Micropolitan Statistical Area",2005,13173,32,118,190,72,-74,12,-86,-12
"28540",NA,2130,"Ketchikan Gateway Borough, AK","County or equivalent",2005,13173,32,118,190,72,-74,12,-86,-12
"28580",NA,NA,"Key West, FL","Micropolitan Statistical Area",2005,75750,-1841,24,748,724,-1835,321,-2156,-30
"28580",NA,12087,"Monroe County, FL","County or equivalent",2005,75750,-1841,24,748,724,-1835,321,-2156,-30
"28620",NA,NA,"Kill Devil Hills, NC","Micropolitan Statistical Area",2005,33663,191,219,487,268,-14,31,-45,-14
"28620",NA,37055,"Dare County, NC","County or equivalent",2005,33663,191,219,487,268,-14,31,-45,-14
"28780",NA,NA,"Kingsville, TX","Micropolitan Statistical Area",2005,31119,-198,231,490,259,-406,48,-454,-23
"28780",NA,48261,"Kenedy County, TX","County or equivalent",2005,433,10,1,5,4,10,1,9,-1
"28780",NA,48273,"Kleberg County, TX","County or equivalent",2005,30686,-208,230,485,255,-416,47,-463,-22
"28820",NA,NA,"Kinston, NC","Micropolitan Statistical Area",2005,57330,-230,89,781,692,-264,66,-330,-55
"28820",NA,37107,"Lenoir County, NC","County or equivalent",2005,57330,-230,89,781,692,-264,66,-330,-55
"28860",NA,NA,"Kirksville, MO","Micropolitan Statistical Area",2005,28652,-269,32,324,292,-278,25,-303,-23
"28860",NA,29001,"Adair County, MO","County or equivalent",2005,24548,-202,46,278,232,-228,23,-251,-20
"28860",NA,29197,"Schuyler County, MO","County or equivalent",2005,4104,-67,-14,46,60,-50,2,-52,-3
"28900",NA,NA,"Klamath Falls, OR","Micropolitan Statistical Area",2005,65365,640,75,811,736,625,48,577,-60
"28900",NA,41035,"Klamath County, OR","County or equivalent",2005,65365,640,75,811,736,625,48,577,-60
"28980",NA,NA,"Kodiak, AK","Micropolitan Statistical Area",2005,12964,-150,165,209,44,-306,59,-365,-9
"28980",NA,2150,"Kodiak Island Borough, AK","County or equivalent",2005,12964,-150,165,209,44,-306,59,-365,-9
"29060",NA,NA,"Laconia, NH","Micropolitan Statistical Area",2005,60975,215,-25,550,575,299,40,259,-59
"29060",NA,33001,"Belknap County, NH","County or equivalent",2005,60975,215,-25,550,575,299,40,259,-59
"29220",NA,NA,"La Follette, TN","Micropolitan Statistical Area",2005,40406,23,-2,474,476,64,24,40,-39
"29220",NA,47013,"Campbell County, TN","County or equivalent",2005,40406,23,-2,474,476,64,24,40,-39
"29260",NA,NA,"La Grande, OR","Micropolitan Statistical Area",2005,24449,112,66,320,254,68,26,42,-22
"29260",NA,41061,"Union County, OR","County or equivalent",2005,24449,112,66,320,254,68,26,42,-22
"29300",NA,NA,"LaGrange, GA","Micropolitan Statistical Area",2005,62203,1026,326,957,631,754,65,689,-54
"29300",NA,13285,"Troup County, GA","County or equivalent",2005,62203,1026,326,957,631,754,65,689,-54
"29380",NA,NA,"Lake City, FL","Micropolitan Statistical Area",2005,63888,2454,236,850,614,2260,28,2232,-42
"29380",NA,12023,"Columbia County, FL","County or equivalent",2005,63888,2454,236,850,614,2260,28,2232,-42
"29500",NA,NA,"Lamesa, TX","Micropolitan Statistical Area",2005,14033,20,45,193,148,-13,20,-33,-12
"29500",NA,48115,"Dawson County, TX","County or equivalent",2005,14033,20,45,193,148,-13,20,-33,-12
"29580",NA,NA,"Lancaster, SC","Micropolitan Statistical Area",2005,69766,1592,250,806,556,-67,53,-120,1409
"29580",NA,45057,"Lancaster County, SC","County or equivalent",2005,69766,1592,250,806,556,-67,53,-120,1409
"29660",NA,NA,"Laramie, WY","Micropolitan Statistical Area",2005,32507,-174,225,404,179,-376,57,-433,-23
"29660",NA,56001,"Albany County, WY","County or equivalent",2005,32507,-174,225,404,179,-376,57,-433,-23
"29780",NA,NA,"Las Vegas, NM","Micropolitan Statistical Area",2005,29053,-44,106,384,278,-126,8,-134,-24
"29780",NA,35047,"San Miguel County, NM","County or equivalent",2005,29053,-44,106,384,278,-126,8,-134,-24
"29860",NA,NA,"Laurel, MS","Micropolitan Statistical Area",2005,83542,294,410,1290,880,-39,126,-165,-77
"29860",NA,28061,"Jasper County, MS","County or equivalent",2005,17831,-194,72,229,157,-251,3,-254,-15
"29860",NA,28067,"Jones County, MS","County or equivalent",2005,65711,488,338,1061,723,212,123,89,-62
"29900",NA,NA,"Laurinburg, NC","Micropolitan Statistical Area",2005,36412,-72,123,493,370,-163,20,-183,-32
"29900",NA,37165,"Scotland County, NC","County or equivalent",2005,36412,-72,123,493,370,-163,20,-183,-32
"29980",NA,NA,"Lawrenceburg, TN","Micropolitan Statistical Area",2005,40655,160,55,540,485,144,12,132,-39
"29980",NA,47099,"Lawrence County, TN","County or equivalent",2005,40655,160,55,540,485,144,12,132,-39
"30060",NA,NA,"Lebanon, MO","Micropolitan Statistical Area",2005,34212,713,144,510,366,601,5,596,-32
"30060",NA,29105,"Laclede County, MO","County or equivalent",2005,34212,713,144,510,366,601,5,596,-32
"30100",NA,NA,"Lebanon, NH-VT","Micropolitan Statistical Area",2005,170926,382,65,1609,1544,455,114,341,-138
"30100",NA,33009,"Grafton County, NH","County or equivalent",2005,84671,635,46,795,749,655,86,569,-66
"30100",NA,50017,"Orange County, VT","County or equivalent",2005,28955,11,65,278,213,-29,0,-29,-25
"30100",NA,50027,"Windsor County, VT","County or equivalent",2005,57300,-264,-46,536,582,-171,28,-199,-47
"30220",NA,NA,"Levelland, TX","Micropolitan Statistical Area",2005,22608,64,152,353,201,-72,21,-93,-16
"30220",NA,48219,"Hockley County, TX","County or equivalent",2005,22608,64,152,353,201,-72,21,-93,-16
"30260",NA,NA,"Lewisburg, PA","Micropolitan Statistical Area",2005,42762,222,8,396,388,251,14,237,-37
"30260",NA,42119,"Union County, PA","County or equivalent",2005,42762,222,8,396,388,251,14,237,-37
"30280",NA,NA,"Lewisburg, TN","Micropolitan Statistical Area",2005,28022,295,73,356,283,245,31,214,-23
"30280",NA,47117,"Marshall County, TN","County or equivalent",2005,28022,295,73,356,283,245,31,214,-23
"30380",NA,NA,"Lewistown, PA","Micropolitan Statistical Area",2005,45970,-28,4,573,569,12,3,9,-44
"30380",NA,42087,"Mifflin County, PA","County or equivalent",2005,45970,-28,4,573,569,12,3,9,-44
"30420",NA,NA,"Lexington, NE","Micropolitan Statistical Area",2005,26298,-10,250,496,246,-239,166,-405,-21
"30420",NA,31047,"Dawson County, NE","County or equivalent",2005,24294,13,250,466,216,-217,165,-382,-20
"30420",NA,31073,"Gosper County, NE","County or equivalent",2005,2004,-23,0,30,30,-22,1,-23,-1
"30500",NA,NA,"Lexington Park, MD","Micropolitan Statistical Area",2005,96885,2001,787,1436,649,1298,6,1292,-84
"30500",NA,24037,"St. Mary's County, MD","County or equivalent",2005,96885,2001,787,1436,649,1298,6,1292,-84
"30580",NA,NA,"Liberal, KS","Micropolitan Statistical Area",2005,22561,-135,393,540,147,-514,288,-802,-14
"30580",NA,20175,"Seward County, KS","County or equivalent",2005,22561,-135,393,540,147,-514,288,-802,-14
"30660",NA,NA,"Lincoln, IL","Micropolitan Statistical Area",2005,30213,-239,-19,333,352,-194,7,-201,-26
"30660",NA,17107,"Logan County, IL","County or equivalent",2005,30213,-239,-19,333,352,-194,7,-201,-26
"30740",NA,NA,"Lincolnton, NC","Micropolitan Statistical Area",2005,68999,1449,172,801,629,1338,229,1109,-61
"30740",NA,37109,"Lincoln County, NC","County or equivalent",2005,68999,1449,172,801,629,1338,229,1109,-61
"30820",NA,NA,"Lock Haven, PA","Micropolitan Statistical Area",2005,37186,-56,-7,433,440,-13,10,-23,-36
"30820",NA,42035,"Clinton County, PA","County or equivalent",2005,37186,-56,-7,433,440,-13,10,-23,-36
"30900",NA,NA,"Logansport, IN","Micropolitan Statistical Area",2005,39643,-284,170,545,375,-422,77,-499,-32
"30900",NA,18017,"Cass County, IN","County or equivalent",2005,39643,-284,170,545,375,-422,77,-499,-32
"30940",NA,NA,"London, KY","Micropolitan Statistical Area",2005,56025,560,232,742,510,380,25,355,-52
"30940",NA,21125,"Laurel County, KY","County or equivalent",2005,56025,560,232,742,510,380,25,355,-52
"31060",NA,NA,"Los Alamos, NM","Micropolitan Statistical Area",2005,18543,12,95,192,97,-68,56,-124,-15
"31060",NA,35028,"Los Alamos County, NM","County or equivalent",2005,18543,12,95,192,97,-68,56,-124,-15
"31260",NA,NA,"Lufkin, TX","Micropolitan Statistical Area",2005,81065,206,502,1269,767,-224,141,-365,-72
"31260",NA,48005,"Angelina County, TX","County or equivalent",2005,81065,206,502,1269,767,-224,141,-365,-72
"31300",NA,NA,"Lumberton, NC","Micropolitan Statistical Area",2005,125984,1372,999,2129,1130,491,392,99,-118
"31300",NA,37155,"Robeson County, NC","County or equivalent",2005,125984,1372,999,2129,1130,491,392,99,-118
"31380",NA,NA,"Macomb, IL","Micropolitan Statistical Area",2005,32897,83,-6,296,302,122,61,61,-33
"31380",NA,17109,"McDonough County, IL","County or equivalent",2005,32897,83,-6,296,302,122,61,61,-33
"31500",NA,NA,"Madison, IN","Micropolitan Statistical Area",2005,32275,230,56,387,331,199,6,193,-25
"31500",NA,18077,"Jefferson County, IN","County or equivalent",2005,32275,230,56,387,331,199,6,193,-25
"31580",NA,NA,"Madisonville, KY","Micropolitan Statistical Area",2005,46213,-210,14,585,571,-182,10,-192,-42
"31580",NA,21107,"Hopkins County, KY","County or equivalent",2005,46213,-210,14,585,571,-182,10,-192,-42
"31620",NA,NA,"Magnolia, AR","Micropolitan Statistical Area",2005,24581,-218,38,343,305,-236,10,-246,-20
"31620",NA,5027,"Columbia County, AR","County or equivalent",2005,24581,-218,38,343,305,-236,10,-246,-20
"31660",NA,NA,"Malone, NY","Micropolitan Statistical Area",2005,50330,-115,62,491,429,-131,6,-137,-46
"31660",NA,36033,"Franklin County, NY","County or equivalent",2005,50330,-115,62,491,429,-131,6,-137,-46
"31740",NA,NA,"Manhattan, KS","Micropolitan Statistical Area",2005,114410,1581,1031,1670,639,-772,130,-902,1322
"31740",NA,20061,"Geary County, KS","County or equivalent",2005,28267,137,359,535,176,-767,10,-777,545
"31740",NA,20149,"Pottawatomie County, KS","County or equivalent",2005,18795,113,99,271,172,33,-1,34,-19
"31740",NA,20161,"Riley County, KS","County or equivalent",2005,67348,1331,573,864,291,-38,121,-159,796
"31820",NA,NA,"Manitowoc, WI","Micropolitan Statistical Area",2005,81020,-199,76,869,793,-199,74,-273,-76
"31820",NA,55071,"Manitowoc County, WI","County or equivalent",2005,81020,-199,76,869,793,-199,74,-273,-76
"31860",NA,NA,"Mankato-North Mankato, MN","Micropolitan Statistical Area",2005,89321,640,452,1108,656,260,92,168,-72
"31860",NA,27013,"Blue Earth County, MN","County or equivalent",2005,58408,494,241,699,458,305,63,242,-52
"31860",NA,27103,"Nicollet County, MN","County or equivalent",2005,30913,146,211,409,198,-45,29,-74,-20
"31940",NA,NA,"Marinette, WI-MI","Micropolitan Statistical Area",2005,67558,-97,-65,675,740,34,14,20,-66
"31940",NA,26109,"Menominee County, MI","County or equivalent",2005,24592,-296,-45,218,263,-228,5,-233,-23
"31940",NA,55075,"Marinette County, WI","County or equivalent",2005,42966,199,-20,457,477,262,9,253,-43
"31980",NA,NA,"Marion, IN","Micropolitan Statistical Area",2005,69970,-844,-82,732,814,-705,12,-717,-57
"31980",NA,18053,"Grant County, IN","County or equivalent",2005,69970,-844,-82,732,814,-705,12,-717,-57
"32020",NA,NA,"Marion, OH","Micropolitan Statistical Area",2005,65716,-24,94,732,638,-55,13,-68,-63
"32020",NA,39101,"Marion County, OH","County or equivalent",2005,65716,-24,94,732,638,-55,13,-68,-63
"32060",NA,NA,"Marion-Herrin, IL","Micropolitan Statistical Area",2005,63518,438,-53,762,815,534,15,519,-43
"32060",NA,17199,"Williamson County, IL","County or equivalent",2005,63518,438,-53,762,815,534,15,519,-43
"32100",NA,NA,"Marquette, MI","Micropolitan Statistical Area",2005,65065,-26,-27,602,629,57,17,40,-56
"32100",NA,26103,"Marquette County, MI","County or equivalent",2005,65065,-26,-27,602,629,57,17,40,-56
"32140",NA,NA,"Marshall, MN","Micropolitan Statistical Area",2005,24618,96,88,320,232,30,43,-13,-22
"32140",NA,27083,"Lyon County, MN","County or equivalent",2005,24618,96,88,320,232,30,43,-13,-22
"32180",NA,NA,"Marshall, MO","Micropolitan Statistical Area",2005,22847,-87,-27,305,332,-39,37,-76,-21
"32180",NA,29195,"Saline County, MO","County or equivalent",2005,22847,-87,-27,305,332,-39,37,-76,-21
"32220",NA,NA,"Marshall, TX","Micropolitan Statistical Area",2005,62401,87,178,803,625,-35,79,-114,-56
"32220",NA,48203,"Harrison County, TX","County or equivalent",2005,62401,87,178,803,625,-35,79,-114,-56
"32260",NA,NA,"Marshalltown, IA","Micropolitan Statistical Area",2005,39066,-185,147,610,463,-305,117,-422,-27
"32260",NA,19127,"Marshall County, IA","County or equivalent",2005,39066,-185,147,610,463,-305,117,-422,-27
"32270",NA,NA,"Marshfield-Wisconsin Rapids, WI","Micropolitan Statistical Area",2005,74445,-308,108,850,742,-351,50,-401,-65
"32270",NA,55141,"Wood County, WI","County or equivalent",2005,74445,-308,108,850,742,-351,50,-401,-65
"32280",NA,NA,"Martin, TN","Micropolitan Statistical Area",2005,33505,-9,-27,356,383,50,38,12,-32
"32280",NA,47183,"Weakley County, TN","County or equivalent",2005,33505,-9,-27,356,383,50,38,12,-32
"32300",NA,NA,"Martinsville, VA","Micropolitan Statistical Area",2005,70460,-525,-127,768,895,-340,164,-504,-58
"32300",NA,51089,"Henry County, VA","County or equivalent",2005,55717,-537,-68,604,672,-422,129,-551,-47
"32300",NA,51690,"Martinsville city, VA","County or equivalent",2005,14743,12,-59,164,223,82,35,47,-11
"32340",NA,NA,"Maryville, MO","Micropolitan Statistical Area",2005,22031,42,46,229,183,17,15,2,-21
"32340",NA,29147,"Nodaway County, MO","County or equivalent",2005,22031,42,46,229,183,17,15,2,-21
"32380",NA,NA,"Mason City, IA","Micropolitan Statistical Area",2005,52062,-315,-95,538,633,-171,22,-193,-49
"32380",NA,19033,"Cerro Gordo County, IA","County or equivalent",2005,44341,-323,-79,463,542,-202,20,-222,-42
"32380",NA,19195,"Worth County, IA","County or equivalent",2005,7721,8,-16,75,91,31,2,29,-7
"32460",NA,NA,"Mayfield, KY","Micropolitan Statistical Area",2005,37228,173,60,478,418,145,55,90,-32
"32460",NA,21083,"Graves County, KY","County or equivalent",2005,37228,173,60,478,418,145,55,90,-32
"32500",NA,NA,"Maysville, KY","Micropolitan Statistical Area",2005,30648,122,27,374,347,122,13,109,-27
"32500",NA,21135,"Lewis County, KY","County or equivalent",2005,13764,7,22,176,154,-2,1,-3,-13
"32500",NA,21161,"Mason County, KY","County or equivalent",2005,16884,115,5,198,193,124,12,112,-14
"32540",NA,NA,"McAlester, OK","Micropolitan Statistical Area",2005,43940,279,-19,551,570,337,14,323,-39
"32540",NA,40121,"Pittsburg County, OK","County or equivalent",2005,43940,279,-19,551,570,337,14,323,-39
"32620",NA,NA,"McComb, MS","Micropolitan Statistical Area",2005,52003,169,178,796,618,36,1,35,-45
"32620",NA,28005,"Amite County, MS","County or equivalent",2005,13349,37,28,171,143,17,0,17,-8
"32620",NA,28113,"Pike County, MS","County or equivalent",2005,38654,132,150,625,475,19,1,18,-37
"32660",NA,NA,"McMinnville, TN","Micropolitan Statistical Area",2005,39196,139,93,539,446,83,93,-10,-37
"32660",NA,47177,"Warren County, TN","County or equivalent",2005,39196,139,93,539,446,83,93,-10,-37
"32700",NA,NA,"McPherson, KS","Micropolitan Statistical Area",2005,29248,60,33,350,317,50,4,46,-23
"32700",NA,20113,"McPherson County, KS","County or equivalent",2005,29248,60,33,350,317,50,4,46,-23
"32740",NA,NA,"Meadville, PA","Micropolitan Statistical Area",2005,89035,-340,96,1046,950,-351,5,-356,-85
"32740",NA,42039,"Crawford County, PA","County or equivalent",2005,89035,-340,96,1046,950,-351,5,-356,-85
"32860",NA,NA,"Menomonie, WI","Micropolitan Statistical Area",2005,41565,215,183,463,280,71,26,45,-39
"32860",NA,55033,"Dunn County, WI","County or equivalent",2005,41565,215,183,463,280,71,26,45,-39
"32940",NA,NA,"Meridian, MS","Micropolitan Statistical Area",2005,104656,-530,237,1464,1227,-678,-2,-676,-89
"32940",NA,28023,"Clarke County, MS","County or equivalent",2005,17340,-184,18,212,194,-189,0,-189,-13
"32940",NA,28069,"Kemper County, MS","County or equivalent",2005,10204,-145,18,109,91,-156,2,-158,-7
"32940",NA,28075,"Lauderdale County, MS","County or equivalent",2005,77112,-201,201,1143,942,-333,-4,-329,-69
"32980",NA,NA,"Merrill, WI","Micropolitan Statistical Area",2005,29881,-14,-12,290,302,27,15,12,-29
"32980",NA,55069,"Lincoln County, WI","County or equivalent",2005,29881,-14,-12,290,302,27,15,12,-29
"33020",NA,NA,"Mexico, MO","Micropolitan Statistical Area",2005,25811,258,90,381,291,191,1,190,-23
"33020",NA,29007,"Audrain County, MO","County or equivalent",2005,25811,258,90,381,291,191,1,190,-23
"33060",NA,NA,"Miami, OK","Micropolitan Statistical Area",2005,32480,88,-24,417,441,144,19,125,-32
"33060",NA,40115,"Ottawa County, OK","County or equivalent",2005,32480,88,-24,417,441,144,19,125,-32
"33180",NA,NA,"Middlesborough, KY","Micropolitan Statistical Area",2005,29225,-148,11,377,366,-132,12,-144,-27
"33180",NA,21013,"Bell County, KY","County or equivalent",2005,29225,-148,11,377,366,-132,12,-144,-27
"33220",NA,NA,"Midland, MI","Micropolitan Statistical Area",2005,83165,-287,265,932,667,-478,116,-594,-74
"33220",NA,26111,"Midland County, MI","County or equivalent",2005,83165,-287,265,932,667,-478,116,-594,-74
"33300",NA,NA,"Milledgeville, GA","Micropolitan Statistical Area",2005,54979,173,190,688,498,28,20,8,-45
"33300",NA,13009,"Baldwin County, GA","County or equivalent",2005,45532,245,187,573,386,98,20,78,-40
"33300",NA,13141,"Hancock County, GA","County or equivalent",2005,9447,-72,3,115,112,-70,0,-70,-5
"33380",NA,NA,"Minden, LA","Micropolitan Statistical Area",2005,40843,-19,0,518,518,21,7,14,-40
"33380",NA,22119,"Webster Parish, LA","County or equivalent",2005,40843,-19,0,518,518,21,7,14,-40
"33420",NA,NA,"Mineral Wells, TX","Micropolitan Statistical Area",2005,27236,165,71,409,338,115,39,76,-21
"33420",NA,48363,"Palo Pinto County, TX","County or equivalent",2005,27236,165,71,409,338,115,39,76,-21
"33500",NA,NA,"Minot, ND","Micropolitan Statistical Area",2005,64339,-677,500,1063,563,-1132,-20,-1112,-45
"33500",NA,38049,"McHenry County, ND","County or equivalent",2005,5441,-125,-16,58,74,-107,-1,-106,-2
"33500",NA,38075,"Renville County, ND","County or equivalent",2005,2402,-22,1,22,21,-20,-1,-19,-3
"33500",NA,38101,"Ward County, ND","County or equivalent",2005,56496,-530,515,983,468,-1005,-18,-987,-40
"33580",NA,NA,"Mitchell, SD","Micropolitan Statistical Area",2005,22514,10,134,350,216,-105,10,-115,-19
"33580",NA,46035,"Davison County, SD","County or equivalent",2005,18861,-23,96,296,200,-101,8,-109,-18
"33580",NA,46061,"Hanson County, SD","County or equivalent",2005,3653,33,38,54,16,-4,2,-6,-1
"33620",NA,NA,"Moberly, MO","Micropolitan Statistical Area",2005,25431,238,99,357,258,162,19,143,-23
"33620",NA,29175,"Randolph County, MO","County or equivalent",2005,25431,238,99,357,258,162,19,143,-23
"33820",NA,NA,"Monroe, WI","Micropolitan Statistical Area",2005,34797,312,108,418,310,233,9,224,-29
"33820",NA,55045,"Green County, WI","County or equivalent",2005,34797,312,108,418,310,233,9,224,-29
"33940",NA,NA,"Montrose, CO","Micropolitan Statistical Area",2005,37079,884,204,516,312,709,41,668,-29
"33940",NA,8085,"Montrose County, CO","County or equivalent",2005,37079,884,204,516,312,709,41,668,-29
"33980",NA,NA,"Morehead City, NC","Micropolitan Statistical Area",2005,62405,559,-60,644,704,582,27,555,37
"33980",NA,37031,"Carteret County, NC","County or equivalent",2005,62405,559,-60,644,704,582,27,555,37
"34020",NA,NA,"Morgan City, LA","Micropolitan Statistical Area",2005,50855,-671,267,782,515,-896,25,-921,-42
"34020",NA,22101,"St. Mary Parish, LA","County or equivalent",2005,50855,-671,267,782,515,-896,25,-921,-42
"34140",NA,NA,"Moscow, ID","Micropolitan Statistical Area",2005,35950,115,178,391,213,-30,60,-90,-33
"34140",NA,16057,"Latah County, ID","County or equivalent",2005,35950,115,178,391,213,-30,60,-90,-33
"34180",NA,NA,"Moses Lake, WA","Micropolitan Statistical Area",2005,79531,764,833,1424,591,4,574,-570,-73
"34180",NA,53025,"Grant County, WA","County or equivalent",2005,79531,764,833,1424,591,4,574,-570,-73
"34220",NA,NA,"Moultrie, GA","Micropolitan Statistical Area",2005,43323,70,311,745,434,-204,179,-383,-37
"34220",NA,13071,"Colquitt County, GA","County or equivalent",2005,43323,70,311,745,434,-204,179,-383,-37
"34260",NA,NA,"Mountain Home, AR","Micropolitan Statistical Area",2005,40248,695,-306,386,692,1027,0,1027,-26
"34260",NA,5005,"Baxter County, AR","County or equivalent",2005,40248,695,-306,386,692,1027,0,1027,-26
"34300",NA,NA,"Mountain Home, ID","Micropolitan Statistical Area",2005,28590,-474,370,526,156,-827,20,-847,-17
"34300",NA,16039,"Elmore County, ID","County or equivalent",2005,28590,-474,370,526,156,-827,20,-847,-17
"34340",NA,NA,"Mount Airy, NC","Micropolitan Statistical Area",2005,71912,208,64,865,801,215,180,35,-71
"34340",NA,37171,"Surry County, NC","County or equivalent",2005,71912,208,64,865,801,215,180,35,-71
"34380",NA,NA,"Mount Pleasant, MI","Micropolitan Statistical Area",2005,66107,391,285,704,419,164,73,91,-58
"34380",NA,26073,"Isabella County, MI","County or equivalent",2005,66107,391,285,704,419,164,73,91,-58
"34420",NA,NA,"Mount Pleasant, TX","Micropolitan Statistical Area",2005,28027,-811,334,570,236,-1128,188,-1316,-17
"34420",NA,48449,"Titus County, TX","County or equivalent",2005,28027,-811,334,570,236,-1128,188,-1316,-17
"34460",NA,NA,"Mount Sterling, KY","Micropolitan Statistical Area",2005,42523,632,172,581,409,495,2,493,-35
"34460",NA,21011,"Bath County, KY","County or equivalent",2005,11565,95,50,166,116,54,-1,55,-9
"34460",NA,21165,"Menifee County, KY","County or equivalent",2005,6743,9,3,70,67,13,-1,14,-7
"34460",NA,21173,"Montgomery County, KY","County or equivalent",2005,24215,528,119,345,226,428,4,424,-19
"34500",NA,NA,"Mount Vernon, IL","Micropolitan Statistical Area",2005,48404,-25,16,543,527,0,9,-9,-41
"34500",NA,17065,"Hamilton County, IL","County or equivalent",2005,8281,-94,-27,75,102,-60,1,-61,-7
"34500",NA,17081,"Jefferson County, IL","County or equivalent",2005,40123,69,43,468,425,60,8,52,-34
"34540",NA,NA,"Mount Vernon, OH","Micropolitan Statistical Area",2005,58009,522,139,733,594,435,9,426,-52
"34540",NA,39083,"Knox County, OH","County or equivalent",2005,58009,522,139,733,594,435,9,426,-52
"34660",NA,NA,"Murray, KY","Micropolitan Statistical Area",2005,35448,382,52,354,302,364,59,305,-34
"34660",NA,21035,"Calloway County, KY","County or equivalent",2005,35448,382,52,354,302,364,59,305,-34
"34700",NA,NA,"Muscatine, IA","Micropolitan Statistical Area",2005,53743,-116,222,773,551,-297,91,-388,-41
"34700",NA,19115,"Louisa County, IA","County or equivalent",2005,11775,-274,35,156,121,-303,25,-328,-6
"34700",NA,19139,"Muscatine County, IA","County or equivalent",2005,41968,158,187,617,430,6,66,-60,-35
"34780",NA,NA,"Muskogee, OK","Micropolitan Statistical Area",2005,70211,314,158,1020,862,212,61,151,-56
"34780",NA,40101,"Muskogee County, OK","County or equivalent",2005,70211,314,158,1020,862,212,61,151,-56
"34860",NA,NA,"Nacogdoches, TX","Micropolitan Statistical Area",2005,61147,566,429,1000,571,193,167,26,-56
"34860",NA,48347,"Nacogdoches County, TX","County or equivalent",2005,61147,566,429,1000,571,193,167,26,-56
"35020",NA,NA,"Natchez, MS-LA","Micropolitan Statistical Area",2005,50670,-565,79,683,604,-606,6,-612,-38
"35020",NA,22029,"Concordia Parish, LA","County or equivalent",2005,18927,-270,33,270,237,-289,0,-289,-14
"35020",NA,28001,"Adams County, MS","County or equivalent",2005,31743,-295,46,413,367,-317,6,-323,-24
"35060",NA,NA,"Natchitoches, LA","Micropolitan Statistical Area",2005,38778,88,181,579,398,-58,26,-84,-35
"35060",NA,22069,"Natchitoches Parish, LA","County or equivalent",2005,38778,88,181,579,398,-58,26,-84,-35
"35100",NA,NA,"New Bern, NC","Micropolitan Statistical Area",2005,117619,1048,593,1785,1192,-31,56,-87,486
"35100",NA,37049,"Craven County, NC","County or equivalent",2005,94953,1072,655,1580,925,-91,43,-134,508
"35100",NA,37103,"Jones County, NC","County or equivalent",2005,10077,-81,-12,86,98,-61,7,-68,-8
"35100",NA,37137,"Pamlico County, NC","County or equivalent",2005,12589,57,-50,119,169,121,6,115,-14
"35140",NA,NA,"Newberry, SC","Micropolitan Statistical Area",2005,36909,142,109,525,416,67,103,-36,-34
"35140",NA,45071,"Newberry County, SC","County or equivalent",2005,36909,142,109,525,416,67,103,-36,-34
"35220",NA,NA,"New Castle, IN","Micropolitan Statistical Area",2005,47283,-279,-8,553,561,-228,2,-230,-43
"35220",NA,18065,"Henry County, IN","County or equivalent",2005,47283,-279,-8,553,561,-228,2,-230,-43
"35260",NA,NA,"New Castle, PA","Micropolitan Statistical Area",2005,91948,-706,-257,931,1188,-363,12,-375,-86
"35260",NA,42073,"Lawrence County, PA","County or equivalent",2005,91948,-706,-257,931,1188,-363,12,-375,-86
"35340",NA,NA,"New Iberia, LA","Micropolitan Statistical Area",2005,73598,205,459,1112,653,-189,30,-219,-65
"35340",NA,22045,"Iberia Parish, LA","County or equivalent",2005,73598,205,459,1112,653,-189,30,-219,-65
"35420",NA,NA,"New Philadelphia-Dover, OH","Micropolitan Statistical Area",2005,91309,-267,266,1199,933,-450,24,-474,-83
"35420",NA,39157,"Tuscarawas County, OH","County or equivalent",2005,91309,-267,266,1199,933,-450,24,-474,-83
"35460",NA,NA,"Newport, TN","Micropolitan Statistical Area",2005,34712,253,-19,402,421,300,6,294,-28
"35460",NA,47029,"Cocke County, TN","County or equivalent",2005,34712,253,-19,402,421,300,6,294,-28
"35500",NA,NA,"Newton, IA","Micropolitan Statistical Area",2005,37028,-238,86,439,353,-294,19,-313,-30
"35500",NA,19099,"Jasper County, IA","County or equivalent",2005,37028,-238,86,439,353,-294,19,-313,-30
"35580",NA,NA,"New Ulm, MN","Micropolitan Statistical Area",2005,26089,-421,-7,278,285,-396,5,-401,-18
"35580",NA,27015,"Brown County, MN","County or equivalent",2005,26089,-421,-7,278,285,-396,5,-401,-18
"35700",NA,NA,"Nogales, AZ","Micropolitan Statistical Area",2005,40997,912,549,782,233,404,222,182,-41
"35700",NA,4023,"Santa Cruz County, AZ","County or equivalent",2005,40997,912,549,782,233,404,222,182,-41
"35740",NA,NA,"Norfolk, NE","Micropolitan Statistical Area",2005,49299,-159,257,761,504,-381,71,-452,-35
"35740",NA,31119,"Madison County, NE","County or equivalent",2005,35392,-138,236,601,365,-350,62,-412,-24
"35740",NA,31139,"Pierce County, NE","County or equivalent",2005,7464,18,-4,74,78,29,2,27,-7
"35740",NA,31167,"Stanton County, NE","County or equivalent",2005,6443,-39,25,86,61,-60,7,-67,-4
"35820",NA,NA,"North Platte, NE","Micropolitan Statistical Area",2005,36398,305,123,479,356,213,18,195,-31
"35820",NA,31111,"Lincoln County, NE","County or equivalent",2005,35164,311,123,463,340,219,16,203,-31
"35820",NA,31113,"Logan County, NE","County or equivalent",2005,739,7,0,11,11,7,1,6,0
"35820",NA,31117,"McPherson County, NE","County or equivalent",2005,495,-13,0,5,5,-13,1,-14,0
"35860",NA,NA,"North Vernon, IN","Micropolitan Statistical Area",2005,28060,78,204,414,210,-100,6,-106,-26
"35860",NA,18079,"Jennings County, IN","County or equivalent",2005,28060,78,204,414,210,-100,6,-106,-26
"35900",NA,NA,"North Wilkesboro, NC","Micropolitan Statistical Area",2005,66444,105,107,795,688,56,137,-81,-58
"35900",NA,37193,"Wilkes County, NC","County or equivalent",2005,66444,105,107,795,688,56,137,-81,-58
"35940",NA,NA,"Norwalk, OH","Micropolitan Statistical Area",2005,59897,63,324,856,532,-208,46,-254,-53
"35940",NA,39077,"Huron County, OH","County or equivalent",2005,59897,63,324,856,532,-208,46,-254,-53
"36020",NA,NA,"Oak Harbor, WA","Micropolitan Statistical Area",2005,79603,333,388,986,598,-52,-18,-34,-3
"36020",NA,53029,"Island County, WA","County or equivalent",2005,79603,333,388,986,598,-52,-18,-34,-3
"36060",NA,NA,"Oak Hill, WV","Micropolitan Statistical Area",2005,46306,-491,-45,567,612,-405,12,-417,-41
"36060",NA,54019,"Fayette County, WV","County or equivalent",2005,46306,-491,-45,567,612,-405,12,-417,-41
"36180",NA,NA,"Ocean Pines, MD","Micropolitan Statistical Area",2005,48785,-83,-28,506,534,-13,49,-62,-42
"36180",NA,24047,"Worcester County, MD","County or equivalent",2005,48785,-83,-28,506,534,-13,49,-62,-42
"36300",NA,NA,"Ogdensburg-Massena, NY","Micropolitan Statistical Area",2005,110076,-150,160,1208,1048,-212,68,-280,-98
"36300",NA,36089,"St. Lawrence County, NY","County or equivalent",2005,110076,-150,160,1208,1048,-212,68,-280,-98
"36340",NA,NA,"Oil City, PA","Micropolitan Statistical Area",2005,55516,-300,-117,604,721,-132,3,-135,-51
"36340",NA,42121,"Venango County, PA","County or equivalent",2005,55516,-300,-117,604,721,-132,3,-135,-51
"36380",NA,NA,"Okeechobee, FL","Micropolitan Statistical Area",2005,39239,668,140,608,468,563,170,393,-35
"36380",NA,12093,"Okeechobee County, FL","County or equivalent",2005,39239,668,140,608,468,563,170,393,-35
"36460",NA,NA,"Olean, NY","Micropolitan Statistical Area",2005,81427,-967,108,993,885,-1008,10,-1018,-67
"36460",NA,36009,"Cattaraugus County, NY","County or equivalent",2005,81427,-967,108,993,885,-1008,10,-1018,-67
"36580",NA,NA,"Oneonta, NY","Micropolitan Statistical Area",2005,62499,53,-10,559,569,121,13,108,-58
"36580",NA,36077,"Otsego County, NY","County or equivalent",2005,62499,53,-10,559,569,121,13,108,-58
"36620",NA,NA,"Ontario, OR-ID","Micropolitan Statistical Area",2005,52643,354,308,788,480,92,107,-15,-46
"36620",NA,16075,"Payette County, ID","County or equivalent",2005,21675,380,123,303,180,274,16,258,-17
"36620",NA,41045,"Malheur County, OR","County or equivalent",2005,30968,-26,185,485,300,-182,91,-273,-29
"36660",NA,NA,"Opelousas-Eunice, LA","Micropolitan Statistical Area",2005,88635,330,384,1307,923,26,12,14,-80
"36660",NA,22097,"St. Landry Parish, LA","County or equivalent",2005,88635,330,384,1307,923,26,12,14,-80
"36700",NA,NA,"Orangeburg, SC","Micropolitan Statistical Area",2005,90704,134,368,1331,963,-147,22,-169,-87
"36700",NA,45075,"Orangeburg County, SC","County or equivalent",2005,90704,134,368,1331,963,-147,22,-169,-87
"36820",NA,NA,"Oskaloosa, IA","Micropolitan Statistical Area",2005,22233,164,90,284,194,95,19,76,-21
"36820",NA,19123,"Mahaska County, IA","County or equivalent",2005,22233,164,90,284,194,95,19,76,-21
"36860",NA,NA,"Ottawa-Streator, IL","Micropolitan Statistical Area",2005,151966,105,30,1820,1790,220,104,116,-145
"36860",NA,17011,"Bureau County, IL","County or equivalent",2005,34789,-22,6,397,391,6,15,-9,-34
"36860",NA,17099,"LaSalle County, IL","County or equivalent",2005,111197,167,26,1366,1340,247,86,161,-106
"36860",NA,17155,"Putnam County, IL","County or equivalent",2005,5980,-40,-2,57,59,-33,3,-36,-5
"36900",NA,NA,"Ottumwa, IA","Micropolitan Statistical Area",2005,35785,125,82,501,419,74,31,43,-31
"36900",NA,19179,"Wapello County, IA","County or equivalent",2005,35785,125,82,501,419,74,31,43,-31
"36940",NA,NA,"Owatonna, MN","Micropolitan Statistical Area",2005,35482,420,260,506,246,193,76,117,-33
"36940",NA,27147,"Steele County, MN","County or equivalent",2005,35482,420,260,506,246,193,76,117,-33
"37020",NA,NA,"Owosso, MI","Micropolitan Statistical Area",2005,72261,-379,258,864,606,-574,5,-579,-63
"37020",NA,26155,"Shiawassee County, MI","County or equivalent",2005,72261,-379,258,864,606,-574,5,-579,-63
"37060",NA,NA,"Oxford, MS","Micropolitan Statistical Area",2005,41275,318,156,498,342,199,51,148,-37
"37060",NA,28071,"Lafayette County, MS","County or equivalent",2005,41275,318,156,498,342,199,51,148,-37
"37140",NA,NA,"Paducah, KY-IL","Micropolitan Statistical Area",2005,97557,211,145,1229,1084,157,14,143,-91
"37140",NA,17127,"Massac County, IL","County or equivalent",2005,15220,-19,19,207,188,-23,1,-24,-15
"37140",NA,21007,"Ballard County, KY","County or equivalent",2005,8245,23,26,101,75,4,2,2,-7
"37140",NA,21139,"Livingston County, KY","County or equivalent",2005,9692,69,-4,103,107,80,0,80,-7
"37140",NA,21145,"McCracken County, KY","County or equivalent",2005,64400,138,104,818,714,96,11,85,-62
"37220",NA,NA,"Pahrump, NV","Micropolitan Statistical Area",2005,40061,2700,-164,372,536,2887,42,2845,-23
"37220",NA,32023,"Nye County, NV","County or equivalent",2005,40061,2700,-164,372,536,2887,42,2845,-23
"37260",NA,NA,"Palatka, FL","Micropolitan Statistical Area",2005,72616,705,62,980,918,714,61,653,-71
"37260",NA,12107,"Putnam County, FL","County or equivalent",2005,72616,705,62,980,918,714,61,653,-71
"37300",NA,NA,"Palestine, TX","Micropolitan Statistical Area",2005,56020,458,99,666,567,405,51,354,-46
"37300",NA,48001,"Anderson County, TX","County or equivalent",2005,56020,458,99,666,567,405,51,354,-46
"37420",NA,NA,"Pampa, TX","Micropolitan Statistical Area",2005,22180,146,28,326,298,140,45,95,-22
"37420",NA,48179,"Gray County, TX","County or equivalent",2005,21358,140,26,312,286,135,44,91,-21
"37420",NA,48393,"Roberts County, TX","County or equivalent",2005,822,6,2,14,12,5,1,4,-1
"37500",NA,NA,"Paragould, AR","Micropolitan Statistical Area",2005,39129,461,136,571,435,360,8,352,-35
"37500",NA,5055,"Greene County, AR","County or equivalent",2005,39129,461,136,571,435,360,8,352,-35
"37540",NA,NA,"Paris, TN","Micropolitan Statistical Area",2005,31300,217,-52,396,448,298,10,288,-29
"37540",NA,47079,"Henry County, TN","County or equivalent",2005,31300,217,-52,396,448,298,10,288,-29
"37580",NA,NA,"Paris, TX","Micropolitan Statistical Area",2005,49094,23,74,673,599,-10,56,-66,-41
"37580",NA,48277,"Lamar County, TX","County or equivalent",2005,49094,23,74,673,599,-10,56,-66,-41
"37660",NA,NA,"Parsons, KS","Micropolitan Statistical Area",2005,21939,-5,-27,267,294,43,2,41,-21
"37660",NA,20099,"Labette County, KS","County or equivalent",2005,21939,-5,-27,267,294,43,2,41,-21
"37740",NA,NA,"Payson, AZ","Micropolitan Statistical Area",2005,50894,58,-40,667,707,149,40,109,-51
"37740",NA,4007,"Gila County, AZ","County or equivalent",2005,50894,58,-40,667,707,149,40,109,-51
"37780",NA,NA,"Pecos, TX","Micropolitan Statistical Area",2005,11244,-312,29,145,116,-335,22,-357,-6
"37780",NA,48389,"Reeves County, TX","County or equivalent",2005,11244,-312,29,145,116,-335,22,-357,-6
"37800",NA,NA,"Pella, IA","Micropolitan Statistical Area",2005,32321,58,35,399,364,49,6,43,-26
"37800",NA,19125,"Marion County, IA","County or equivalent",2005,32321,58,35,399,364,49,6,43,-26
"37820",NA,NA,"Pendleton-Hermiston, OR","Micropolitan Statistical Area",2005,84206,52,550,1223,673,-423,207,-630,-75
"37820",NA,41049,"Morrow County, OR","County or equivalent",2005,11288,-94,91,162,71,-179,43,-222,-6
"37820",NA,41059,"Umatilla County, OR","County or equivalent",2005,72918,146,459,1061,602,-244,164,-408,-69
"37940",NA,NA,"Peru, IN","Micropolitan Statistical Area",2005,36780,207,123,458,335,115,3,112,-31
"37940",NA,18103,"Miami County, IN","County or equivalent",2005,36780,207,123,458,335,115,3,112,-31
"38020",NA,NA,"Phoenix Lake-Cedar Ridge, CA","Micropolitan Statistical Area",2005,56255,83,-98,492,590,227,15,212,-46
"38020",NA,6109,"Tuolumne County, CA","County or equivalent",2005,56255,83,-98,492,590,227,15,212,-46
"38100",NA,NA,"Picayune, MS","Micropolitan Statistical Area",2005,51773,509,147,655,508,408,6,402,-46
"38100",NA,28109,"Pearl River County, MS","County or equivalent",2005,51773,509,147,655,508,408,6,402,-46
"38180",NA,NA,"Pierre, SD","Micropolitan Statistical Area",2005,19480,59,109,257,148,-34,13,-47,-16
"38180",NA,46065,"Hughes County, SD","County or equivalent",2005,16724,92,86,219,133,22,12,10,-16
"38180",NA,46117,"Stanley County, SD","County or equivalent",2005,2756,-33,23,38,15,-56,1,-57,0
"38200",NA,NA,"Pierre Part, LA","Micropolitan Statistical Area",2005,22836,-206,88,288,200,-276,5,-281,-18
"38200",NA,22007,"Assumption Parish, LA","County or equivalent",2005,22836,-206,88,288,200,-276,5,-281,-18
"38260",NA,NA,"Pittsburg, KS","Micropolitan Statistical Area",2005,38506,-37,-3,478,481,-3,73,-76,-31
"38260",NA,20037,"Crawford County, KS","County or equivalent",2005,38506,-37,-3,478,481,-3,73,-76,-31
"38380",NA,NA,"Plainview, TX","Micropolitan Statistical Area",2005,35697,-269,285,605,320,-525,72,-597,-29
"38380",NA,48189,"Hale County, TX","County or equivalent",2005,35697,-269,285,605,320,-525,72,-597,-29
"38420",NA,NA,"Platteville, WI","Micropolitan Statistical Area",2005,49138,-113,94,600,506,-162,8,-170,-45
"38420",NA,55043,"Grant County, WI","County or equivalent",2005,49138,-113,94,600,506,-162,8,-170,-45
"38460",NA,NA,"Plattsburgh, NY","Micropolitan Statistical Area",2005,81698,316,130,753,623,260,43,217,-74
"38460",NA,36019,"Clinton County, NY","County or equivalent",2005,81698,316,130,753,623,260,43,217,-74
"38500",NA,NA,"Plymouth, IN","Micropolitan Statistical Area",2005,46317,209,239,637,398,14,118,-104,-44
"38500",NA,18099,"Marshall County, IN","County or equivalent",2005,46317,209,239,637,398,14,118,-104,-44
"38580",NA,NA,"Point Pleasant, WV-OH","Micropolitan Statistical Area",2005,56483,-200,1,679,678,-149,1,-150,-52
"38580",NA,39053,"Gallia County, OH","County or equivalent",2005,30922,-45,32,393,361,-48,2,-50,-29
"38580",NA,54053,"Mason County, WV","County or equivalent",2005,25561,-155,-31,286,317,-101,-1,-100,-23
"38620",NA,NA,"Ponca City, OK","Micropolitan Statistical Area",2005,46042,-519,48,683,635,-529,41,-570,-38
"38620",NA,40071,"Kay County, OK","County or equivalent",2005,46042,-519,48,683,635,-529,41,-570,-38
"38700",NA,NA,"Pontiac, IL","Micropolitan Statistical Area",2005,38255,-221,32,514,482,-219,14,-233,-34
"38700",NA,17105,"Livingston County, IL","County or equivalent",2005,38255,-221,32,514,482,-219,14,-233,-34
"38740",NA,NA,"Poplar Bluff, MO","Micropolitan Statistical Area",2005,41255,365,84,598,514,319,13,306,-38
"38740",NA,29023,"Butler County, MO","County or equivalent",2005,41255,365,84,598,514,319,13,306,-38
"38780",NA,NA,"Portales, NM","Micropolitan Statistical Area",2005,18774,158,189,327,138,-12,13,-25,-19
"38780",NA,35041,"Roosevelt County, NM","County or equivalent",2005,18774,158,189,327,138,-12,13,-25,-19
"38820",NA,NA,"Port Angeles, WA","Micropolitan Statistical Area",2005,68701,1292,-263,579,842,1610,54,1556,-55
"38820",NA,53009,"Clallam County, WA","County or equivalent",2005,68701,1292,-263,579,842,1610,54,1556,-55
"39020",NA,NA,"Portsmouth, OH","Micropolitan Statistical Area",2005,76194,-184,111,998,887,-227,12,-239,-68
"39020",NA,39145,"Scioto County, OH","County or equivalent",2005,76194,-184,111,998,887,-227,12,-239,-68
"39060",NA,NA,"Pottsville, PA","Micropolitan Statistical Area",2005,146112,-316,-664,1433,2097,495,15,480,-147
"39060",NA,42107,"Schuylkill County, PA","County or equivalent",2005,146112,-316,-664,1433,2097,495,15,480,-147
"39220",NA,NA,"Price, UT","Micropolitan Statistical Area",2005,19185,-259,108,302,194,-352,11,-363,-15
"39220",NA,49007,"Carbon County, UT","County or equivalent",2005,19185,-259,108,302,194,-352,11,-363,-15
"39260",NA,NA,"Prineville, OR","Micropolitan Statistical Area",2005,21685,514,40,237,197,493,26,467,-19
"39260",NA,41013,"Crook County, OR","County or equivalent",2005,21685,514,40,237,197,493,26,467,-19
"39420",NA,NA,"Pullman, WA","Micropolitan Statistical Area",2005,41533,408,194,409,215,250,190,60,-36
"39420",NA,53075,"Whitman County, WA","County or equivalent",2005,41533,408,194,409,215,250,190,60,-36
"39500",NA,NA,"Quincy, IL-MO","Micropolitan Statistical Area",2005,76842,-54,-23,959,982,36,16,20,-67
"39500",NA,17001,"Adams County, IL","County or equivalent",2005,66785,35,-4,854,858,98,15,83,-59
"39500",NA,29111,"Lewis County, MO","County or equivalent",2005,10057,-89,-19,105,124,-62,1,-63,-8
"39700",NA,NA,"Raymondville, TX","Micropolitan Statistical Area",2005,20288,279,279,412,133,17,43,-26,-17
"39700",NA,48489,"Willacy County, TX","County or equivalent",2005,20288,279,279,412,133,17,43,-26,-17
"39780",NA,NA,"Red Bluff, CA","Micropolitan Statistical Area",2005,59635,817,189,773,584,678,78,600,-50
"39780",NA,6103,"Tehama County, CA","County or equivalent",2005,59635,817,189,773,584,678,78,600,-50
"39860",NA,NA,"Red Wing, MN","Micropolitan Statistical Area",2005,45257,2,111,565,454,-70,14,-84,-39
"39860",NA,27049,"Goodhue County, MN","County or equivalent",2005,45257,2,111,565,454,-70,14,-84,-39
"39940",NA,NA,"Rexburg, ID","Micropolitan Statistical Area",2005,47376,1464,876,1096,220,596,65,531,-8
"39940",NA,16043,"Fremont County, ID","County or equivalent",2005,12270,-97,146,230,84,-234,36,-270,-9
"39940",NA,16065,"Madison County, ID","County or equivalent",2005,35106,1561,730,866,136,830,29,801,1
"39980",NA,NA,"Richmond, IN","Micropolitan Statistical Area",2005,68819,-474,114,911,797,-524,37,-561,-64
"39980",NA,18177,"Wayne County, IN","County or equivalent",2005,68819,-474,114,911,797,-524,37,-561,-64
"40080",NA,NA,"Richmond-Berea, KY","Micropolitan Statistical Area",2005,95208,1762,490,1234,744,1352,42,1310,-80
"40080",NA,21151,"Madison County, KY","County or equivalent",2005,78651,1750,469,1034,565,1346,43,1303,-65
"40080",NA,21203,"Rockcastle County, KY","County or equivalent",2005,16557,12,21,200,179,6,-1,7,-15
"40100",NA,NA,"Rio Grande City-Roma, TX","Micropolitan Statistical Area",2005,59458,656,1202,1510,308,-497,407,-904,-49
"40100",NA,48427,"Starr County, TX","County or equivalent",2005,59458,656,1202,1510,308,-497,407,-904,-49
"40180",NA,NA,"Riverton, WY","Micropolitan Statistical Area",2005,36273,332,245,579,334,119,4,115,-32
"40180",NA,56013,"Fremont County, WY","County or equivalent",2005,36273,332,245,579,334,119,4,115,-32
"40260",NA,NA,"Roanoke Rapids, NC","Micropolitan Statistical Area",2005,76502,-263,4,949,945,-200,30,-230,-67
"40260",NA,37083,"Halifax County, NC","County or equivalent",2005,55463,-222,81,712,631,-256,25,-281,-47
"40260",NA,37131,"Northampton County, NC","County or equivalent",2005,21039,-41,-77,237,314,56,5,51,-20
"40300",NA,NA,"Rochelle, IL","Micropolitan Statistical Area",2005,53926,583,114,594,480,380,94,286,89
"40300",NA,17141,"Ogle County, IL","County or equivalent",2005,53926,583,114,594,480,380,94,286,89
"40460",NA,NA,"Rockingham, NC","Micropolitan Statistical Area",2005,45984,22,92,588,496,-30,54,-84,-40
"40460",NA,37153,"Richmond County, NC","County or equivalent",2005,45984,22,92,588,496,-30,54,-84,-40
"40500",NA,NA,"Rockland, ME","Micropolitan Statistical Area",2005,40962,125,14,443,429,151,9,142,-40
"40500",NA,23013,"Knox County, ME","County or equivalent",2005,40962,125,14,443,429,151,9,142,-40
"40540",NA,NA,"Rock Springs, WY","Micropolitan Statistical Area",2005,37308,425,348,622,274,111,13,98,-34
"40540",NA,56037,"Sweetwater County, WY","County or equivalent",2005,37308,425,348,622,274,111,13,98,-34
"40620",NA,NA,"Rolla, MO","Micropolitan Statistical Area",2005,41964,442,119,543,424,359,90,269,-36
"40620",NA,29161,"Phelps County, MO","County or equivalent",2005,41964,442,119,543,424,359,90,269,-36
"40700",NA,NA,"Roseburg, OR","Micropolitan Statistical Area",2005,102878,826,-117,1075,1192,1028,33,995,-85
"40700",NA,41019,"Douglas County, OR","County or equivalent",2005,102878,826,-117,1075,1192,1028,33,995,-85
"40740",NA,NA,"Roswell, NM","Micropolitan Statistical Area",2005,61189,467,396,992,596,131,129,2,-60
"40740",NA,35005,"Chaves County, NM","County or equivalent",2005,61189,467,396,992,596,131,129,2,-60
"40760",NA,NA,"Ruidoso, NM","Micropolitan Statistical Area",2005,20638,233,73,236,163,174,26,148,-14
"40760",NA,35027,"Lincoln County, NM","County or equivalent",2005,20638,233,73,236,163,174,26,148,-14
"40780",NA,NA,"Russellville, AR","Micropolitan Statistical Area",2005,78378,925,321,1083,762,589,132,457,15
"40780",NA,5115,"Pope County, AR","County or equivalent",2005,57232,873,275,767,492,566,26,540,32
"40780",NA,5149,"Yell County, AR","County or equivalent",2005,21146,52,46,316,270,23,106,-83,-17
"40820",NA,NA,"Ruston, LA","Micropolitan Statistical Area",2005,57726,-169,186,769,583,-304,42,-346,-51
"40820",NA,22049,"Jackson Parish, LA","County or equivalent",2005,15058,-93,-21,195,216,-59,0,-59,-13
"40820",NA,22061,"Lincoln Parish, LA","County or equivalent",2005,42668,-76,207,574,367,-245,42,-287,-38
"40860",NA,NA,"Rutland, VT","Micropolitan Statistical Area",2005,63478,81,-30,594,624,166,5,161,-55
"40860",NA,50021,"Rutland County, VT","County or equivalent",2005,63478,81,-30,594,624,166,5,161,-55
"40940",NA,NA,"Safford, AZ","Micropolitan Statistical Area",2005,39908,171,198,553,355,6,22,-16,-33
"40940",NA,4009,"Graham County, AZ","County or equivalent",2005,32617,187,160,453,293,56,15,41,-29
"40940",NA,4011,"Greenlee County, AZ","County or equivalent",2005,7291,-16,38,100,62,-50,7,-57,-4
"41220",NA,NA,"St. Marys, GA","Micropolitan Statistical Area",2005,45762,577,445,676,231,172,-42,214,-40
"41220",NA,13039,"Camden County, GA","County or equivalent",2005,45762,577,445,676,231,172,-42,214,-40
"41260",NA,NA,"St. Marys, PA","Micropolitan Statistical Area",2005,33237,-482,-26,325,351,-433,5,-438,-23
"41260",NA,42047,"Elk County, PA","County or equivalent",2005,33237,-482,-26,325,351,-433,5,-438,-23
"41460",NA,NA,"Salina, KS","Micropolitan Statistical Area",2005,59936,62,348,864,516,-232,77,-309,-54
"41460",NA,20143,"Ottawa County, KS","County or equivalent",2005,6004,-35,-7,63,70,-23,0,-23,-5
"41460",NA,20169,"Saline County, KS","County or equivalent",2005,53932,97,355,801,446,-209,77,-286,-49
"41580",NA,NA,"Salisbury, NC","Micropolitan Statistical Area",2005,133671,552,245,1617,1372,430,308,122,-123
"41580",NA,37159,"Rowan County, NC","County or equivalent",2005,133671,552,245,1617,1372,430,308,122,-123
"41820",NA,NA,"Sanford, NC","Micropolitan Statistical Area",2005,55470,1053,279,782,503,770,264,506,4
"41820",NA,37105,"Lee County, NC","County or equivalent",2005,55470,1053,279,782,503,770,264,506,4
"42300",NA,NA,"Sault Ste. Marie, MI","Micropolitan Statistical Area",2005,38612,106,92,393,301,49,10,39,-35
"42300",NA,26033,"Chippewa County, MI","County or equivalent",2005,38612,106,92,393,301,49,10,39,-35
"42380",NA,NA,"Sayre, PA","Micropolitan Statistical Area",2005,61767,-54,126,778,652,-121,4,-125,-59
"42380",NA,42015,"Bradford County, PA","County or equivalent",2005,61767,-54,126,778,652,-121,4,-125,-59
"42420",NA,NA,"Scottsbluff, NE","Micropolitan Statistical Area",2005,36966,-30,117,554,437,-114,46,-160,-33
"42420",NA,31007,"Banner County, NE","County or equivalent",2005,729,-19,1,6,5,-20,1,-21,0
"42420",NA,31157,"Scotts Bluff County, NE","County or equivalent",2005,36237,-11,116,548,432,-94,45,-139,-33
"42460",NA,NA,"Scottsboro, AL","Micropolitan Statistical Area",2005,52934,-291,29,631,602,-272,9,-281,-48
"42460",NA,1071,"Jackson County, AL","County or equivalent",2005,52934,-291,29,631,602,-272,9,-281,-48
"42500",NA,NA,"Scottsburg, IN","Micropolitan Statistical Area",2005,23603,203,34,296,262,189,1,188,-20
"42500",NA,18143,"Scott County, IN","County or equivalent",2005,23603,203,34,296,262,189,1,188,-20
"42580",NA,NA,"Seaford, DE","Micropolitan Statistical Area",2005,175489,4229,360,2248,1888,4019,278,3741,-150
"42580",NA,10005,"Sussex County, DE","County or equivalent",2005,175489,4229,360,2248,1888,4019,278,3741,-150
"42620",NA,NA,"Searcy, AR","Micropolitan Statistical Area",2005,71331,951,228,937,709,782,40,742,-59
"42620",NA,5145,"White County, AR","County or equivalent",2005,71331,951,228,937,709,782,40,742,-59
"42700",NA,NA,"Sebring, FL","Micropolitan Statistical Area",2005,95008,2368,-447,945,1392,2887,308,2579,-72
"42700",NA,12055,"Highlands County, FL","County or equivalent",2005,95008,2368,-447,945,1392,2887,308,2579,-72
"42740",NA,NA,"Sedalia, MO","Micropolitan Statistical Area",2005,40009,470,200,598,398,310,64,246,-40
"42740",NA,29159,"Pettis County, MO","County or equivalent",2005,40009,470,200,598,398,310,64,246,-40
"42780",NA,NA,"Selinsgrove, PA","Micropolitan Statistical Area",2005,37775,-184,125,449,324,-283,1,-284,-26
"42780",NA,42109,"Snyder County, PA","County or equivalent",2005,37775,-184,125,449,324,-283,1,-284,-26
"42820",NA,NA,"Selma, AL","Micropolitan Statistical Area",2005,43379,-566,89,654,565,-618,1,-619,-37
"42820",NA,1047,"Dallas County, AL","County or equivalent",2005,43379,-566,89,654,565,-618,1,-619,-37
"42860",NA,NA,"Seneca, SC","Micropolitan Statistical Area",2005,69225,665,140,824,684,590,63,527,-65
"42860",NA,45073,"Oconee County, SC","County or equivalent",2005,69225,665,140,824,684,590,63,527,-65
"42900",NA,NA,"Seneca Falls, NY","Micropolitan Statistical Area",2005,34335,-314,30,367,337,-318,21,-339,-26
"42900",NA,36099,"Seneca County, NY","County or equivalent",2005,34335,-314,30,367,337,-318,21,-339,-26
"42940",NA,NA,"Sevierville, TN","Micropolitan Statistical Area",2005,79519,2275,309,1016,707,2032,41,1991,-66
"42940",NA,47155,"Sevier County, TN","County or equivalent",2005,79519,2275,309,1016,707,2032,41,1991,-66
"42980",NA,NA,"Seymour, IN","Micropolitan Statistical Area",2005,41844,288,195,572,377,132,79,53,-39
"42980",NA,18071,"Jackson County, IN","County or equivalent",2005,41844,288,195,572,377,132,79,53,-39
"43060",NA,NA,"Shawnee, OK","Micropolitan Statistical Area",2005,67723,310,182,911,729,191,19,172,-63
"43060",NA,40125,"Pottawatomie County, OK","County or equivalent",2005,67723,310,182,911,729,191,19,172,-63
"43140",NA,NA,"Shelby, NC","Micropolitan Statistical Area",2005,97398,-228,184,1171,987,-323,60,-383,-89
"43140",NA,37045,"Cleveland County, NC","County or equivalent",2005,97398,-228,184,1171,987,-323,60,-383,-89
"43180",NA,NA,"Shelbyville, TN","Micropolitan Statistical Area",2005,41826,1067,304,700,396,805,192,613,-42
"43180",NA,47003,"Bedford County, TN","County or equivalent",2005,41826,1067,304,700,396,805,192,613,-42
"43220",NA,NA,"Shelton, WA","Micropolitan Statistical Area",2005,53822,1095,-17,559,576,1160,44,1116,-48
"43220",NA,53045,"Mason County, WA","County or equivalent",2005,53822,1095,-17,559,576,1160,44,1116,-48
"43260",NA,NA,"Sheridan, WY","Micropolitan Statistical Area",2005,27140,143,72,338,266,95,8,87,-24
"43260",NA,56033,"Sheridan County, WY","County or equivalent",2005,27140,143,72,338,266,95,8,87,-24
"43320",NA,NA,"Show Low, AZ","Micropolitan Statistical Area",2005,106966,1948,1070,1882,812,974,54,920,-96
"43320",NA,4017,"Navajo County, AZ","County or equivalent",2005,106966,1948,1070,1882,812,974,54,920,-96
"43380",NA,NA,"Sidney, OH","Micropolitan Statistical Area",2005,48462,200,337,708,371,-91,42,-133,-46
"43380",NA,39149,"Shelby County, OH","County or equivalent",2005,48462,200,337,708,371,-91,42,-133,-46
"43420",NA,NA,"Sierra Vista-Douglas, AZ","Micropolitan Statistical Area",2005,125498,2378,728,1830,1102,1764,212,1552,-114
"43420",NA,4003,"Cochise County, AZ","County or equivalent",2005,125498,2378,728,1830,1102,1764,212,1552,-114
"43460",NA,NA,"Sikeston, MO","Micropolitan Statistical Area",2005,40633,190,209,606,397,21,11,10,-40
"43460",NA,29201,"Scott County, MO","County or equivalent",2005,40633,190,209,606,397,21,11,10,-40
"43500",NA,NA,"Silver City, NM","Micropolitan Statistical Area",2005,29264,232,64,375,311,197,7,190,-29
"43500",NA,35017,"Grant County, NM","County or equivalent",2005,29264,232,64,375,311,197,7,190,-29
"43540",NA,NA,"Silverthorne, CO","Micropolitan Statistical Area",2005,25344,137,292,338,46,-140,216,-356,-15
"43540",NA,8117,"Summit County, CO","County or equivalent",2005,25344,137,292,338,46,-140,216,-356,-15
"43660",NA,NA,"Snyder, TX","Micropolitan Statistical Area",2005,15769,-87,59,227,168,-134,11,-145,-12
"43660",NA,48415,"Scurry County, TX","County or equivalent",2005,15769,-87,59,227,168,-134,11,-145,-12
"43700",NA,NA,"Somerset, KY","Micropolitan Statistical Area",2005,58918,570,137,777,640,485,14,471,-52
"43700",NA,21199,"Pulaski County, KY","County or equivalent",2005,58918,570,137,777,640,485,14,471,-52
"43740",NA,NA,"Somerset, PA","Micropolitan Statistical Area",2005,78454,-501,-168,736,904,-258,10,-268,-75
"43740",NA,42111,"Somerset County, PA","County or equivalent",2005,78454,-501,-168,736,904,-258,10,-268,-75
"43860",NA,NA,"Southern Pines-Pinehurst, NC","Micropolitan Statistical Area",2005,80846,1326,20,990,970,1386,146,1240,-80
"43860",NA,37125,"Moore County, NC","County or equivalent",2005,80846,1326,20,990,970,1386,146,1240,-80
"43940",NA,NA,"Spearfish, SD","Micropolitan Statistical Area",2005,22705,242,48,260,212,208,1,207,-14
"43940",NA,46081,"Lawrence County, SD","County or equivalent",2005,22705,242,48,260,212,208,1,207,-14
"43980",NA,NA,"Spencer, IA","Micropolitan Statistical Area",2005,16777,-131,31,217,186,-145,12,-157,-17
"43980",NA,19041,"Clay County, IA","County or equivalent",2005,16777,-131,31,217,186,-145,12,-157,-17
"44020",NA,NA,"Spirit Lake, IA","Micropolitan Statistical Area",2005,16610,130,30,176,146,116,0,116,-16
"44020",NA,19059,"Dickinson County, IA","County or equivalent",2005,16610,130,30,176,146,116,0,116,-16
"44260",NA,NA,"Starkville, MS","Micropolitan Statistical Area",2005,42385,303,311,592,281,33,102,-69,-41
"44260",NA,28105,"Oktibbeha County, MS","County or equivalent",2005,42385,303,311,592,281,33,102,-69,-41
"44340",NA,NA,"Statesboro, GA","Micropolitan Statistical Area",2005,63489,2266,365,783,418,1950,75,1875,-49
"44340",NA,13031,"Bulloch County, GA","County or equivalent",2005,63489,2266,365,783,418,1950,75,1875,-49
"44380",NA,NA,"Statesville-Mooresville, NC","Micropolitan Statistical Area",2005,140022,3860,569,1824,1255,3410,275,3135,-119
"44380",NA,37097,"Iredell County, NC","County or equivalent",2005,140022,3860,569,1824,1255,3410,275,3135,-119
"44420",NA,NA,"Staunton-Waynesboro, VA","Micropolitan Statistical Area",2005,113462,1389,192,1291,1099,1295,48,1247,-98
"44420",NA,51015,"Augusta County, VA","County or equivalent",2005,68958,842,146,732,586,759,26,733,-63
"44420",NA,51790,"Staunton city, VA","County or equivalent",2005,23403,237,-26,256,282,281,3,278,-18
"44420",NA,51820,"Waynesboro city, VA","County or equivalent",2005,21101,310,72,303,231,255,19,236,-17
"44500",NA,NA,"Stephenville, TX","Micropolitan Statistical Area",2005,34461,260,95,470,375,199,76,123,-34
"44500",NA,48143,"Erath County, TX","County or equivalent",2005,34461,260,95,470,375,199,76,123,-34
"44540",NA,NA,"Sterling, CO","Micropolitan Statistical Area",2005,20863,-265,22,223,201,-271,41,-312,-16
"44540",NA,8075,"Logan County, CO","County or equivalent",2005,20863,-265,22,223,201,-271,41,-312,-16
"44580",NA,NA,"Sterling, IL","Micropolitan Statistical Area",2005,59217,-244,35,722,687,-226,44,-270,-53
"44580",NA,17195,"Whiteside County, IL","County or equivalent",2005,59217,-244,35,722,687,-226,44,-270,-53
"44620",NA,NA,"Stevens Point, WI","Micropolitan Statistical Area",2005,67577,168,213,715,502,13,41,-28,-58
"44620",NA,55097,"Portage County, WI","County or equivalent",2005,67577,168,213,715,502,13,41,-28,-58
"44660",NA,NA,"Stillwater, OK","Micropolitan Statistical Area",2005,75042,262,362,897,535,-646,225,-871,546
"44660",NA,40119,"Payne County, OK","County or equivalent",2005,75042,262,362,897,535,-646,225,-871,546
"44740",NA,NA,"Storm Lake, IA","Micropolitan Statistical Area",2005,19720,-84,105,287,182,-173,118,-291,-16
"44740",NA,19021,"Buena Vista County, IA","County or equivalent",2005,19720,-84,105,287,182,-173,118,-291,-16
"44780",NA,NA,"Sturgis, MI","Micropolitan Statistical Area",2005,62370,21,387,983,596,-313,107,-420,-53
"44780",NA,26149,"St. Joseph County, MI","County or equivalent",2005,62370,21,387,983,596,-313,107,-420,-53
"44860",NA,NA,"Sulphur Springs, TX","Micropolitan Statistical Area",2005,33075,216,93,471,378,154,56,98,-31
"44860",NA,48223,"Hopkins County, TX","County or equivalent",2005,33075,216,93,471,378,154,56,98,-31
"44900",NA,NA,"Summerville, GA","Micropolitan Statistical Area",2005,25904,39,12,293,281,50,19,31,-23
"44900",NA,13055,"Chattooga County, GA","County or equivalent",2005,25904,39,12,293,281,50,19,31,-23
"44980",NA,NA,"Sunbury, PA","Micropolitan Statistical Area",2005,91534,-505,-279,968,1247,-137,17,-154,-89
"44980",NA,42097,"Northumberland County, PA","County or equivalent",2005,91534,-505,-279,968,1247,-137,17,-154,-89
"45000",NA,NA,"Susanville, CA","Micropolitan Statistical Area",2005,34061,-58,57,286,229,-88,3,-91,-27
"45000",NA,6035,"Lassen County, CA","County or equivalent",2005,34061,-58,57,286,229,-88,3,-91,-27
"45020",NA,NA,"Sweetwater, TX","Micropolitan Statistical Area",2005,14581,-277,30,251,221,-297,8,-305,-10
"45020",NA,48353,"Nolan County, TX","County or equivalent",2005,14581,-277,30,251,221,-297,8,-305,-10
"45140",NA,NA,"Tahlequah, OK","Micropolitan Statistical Area",2005,44415,283,141,606,465,184,74,110,-42
"45140",NA,40021,"Cherokee County, OK","County or equivalent",2005,44415,283,141,606,465,184,74,110,-42
"45180",NA,NA,"Talladega-Sylacauga, AL","Micropolitan Statistical Area",2005,79869,145,99,992,893,124,16,108,-78
"45180",NA,1121,"Talladega County, AL","County or equivalent",2005,79869,145,99,992,893,124,16,108,-78
"45260",NA,NA,"Tallulah, LA","Micropolitan Statistical Area",2005,12093,-168,80,238,158,-238,1,-239,-10
"45260",NA,22065,"Madison Parish, LA","County or equivalent",2005,12093,-168,80,238,158,-238,1,-239,-10
"45340",NA,NA,"Taos, NM","Micropolitan Statistical Area",2005,31142,30,130,358,228,-69,47,-116,-31
"45340",NA,35055,"Taos County, NM","County or equivalent",2005,31142,30,130,358,228,-69,47,-116,-31
"45380",NA,NA,"Taylorville, IL","Micropolitan Statistical Area",2005,34797,-223,2,425,423,-191,12,-203,-34
"45380",NA,17021,"Christian County, IL","County or equivalent",2005,34797,-223,2,425,423,-191,12,-203,-34
"45540",NA,NA,"The Villages, FL","Micropolitan Statistical Area",2005,63382,3320,-288,513,801,3630,43,3587,-22
"45540",NA,12119,"Sumter County, FL","County or equivalent",2005,63382,3320,-288,513,801,3630,43,3587,-22
"45580",NA,NA,"Thomaston, GA","Micropolitan Statistical Area",2005,27446,-32,-62,317,379,54,36,18,-24
"45580",NA,13293,"Upson County, GA","County or equivalent",2005,27446,-32,-62,317,379,54,36,18,-24
"45620",NA,NA,"Thomasville, GA","Micropolitan Statistical Area",2005,44206,889,184,611,427,739,18,721,-34
"45620",NA,13275,"Thomas County, GA","County or equivalent",2005,44206,889,184,611,427,739,18,721,-34
"45640",NA,NA,"Thomasville-Lexington, NC","Micropolitan Statistical Area",2005,153116,785,400,1847,1447,533,329,204,-148
"45640",NA,37057,"Davidson County, NC","County or equivalent",2005,153116,785,400,1847,1447,533,329,204,-148
"45660",NA,NA,"Tiffin, OH","Micropolitan Statistical Area",2005,57246,-286,201,757,556,-437,17,-454,-50
"45660",NA,39147,"Seneca County, OH","County or equivalent",2005,57246,-286,201,757,556,-437,17,-454,-50
"45700",NA,NA,"Tifton, GA","Micropolitan Statistical Area",2005,40370,449,290,661,371,194,133,61,-35
"45700",NA,13277,"Tift County, GA","County or equivalent",2005,40370,449,290,661,371,194,133,61,-35
"45740",NA,NA,"Toccoa, GA","Micropolitan Statistical Area",2005,25056,-77,14,336,322,-72,7,-79,-19
"45740",NA,13257,"Stephens County, GA","County or equivalent",2005,25056,-77,14,336,322,-72,7,-79,-19
"45860",NA,NA,"Torrington, CT","Micropolitan Statistical Area",2005,187648,33,175,1876,1701,38,163,-125,-180
"45860",NA,9005,"Litchfield County, CT","County or equivalent",2005,187648,33,175,1876,1701,38,163,-125,-180
"45900",NA,NA,"Traverse City, MI","Micropolitan Statistical Area",2005,139907,968,345,1549,1204,738,56,682,-115
"45900",NA,26019,"Benzie County, MI","County or equivalent",2005,17466,220,34,188,154,198,3,195,-12
"45900",NA,26055,"Grand Traverse County, MI","County or equivalent",2005,83482,870,225,938,713,718,43,675,-73
"45900",NA,26079,"Kalkaska County, MI","County or equivalent",2005,17111,-73,79,216,137,-143,1,-144,-9
"45900",NA,26089,"Leelanau County, MI","County or equivalent",2005,21848,-49,7,207,200,-35,9,-44,-21
"45980",NA,NA,"Troy, AL","Micropolitan Statistical Area",2005,29672,-50,76,381,305,-98,22,-120,-28
"45980",NA,1109,"Pike County, AL","County or equivalent",2005,29672,-50,76,381,305,-98,22,-120,-28
"46020",NA,NA,"Truckee-Grass Valley, CA","Micropolitan Statistical Area",2005,96573,586,-105,830,935,786,74,712,-95
"46020",NA,6057,"Nevada County, CA","County or equivalent",2005,96573,586,-105,830,935,786,74,712,-95
"46100",NA,NA,"Tullahoma, TN","Micropolitan Statistical Area",2005,97143,931,78,1152,1074,942,66,876,-89
"46100",NA,47031,"Coffee County, TN","County or equivalent",2005,50637,706,106,676,570,648,52,596,-48
"46100",NA,47051,"Franklin County, TN","County or equivalent",2005,40523,166,-20,426,446,222,15,207,-36
"46100",NA,47127,"Moore County, TN","County or equivalent",2005,5983,59,-8,50,58,72,-1,73,-5
"46180",NA,NA,"Tupelo, MS","Micropolitan Statistical Area",2005,129365,825,755,2031,1276,182,51,131,-112
"46180",NA,28057,"Itawamba County, MS","County or equivalent",2005,23015,121,8,296,288,133,2,131,-20
"46180",NA,28081,"Lee County, MS","County or equivalent",2005,78208,484,518,1261,743,36,32,4,-70
"46180",NA,28115,"Pontotoc County, MS","County or equivalent",2005,28142,220,229,474,245,13,17,-4,-22
"46260",NA,NA,"Tuskegee, AL","Micropolitan Statistical Area",2005,22739,-306,-9,245,254,-278,15,-293,-19
"46260",NA,1087,"Macon County, AL","County or equivalent",2005,22739,-306,-9,245,254,-278,15,-293,-19
"46300",NA,NA,"Twin Falls, ID","Micropolitan Statistical Area",2005,88351,1597,676,1462,786,984,227,757,-63
"46300",NA,16053,"Jerome County, ID","County or equivalent",2005,19200,234,232,362,130,19,65,-46,-17
"46300",NA,16083,"Twin Falls County, ID","County or equivalent",2005,69151,1363,444,1100,656,965,162,803,-46
"46380",NA,NA,"Ukiah, CA","Micropolitan Statistical Area",2005,86986,-228,328,1131,803,-477,279,-756,-79
"46380",NA,6045,"Mendocino County, CA","County or equivalent",2005,86986,-228,328,1131,803,-477,279,-756,-79
"46420",NA,NA,"Union, SC","Micropolitan Statistical Area",2005,28245,-222,-73,312,385,-126,3,-129,-23
"46420",NA,45087,"Union County, SC","County or equivalent",2005,28245,-222,-73,312,385,-126,3,-129,-23
"46460",NA,NA,"Union City, TN-KY","Micropolitan Statistical Area",2005,38902,-426,-19,476,495,-376,21,-397,-31
"46460",NA,21075,"Fulton County, KY","County or equivalent",2005,7093,-185,-35,88,123,-146,0,-146,-4
"46460",NA,47131,"Obion County, TN","County or equivalent",2005,31809,-241,16,388,372,-230,21,-251,-27
"46500",NA,NA,"Urbana, OH","Micropolitan Statistical Area",2005,39193,-44,129,485,356,-139,0,-139,-34
"46500",NA,39021,"Champaign County, OH","County or equivalent",2005,39193,-44,129,485,356,-139,0,-139,-34
"46620",NA,NA,"Uvalde, TX","Micropolitan Statistical Area",2005,26552,192,260,468,208,-45,42,-87,-23
"46620",NA,48463,"Uvalde County, TX","County or equivalent",2005,26552,192,260,468,208,-45,42,-87,-23
"46740",NA,NA,"Valley, AL","Micropolitan Statistical Area",2005,35136,-217,-65,415,480,-120,16,-136,-32
"46740",NA,1017,"Chambers County, AL","County or equivalent",2005,35136,-217,-65,415,480,-120,16,-136,-32
"46780",NA,NA,"Van Wert, OH","Micropolitan Statistical Area",2005,29031,-112,102,383,281,-188,5,-193,-26
"46780",NA,39161,"Van Wert County, OH","County or equivalent",2005,29031,-112,102,383,281,-188,5,-193,-26
"46820",NA,NA,"Vermillion, SD","Micropolitan Statistical Area",2005,13279,14,43,137,94,-17,13,-30,-12
"46820",NA,46027,"Clay County, SD","County or equivalent",2005,13279,14,43,137,94,-17,13,-30,-12
"46860",NA,NA,"Vernal, UT","Micropolitan Statistical Area",2005,26975,511,349,525,176,185,7,178,-23
"46860",NA,49047,"Uintah County, UT","County or equivalent",2005,26975,511,349,525,176,185,7,178,-23
"46900",NA,NA,"Vernon, TX","Micropolitan Statistical Area",2005,13929,33,49,217,168,-6,13,-19,-10
"46900",NA,48487,"Wilbarger County, TX","County or equivalent",2005,13929,33,49,217,168,-6,13,-19,-10
"46980",NA,NA,"Vicksburg, MS","Micropolitan Statistical Area",2005,48578,-306,256,765,509,-519,16,-535,-43
"46980",NA,28149,"Warren County, MS","County or equivalent",2005,48578,-306,256,765,509,-519,16,-535,-43
"47080",NA,NA,"Vidalia, GA","Micropolitan Statistical Area",2005,35716,375,195,552,357,209,101,108,-29
"47080",NA,13209,"Montgomery County, GA","County or equivalent",2005,8858,-92,33,113,80,-118,12,-130,-7
"47080",NA,13279,"Toombs County, GA","County or equivalent",2005,26858,467,162,439,277,327,89,238,-22
"47180",NA,NA,"Vincennes, IN","Micropolitan Statistical Area",2005,38159,-244,-11,453,464,-200,32,-232,-33
"47180",NA,18083,"Knox County, IN","County or equivalent",2005,38159,-244,-11,453,464,-200,32,-232,-33
"47340",NA,NA,"Wabash, IN","Micropolitan Statistical Area",2005,33486,-384,-7,379,386,-347,-1,-346,-30
"47340",NA,18169,"Wabash County, IN","County or equivalent",2005,33486,-384,-7,379,386,-347,-1,-346,-30
"47420",NA,NA,"Wahpeton, ND-MN","Micropolitan Statistical Area",2005,23803,-273,62,292,230,-319,4,-323,-16
"47420",NA,27167,"Wilkin County, MN","County or equivalent",2005,6640,-91,-6,73,79,-82,0,-82,-3
"47420",NA,38077,"Richland County, ND","County or equivalent",2005,17163,-182,68,219,151,-237,4,-241,-13
"47460",NA,NA,"Walla Walla, WA","Micropolitan Statistical Area",2005,56933,-30,122,699,577,-103,146,-249,-49
"47460",NA,53071,"Walla Walla County, WA","County or equivalent",2005,56933,-30,122,699,577,-103,146,-249,-49
"47500",NA,NA,"Walterboro, SC","Micropolitan Statistical Area",2005,38926,74,108,514,406,4,18,-14,-38
"47500",NA,45029,"Colleton County, SC","County or equivalent",2005,38926,74,108,514,406,4,18,-14,-38
"47540",NA,NA,"Wapakoneta, OH","Micropolitan Statistical Area",2005,46620,236,179,640,461,104,19,85,-47
"47540",NA,39011,"Auglaize County, OH","County or equivalent",2005,46620,236,179,640,461,104,19,85,-47
"47620",NA,NA,"Warren, PA","Micropolitan Statistical Area",2005,41569,-598,-67,407,474,-493,1,-494,-38
"47620",NA,42123,"Warren County, PA","County or equivalent",2005,41569,-598,-67,407,474,-493,1,-494,-38
"47660",NA,NA,"Warrensburg, MO","Micropolitan Statistical Area",2005,51406,246,340,708,368,-52,64,-116,-42
"47660",NA,29101,"Johnson County, MO","County or equivalent",2005,51406,246,340,708,368,-52,64,-116,-42
"47700",NA,NA,"Warsaw, IN","Micropolitan Statistical Area",2005,75390,358,431,1075,644,-3,102,-105,-70
"47700",NA,18085,"Kosciusko County, IN","County or equivalent",2005,75390,358,431,1075,644,-3,102,-105,-70
"47780",NA,NA,"Washington, IN","Micropolitan Statistical Area",2005,29972,61,193,510,317,-105,41,-146,-27
"47780",NA,18027,"Daviess County, IN","County or equivalent",2005,29972,61,193,510,317,-105,41,-146,-27
"47820",NA,NA,"Washington, NC","Micropolitan Statistical Area",2005,45368,288,73,609,536,258,56,202,-43
"47820",NA,37013,"Beaufort County, NC","County or equivalent",2005,45368,288,73,609,536,258,56,202,-43
"47920",NA,NA,"Washington Court House, OH","Micropolitan Statistical Area",2005,28217,135,84,401,317,79,8,71,-28
"47920",NA,39047,"Fayette County, OH","County or equivalent",2005,28217,135,84,401,317,79,8,71,-28
"47980",NA,NA,"Watertown, SD","Micropolitan Statistical Area",2005,31423,66,203,496,293,-111,12,-123,-26
"47980",NA,46029,"Codington County, SD","County or equivalent",2005,25863,14,178,392,214,-142,12,-154,-22
"47980",NA,46057,"Hamlin County, SD","County or equivalent",2005,5560,52,25,104,79,31,0,31,-4
"48020",NA,NA,"Watertown-Fort Atkinson, WI","Micropolitan Statistical Area",2005,78646,675,411,1015,604,340,85,255,-76
"48020",NA,55055,"Jefferson County, WI","County or equivalent",2005,78646,675,411,1015,604,340,85,255,-76
"48060",NA,NA,"Watertown-Fort Drum, NY","Micropolitan Statistical Area",2005,117021,2597,693,1615,922,2259,-62,2321,-355
"48060",NA,36045,"Jefferson County, NY","County or equivalent",2005,117021,2597,693,1615,922,2259,-62,2321,-355
"48100",NA,NA,"Wauchula, FL","Micropolitan Statistical Area",2005,27752,156,255,463,208,-79,203,-282,-20
"48100",NA,12049,"Hardee County, FL","County or equivalent",2005,27752,156,255,463,208,-79,203,-282,-20
"48180",NA,NA,"Waycross, GA","Micropolitan Statistical Area",2005,52056,432,201,785,584,276,65,211,-45
"48180",NA,13229,"Pierce County, GA","County or equivalent",2005,17144,421,104,258,154,332,16,316,-15
"48180",NA,13299,"Ware County, GA","County or equivalent",2005,34912,11,97,527,430,-56,49,-105,-30
"48460",NA,NA,"West Plains, MO","Micropolitan Statistical Area",2005,38075,540,36,516,480,538,19,519,-34
"48460",NA,29091,"Howell County, MO","County or equivalent",2005,38075,540,36,516,480,538,19,519,-34
"48500",NA,NA,"West Point, MS","Micropolitan Statistical Area",2005,21109,-288,118,321,203,-390,4,-394,-16
"48500",NA,28025,"Clay County, MS","County or equivalent",2005,21109,-288,118,321,203,-390,4,-394,-16
"48580",NA,NA,"Whitewater, WI","Micropolitan Statistical Area",2005,98954,1496,334,1191,857,1251,156,1095,-89
"48580",NA,55127,"Walworth County, WI","County or equivalent",2005,98954,1496,334,1191,857,1251,156,1095,-89
"48740",NA,NA,"Willimantic, CT","Micropolitan Statistical Area",2005,115097,1224,417,1327,910,913,171,742,-106
"48740",NA,9015,"Windham County, CT","County or equivalent",2005,115097,1224,417,1327,910,913,171,742,-106
"48780",NA,NA,"Williston, ND","Micropolitan Statistical Area",2005,19125,-13,40,233,193,-35,4,-39,-18
"48780",NA,38105,"Williams County, ND","County or equivalent",2005,19125,-13,40,233,193,-35,4,-39,-18
"48820",NA,NA,"Willmar, MN","Micropolitan Statistical Area",2005,40886,-127,209,591,382,-301,46,-347,-35
"48820",NA,27067,"Kandiyohi County, MN","County or equivalent",2005,40886,-127,209,591,382,-301,46,-347,-35
"48940",NA,NA,"Wilmington, OH","Micropolitan Statistical Area",2005,42074,270,201,593,392,105,36,69,-36
"48940",NA,39027,"Clinton County, OH","County or equivalent",2005,42074,270,201,593,392,105,36,69,-36
"48980",NA,NA,"Wilson, NC","Micropolitan Statistical Area",2005,75405,356,244,1067,823,183,215,-32,-71
"48980",NA,37195,"Wilson County, NC","County or equivalent",2005,75405,356,244,1067,823,183,215,-32,-71
"49060",NA,NA,"Winfield, KS","Micropolitan Statistical Area",2005,34484,-656,24,434,410,-661,21,-682,-19
"49060",NA,20035,"Cowley County, KS","County or equivalent",2005,34484,-656,24,434,410,-661,21,-682,-19
"49100",NA,NA,"Winona, MN","Micropolitan Statistical Area",2005,49561,256,164,531,367,138,49,89,-46
"49100",NA,27169,"Winona County, MN","County or equivalent",2005,49561,256,164,531,367,138,49,89,-46
"49260",NA,NA,"Woodward, OK","Micropolitan Statistical Area",2005,18864,133,93,260,167,55,9,46,-15
"49260",NA,40153,"Woodward County, OK","County or equivalent",2005,18864,133,93,260,167,55,9,46,-15
"49300",NA,NA,"Wooster, OH","Micropolitan Statistical Area",2005,113155,246,606,1636,1030,-251,75,-326,-109
"49300",NA,39169,"Wayne County, OH","County or equivalent",2005,113155,246,606,1636,1030,-251,75,-326,-109
"49380",NA,NA,"Worthington, MN","Micropolitan Statistical Area",2005,20202,-30,157,326,169,-168,59,-227,-19
"49380",NA,27105,"Nobles County, MN","County or equivalent",2005,20202,-30,157,326,169,-168,59,-227,-19
"49460",NA,NA,"Yankton, SD","Micropolitan Statistical Area",2005,21617,-50,61,256,195,-94,6,-100,-17
"49460",NA,46135,"Yankton County, SD","County or equivalent",2005,21617,-50,61,256,195,-94,6,-100,-17
"49540",NA,NA,"Yazoo City, MS","Micropolitan Statistical Area",2005,27821,46,190,447,257,-119,10,-129,-25
"49540",NA,28163,"Yazoo County, MS","County or equivalent",2005,27821,46,190,447,257,-119,10,-129,-25
"49780",NA,NA,"Zanesville, OH","Micropolitan Statistical Area",2005,85138,-17,203,1064,861,-147,8,-155,-73
"49780",NA,39119,"Muskingum County, OH","County or equivalent",2005,85138,-17,203,1064,861,-147,8,-155,-73
"10180",NA,48059,"Callahan County, TX","County or equivalent",2006,13288,77,19,159,140,65,5,60,-7
"10180",NA,48253,"Jones County, TX","County or equivalent",2006,19497,-47,-6,197,203,-30,6,-36,-11
"10180",NA,48441,"Taylor County, TX","County or equivalent",2006,125949,23,933,2098,1165,-855,252,-1107,-55
"10420",NA,NA,"Akron, OH","Metropolitan Statistical Area",2006,699255,-1148,1677,8124,6447,-2752,548,-3300,-73
"10420",NA,39133,"Portage County, OH","County or equivalent",2006,154581,-475,377,1602,1225,-783,97,-880,-69
"10420",NA,39153,"Summit County, OH","County or equivalent",2006,544674,-673,1300,6522,5222,-1969,451,-2420,-4
"10500",NA,NA,"Albany, GA","Metropolitan Statistical Area",2006,162974,1062,1054,2447,1393,65,150,-85,-57
"10500",NA,13007,"Baker County, GA","County or equivalent",2006,3929,-61,3,31,28,-63,3,-66,-1
"10500",NA,13095,"Dougherty County, GA","County or equivalent",2006,95040,-46,769,1651,882,-772,118,-890,-43
"10500",NA,13177,"Lee County, GA","County or equivalent",2006,32120,1256,177,340,163,1077,20,1057,2
"10500",NA,13273,"Terrell County, GA","County or equivalent",2006,10437,-113,48,156,108,-157,2,-159,-4
"10500",NA,13321,"Worth County, GA","County or equivalent",2006,21448,26,57,269,212,-20,7,-27,-11
"10580",NA,NA,"Albany-Schenectady-Troy, NY","Metropolitan Statistical Area",2006,850291,3930,2076,9467,7391,2255,1189,1066,-401
"10580",NA,36001,"Albany County, NY","County or equivalent",2006,299183,589,510,3212,2702,216,579,-363,-137
"10580",NA,36083,"Rensselaer County, NY","County or equivalent",2006,154601,594,348,1733,1385,320,232,88,-74
"10580",NA,36091,"Saratoga County, NY","County or equivalent",2006,214552,1306,871,2373,1502,536,154,382,-101
"10580",NA,36093,"Schenectady County, NY","County or equivalent",2006,150055,1472,354,1870,1516,1192,223,969,-74
"10580",NA,36095,"Schoharie County, NY","County or equivalent",2006,31900,-31,-7,279,286,-9,1,-10,-15
"10740",NA,NA,"Albuquerque, NM","Metropolitan Statistical Area",2006,815979,18833,5605,11778,6173,13685,1821,11864,-457
"10740",NA,35001,"Bernalillo County, NM","County or equivalent",2006,618048,11546,4504,9290,4786,7384,1632,5752,-342
"10740",NA,35043,"Sandoval County, NM","County or equivalent",2006,111855,6230,676,1401,725,5625,70,5555,-71
"10740",NA,35057,"Torrance County, NM","County or equivalent",2006,16678,6,27,171,144,-12,9,-21,-9
"10740",NA,35061,"Valencia County, NM","County or equivalent",2006,69398,1051,398,916,518,688,110,578,-35
"10780",NA,NA,"Alexandria, LA","Metropolitan Statistical Area",2006,152145,5095,633,2181,1548,2484,74,2410,1978
"10780",NA,22043,"Grant Parish, LA","County or equivalent",2006,19722,437,58,266,208,390,2,388,-11
"10780",NA,22079,"Rapides Parish, LA","County or equivalent",2006,132423,4658,575,1915,1340,2094,72,2022,1989
"10900",NA,NA,"Allentown-Bethlehem-Easton, PA-NJ","Metropolitan Statistical Area",2006,794432,9618,1697,9157,7460,8172,1599,6573,-251
"10900",NA,34041,"Warren County, NJ","County or equivalent",2006,109265,265,370,1245,875,-53,188,-241,-52
"10900",NA,42025,"Carbon County, PA","County or equivalent",2006,62100,559,-229,623,852,818,16,802,-30
"10900",NA,42077,"Lehigh County, PA","County or equivalent",2006,333428,4865,1057,4225,3168,3982,886,3096,-174
"10900",NA,42095,"Northampton County, PA","County or equivalent",2006,289639,3929,499,3064,2565,3425,509,2916,5
"11020",NA,NA,"Altoona, PA","Metropolitan Statistical Area",2006,125529,-353,-152,1426,1578,-145,27,-172,-56
"11020",NA,42013,"Blair County, PA","County or equivalent",2006,125529,-353,-152,1426,1578,-145,27,-172,-56
"11100",NA,NA,"Amarillo, TX","Metropolitan Statistical Area",2006,239804,2160,1801,3796,1995,484,444,40,-125
"11100",NA,48011,"Armstrong County, TX","County or equivalent",2006,2094,-31,-2,21,23,-28,0,-28,-1
"11100",NA,48065,"Carson County, TX","County or equivalent",2006,6347,-41,4,60,56,-42,2,-44,-3
"11100",NA,48375,"Potter County, TX","County or equivalent",2006,120375,941,1139,2271,1132,-139,342,-481,-59
"11100",NA,48381,"Randall County, TX","County or equivalent",2006,110988,1291,660,1444,784,693,100,593,-62
"11180",NA,NA,"Ames, IA","Metropolitan Statistical Area",2006,83505,1653,558,1013,455,1138,438,700,-43
"11180",NA,19169,"Story County, IA","County or equivalent",2006,83505,1653,558,1013,455,1138,438,700,-43
"11260",NA,NA,"Anchorage, AK","Metropolitan Statistical Area",2006,358812,7684,4010,5601,1591,3868,810,3058,-194
"11260",NA,2020,"Anchorage Municipality, AK","County or equivalent",2006,279362,3198,3196,4404,1208,145,763,-618,-143
"11260",NA,2170,"Matanuska-Susitna Borough, AK","County or equivalent",2006,79450,4486,814,1197,383,3723,47,3676,-51
"11300",NA,NA,"Anderson, IN","Metropolitan Statistical Area",2006,131012,409,262,1648,1386,209,74,135,-62
"11300",NA,18095,"Madison County, IN","County or equivalent",2006,131012,409,262,1648,1386,209,74,135,-62
"11340",NA,NA,"Anderson, SC","Metropolitan Statistical Area",2006,176958,2726,466,2328,1862,2355,110,2245,-95
"11340",NA,45007,"Anderson County, SC","County or equivalent",2006,176958,2726,466,2328,1862,2355,110,2245,-95
"11460",NA,NA,"Ann Arbor, MI","Metropolitan Statistical Area",2006,346185,2160,2368,4228,1860,-43,1735,-1778,-165
"11460",NA,26161,"Washtenaw County, MI","County or equivalent",2006,346185,2160,2368,4228,1860,-43,1735,-1778,-165
"11500",NA,NA,"Anniston-Oxford, AL","Metropolitan Statistical Area",2006,112581,628,119,1490,1371,564,53,511,-55
"11500",NA,1015,"Calhoun County, AL","County or equivalent",2006,112581,628,119,1490,1371,564,53,511,-55
"11540",NA,NA,"Appleton, WI","Metropolitan Statistical Area",2006,216125,2005,1507,2904,1397,604,194,410,-106
"11540",NA,55015,"Calumet County, WI","County or equivalent",2006,44199,155,372,637,265,-196,28,-224,-21
"11540",NA,55087,"Outagamie County, WI","County or equivalent",2006,171926,1850,1135,2267,1132,800,166,634,-85
"11700",NA,NA,"Asheville, NC","Metropolitan Statistical Area",2006,396985,6196,345,4627,4282,6064,701,5363,-213
"11700",NA,37021,"Buncombe County, NC","County or equivalent",2006,222528,3923,523,2665,2142,3517,400,3117,-117
"11700",NA,37087,"Haywood County, NC","County or equivalent",2006,56093,256,-74,581,655,360,21,339,-30
"11700",NA,37089,"Henderson County, NC","County or equivalent",2006,98279,1920,-83,1190,1273,2060,268,1792,-57
"11700",NA,37115,"Madison County, NC","County or equivalent",2006,20085,97,-21,191,212,127,12,115,-9
"12020",NA,NA,"Athens-Clarke County, GA","Metropolitan Statistical Area",2006,182702,3858,1170,2360,1190,2787,672,2115,-99
"12020",NA,13059,"Clarke County, GA","County or equivalent",2006,111240,2298,924,1567,643,1435,615,820,-61
"12020",NA,13195,"Madison County, GA","County or equivalent",2006,27531,321,83,334,251,253,21,232,-15
"12020",NA,13219,"Oconee County, GA","County or equivalent",2006,30266,1001,141,322,181,875,33,842,-15
"12020",NA,13221,"Oglethorpe County, GA","County or equivalent",2006,13665,238,22,137,115,224,3,221,-8
"12060",NA,NA,"Atlanta-Sandy Springs-Marietta, GA","Metropolitan Statistical Area",2006,5113924,168151,52301,80987,28686,117876,22215,95661,-2026
"12060",NA,13013,"Barrow County, GA","County or equivalent",2006,63044,3689,709,1109,400,3024,52,2972,-44
"12060",NA,13015,"Bartow County, GA","County or equivalent",2006,90188,2027,814,1501,687,1263,106,1157,-50
"12060",NA,13035,"Butts County, GA","County or equivalent",2006,23080,625,101,306,205,538,5,533,-14
"12060",NA,13045,"Carroll County, GA","County or equivalent",2006,108030,3636,774,1633,859,2927,163,2764,-65
"12060",NA,13057,"Cherokee County, GA","County or equivalent",2006,193676,10951,2419,3360,941,8659,425,8234,-127
"12060",NA,13063,"Clayton County, GA","County or equivalent",2006,268433,3789,3665,5034,1369,271,1273,-1002,-147
"12060",NA,13067,"Cobb County, GA","County or equivalent",2006,678245,17048,7876,11240,3364,9537,3652,5885,-365
"12060",NA,13077,"Coweta County, GA","County or equivalent",2006,113863,5169,904,1690,786,4340,211,4129,-75
"12060",NA,13085,"Dawson County, GA","County or equivalent",2006,20526,872,152,282,130,732,11,721,-12
"12060",NA,13089,"DeKalb County, GA","County or equivalent",2006,727139,10951,7479,11377,3898,3462,5896,-2434,10
"12060",NA,13097,"Douglas County, GA","County or equivalent",2006,118617,6315,1130,1827,697,5259,154,5105,-74
"12060",NA,13113,"Fayette County, GA","County or equivalent",2006,104580,2096,267,916,649,1889,186,1703,-60
"12060",NA,13117,"Forsyth County, GA","County or equivalent",2006,147855,9453,1707,2346,639,7849,309,7540,-103
"12060",NA,13121,"Fulton County, GA","County or equivalent",2006,964281,30039,7490,13378,5888,22546,4442,18104,3
"12060",NA,13135,"Gwinnett County, GA","County or equivalent",2006,746169,29351,10755,13682,2927,19041,4620,14421,-445
"12060",NA,13143,"Haralson County, GA","County or equivalent",2006,28256,146,96,402,306,64,10,54,-14
"12060",NA,13149,"Heard County, GA","County or equivalent",2006,11331,98,41,136,95,63,2,61,-6
"12060",NA,13151,"Henry County, GA","County or equivalent",2006,177116,10142,1847,2798,951,8409,103,8306,-114
"12060",NA,13159,"Jasper County, GA","County or equivalent",2006,13397,385,62,167,105,330,9,321,-7
"12060",NA,13171,"Lamar County, GA","County or equivalent",2006,16593,12,10,213,203,9,5,4,-7
"12060",NA,13199,"Meriwether County, GA","County or equivalent",2006,22963,151,54,305,251,109,1,108,-12
"12060",NA,13217,"Newton County, GA","County or equivalent",2006,90577,4880,928,1553,625,4011,57,3954,-59
"12060",NA,13223,"Paulding County, GA","County or equivalent",2006,119664,8594,1356,1923,567,7322,57,7265,-84
"12060",NA,13227,"Pickens County, GA","County or equivalent",2006,29217,1068,91,345,254,994,19,975,-17
"12060",NA,13231,"Pike County, GA","County or equivalent",2006,16543,573,59,184,125,524,1,523,-10
"12060",NA,13247,"Rockdale County, GA","County or equivalent",2006,79449,1688,548,1128,580,1182,322,860,-42
"12060",NA,13255,"Spalding County, GA","County or equivalent",2006,62112,879,379,1005,626,533,85,448,-33
"12060",NA,13297,"Walton County, GA","County or equivalent",2006,78980,3524,588,1147,559,2989,39,2950,-53
"12100",NA,NA,"Atlantic City-Hammonton, NJ","Metropolitan Statistical Area",2006,269329,1209,1016,3551,2535,318,1182,-864,-125
"12100",NA,34001,"Atlantic County, NJ","County or equivalent",2006,269329,1209,1016,3551,2535,318,1182,-864,-125
"12220",NA,NA,"Auburn-Opelika, AL","Metropolitan Statistical Area",2006,127925,2793,716,1568,852,2149,166,1983,-72
"12220",NA,1081,"Lee County, AL","County or equivalent",2006,127925,2793,716,1568,852,2149,166,1983,-72
"12260",NA,NA,"Augusta-Richmond County, GA-SC","Metropolitan Statistical Area",2006,522072,4993,2970,7574,4604,2285,674,1611,-262
"12260",NA,13033,"Burke County, GA","County or equivalent",2006,22637,-213,146,389,243,-350,5,-355,-9
"12260",NA,13073,"Columbia County, GA","County or equivalent",2006,105440,3231,769,1435,666,2519,124,2395,-57
"12260",NA,13189,"McDuffie County, GA","County or equivalent",2006,21534,143,112,339,227,42,5,37,-11
"12260",NA,13245,"Richmond County, GA","County or equivalent",2006,197203,479,1366,3202,1836,-793,376,-1169,-94
"12260",NA,45003,"Aiken County, SC","County or equivalent",2006,150125,1597,572,1965,1393,1106,154,952,-81
"12260",NA,45037,"Edgefield County, SC","County or equivalent",2006,25133,-244,5,244,239,-239,10,-249,-10
"12420",NA,NA,"Austin-Round Rock, TX","Metropolitan Statistical Area",2006,1527040,62477,17279,24483,7204,46115,7197,38918,-917
"12420",NA,48021,"Bastrop County, TX","County or equivalent",2006,70293,1542,430,941,511,1151,132,1019,-39
"12420",NA,48055,"Caldwell County, TX","County or equivalent",2006,36206,39,252,541,289,-198,36,-234,-15
"12420",NA,48209,"Hays County, TX","County or equivalent",2006,132887,6563,1121,1773,652,5524,150,5374,-82
"12420",NA,48453,"Travis County, TX","County or equivalent",2006,937541,35840,11381,15607,4226,24994,6260,18734,-535
"12420",NA,48491,"Williamson County, TX","County or equivalent",2006,350113,18493,4095,5621,1526,14644,619,14025,-246
"12540",NA,NA,"Bakersfield, CA","Metropolitan Statistical Area",2006,770221,21455,9136,14645,5509,12740,2611,10129,-421
"12540",NA,6029,"Kern County, CA","County or equivalent",2006,770221,21455,9136,14645,5509,12740,2611,10129,-421
"12580",NA,NA,"Baltimore-Towson, MD","Metropolitan Statistical Area",2006,2658022,11031,12016,34886,22870,-2047,4526,-6573,1062
"12580",NA,24003,"Anne Arundel County, MD","County or equivalent",2006,509037,-377,3110,6813,3703,-3271,820,-4091,-216
"12580",NA,24005,"Baltimore County, MD","County or equivalent",2006,785200,3748,2244,9833,7589,1880,1579,301,-376
"12580",NA,24013,"Carroll County, MD","County or equivalent",2006,168180,1360,595,1896,1301,851,64,787,-86
"12580",NA,24025,"Harford County, MD","County or equivalent",2006,239193,2099,1330,3047,1717,883,192,691,-114
"12580",NA,24027,"Howard County, MD","County or equivalent",2006,269631,2498,2091,3364,1273,537,917,-380,-130
"12580",NA,24035,"Queen Anne's County, MD","County or equivalent",2006,45820,806,153,519,366,676,35,641,-23
"12580",NA,24510,"Baltimore city, MD","County or equivalent",2006,640961,897,2493,9414,6921,-3603,919,-4522,2007
"12620",NA,NA,"Bangor, ME","Metropolitan Statistical Area",2006,147839,937,164,1603,1439,845,104,741,-72
"12620",NA,23019,"Penobscot County, ME","County or equivalent",2006,147839,937,164,1603,1439,845,104,741,-72
"12700",NA,NA,"Barnstable Town, MA","Metropolitan Statistical Area",2006,223315,-1598,-775,1931,2706,-722,345,-1067,-101
"12700",NA,25001,"Barnstable County, MA","County or equivalent",2006,223315,-1598,-775,1931,2706,-722,345,-1067,-101
"12940",NA,NA,"Baton Rouge, LA","Metropolitan Statistical Area",2006,763588,34222,4498,10759,6261,30247,771,29476,-523
"12940",NA,22005,"Ascension Parish, LA","County or equivalent",2006,95518,6400,1051,1593,542,5423,73,5350,-74
"12940",NA,22033,"East Baton Rouge Parish, LA","County or equivalent",2006,430614,19030,2277,5921,3644,17054,667,16387,-301
"12940",NA,22037,"East Feliciana Parish, LA","County or equivalent",2006,21010,475,38,270,232,448,0,448,-11
"12940",NA,22047,"Iberville Parish, LA","County or equivalent",2006,32800,597,85,435,350,528,3,525,-16
"12940",NA,22063,"Livingston Parish, LA","County or equivalent",2006,113186,5796,920,1716,796,4952,19,4933,-76
"12940",NA,22077,"Pointe Coupee Parish, LA","County or equivalent",2006,22370,563,61,302,241,516,1,515,-14
"12940",NA,22091,"St. Helena Parish, LA","County or equivalent",2006,10667,496,-7,111,118,511,0,511,-8
"12940",NA,22121,"West Baton Rouge Parish, LA","County or equivalent",2006,22184,666,106,311,205,575,5,570,-15
"12940",NA,22125,"West Feliciana Parish, LA","County or equivalent",2006,15239,199,-33,100,133,240,3,237,-8
"12980",NA,NA,"Battle Creek, MI","Metropolitan Statistical Area",2006,137192,-868,424,1818,1394,-1233,154,-1387,-59
"12980",NA,26025,"Calhoun County, MI","County or equivalent",2006,137192,-868,424,1818,1394,-1233,154,-1387,-59
"13020",NA,NA,"Bay City, MI","Metropolitan Statistical Area",2006,107927,-604,158,1233,1075,-716,25,-741,-46
"13020",NA,26017,"Bay County, MI","County or equivalent",2006,107927,-604,158,1233,1075,-716,25,-741,-46
"13140",NA,NA,"Beaumont-Port Arthur, TX","Metropolitan Statistical Area",2006,373847,-6472,899,4894,3995,-7233,493,-7726,-138
"13140",NA,48199,"Hardin County, TX","County or equivalent",2006,50721,95,122,620,498,-4,9,-13,-23
"13140",NA,48245,"Jefferson County, TX","County or equivalent",2006,240964,-5179,604,3208,2604,-5698,441,-6139,-85
"13140",NA,48361,"Orange County, TX","County or equivalent",2006,82162,-1388,173,1066,893,-1531,43,-1574,-30
"13380",NA,NA,"Bellingham, WA","Metropolitan Statistical Area",2006,188289,3109,861,2171,1310,2351,517,1834,-103
"13380",NA,53073,"Whatcom County, WA","County or equivalent",2006,188289,3109,861,2171,1310,2351,517,1834,-103
"13460",NA,NA,"Bend, OR","Metropolitan Statistical Area",2006,148827,7885,813,1876,1063,7173,75,7098,-101
"13460",NA,41017,"Deschutes County, OR","County or equivalent",2006,148827,7885,813,1876,1063,7173,75,7098,-101
"13740",NA,NA,"Billings, MT","Metropolitan Statistical Area",2006,147658,1465,683,1990,1307,857,31,826,-75
"13740",NA,30009,"Carbon County, MT","County or equivalent",2006,9687,-59,-17,83,100,-38,4,-42,-4
"13740",NA,30111,"Yellowstone County, MT","County or equivalent",2006,137971,1524,700,1907,1207,895,27,868,-71
"13780",NA,NA,"Binghamton, NY","Metropolitan Statistical Area",2006,246440,-395,169,2581,2412,-447,331,-778,-117
"13780",NA,36007,"Broome County, NY","County or equivalent",2006,195942,-185,37,2041,2004,-131,313,-444,-91
"13780",NA,36107,"Tioga County, NY","County or equivalent",2006,50498,-210,132,540,408,-316,18,-334,-26
"13820",NA,NA,"Birmingham-Hoover, AL","Metropolitan Statistical Area",2006,1100286,11983,4130,15198,11068,7880,1114,6766,-27
"13820",NA,1007,"Bibb County, AL","County or equivalent",2006,21307,-68,35,268,233,-94,7,-101,-9
"13820",NA,1009,"Blount County, AL","County or equivalent",2006,55708,793,129,675,546,692,83,609,-28
"13820",NA,1021,"Chilton County, AL","County or equivalent",2006,41672,241,94,537,443,166,32,134,-19
"13820",NA,1073,"Jefferson County, AL","County or equivalent",2006,659403,1289,2186,9285,7099,-904,796,-1700,7
"13820",NA,1115,"St. Clair County, AL","County or equivalent",2006,74934,2965,259,983,724,2751,14,2737,-45
"13820",NA,1117,"Shelby County, AL","County or equivalent",2006,178289,6915,1559,2636,1077,5258,155,5103,98
"13820",NA,1127,"Walker County, AL","County or equivalent",2006,68973,-152,-132,814,946,11,27,-16,-31
"13900",NA,NA,"Bismarck, ND","Metropolitan Statistical Area",2006,101155,1767,594,1360,766,1226,43,1183,-53
"13900",NA,38015,"Burleigh County, ND","County or equivalent",2006,75636,1500,499,1014,515,1041,34,1007,-40
"13900",NA,38059,"Morton County, ND","County or equivalent",2006,25519,267,95,346,251,185,9,176,-13
"13980",NA,NA,"Blacksburg-Christiansburg-Radford, VA","Metropolitan Statistical Area",2006,155792,1376,159,1425,1266,1294,337,957,-77
"13980",NA,51071,"Giles County, VA","County or equivalent",2006,17179,190,-47,151,198,247,0,247,-10
"13980",NA,51121,"Montgomery County, VA","County or equivalent",2006,87850,960,319,829,510,683,317,366,-42
"13980",NA,51155,"Pulaski County, VA","County or equivalent",2006,34789,101,-115,315,430,232,5,227,-16
"13980",NA,51750,"Radford city, VA","County or equivalent",2006,15974,125,2,130,128,132,15,117,-9
"14020",NA,NA,"Bloomington, IN","Metropolitan Statistical Area",2006,181543,1589,624,1904,1280,1054,401,653,-89
"14020",NA,18055,"Greene County, IN","County or equivalent",2006,32895,-147,28,373,345,-160,4,-164,-15
"14020",NA,18105,"Monroe County, IN","County or equivalent",2006,126348,1803,545,1292,747,1322,395,927,-64
"14020",NA,18119,"Owen County, IN","County or equivalent",2006,22300,-67,51,239,188,-108,2,-110,-10
"14060",NA,NA,"Bloomington-Normal, IL","Metropolitan Statistical Area",2006,161630,2281,1134,2166,1032,1229,235,994,-82
"14060",NA,17113,"McLean County, IL","County or equivalent",2006,161630,2281,1134,2166,1032,1229,235,994,-82
"14260",NA,NA,"Boise City-Nampa, ID","Metropolitan Statistical Area",2006,566386,22468,5796,9420,3624,17033,1034,15999,-361
"14260",NA,16001,"Ada County, ID","County or equivalent",2006,360869,14120,3426,5604,2178,10923,638,10285,-229
"14260",NA,16015,"Boise County, ID","County or equivalent",2006,7441,216,1,50,49,220,6,214,-5
"14260",NA,16027,"Canyon County, ID","County or equivalent",2006,171116,7877,2217,3358,1141,5771,326,5445,-111
"14260",NA,16045,"Gem County, ID","County or equivalent",2006,16265,255,64,236,172,202,24,178,-11
"14260",NA,16073,"Owyhee County, ID","County or equivalent",2006,10695,0,88,172,84,-83,40,-123,-5
"14460",NA,NA,"Boston-Cambridge-Quincy, MA-NH","Metropolitan Statistical Area",2006,4467233,12274,20846,54932,34086,-12434,20554,-32988,3862
"14460",14484,NA,"Boston-Quincy, MA","Metropolitan Division",2006,1856724,6199,8654,22890,14236,-6841,9531,-16372,4386
"14460",14484,25021,"Norfolk County, MA","County or equivalent",2006,652980,1551,2252,7685,5433,-382,1989,-2371,-319
"14460",14484,25023,"Plymouth County, MA","County or equivalent",2006,488294,529,1908,5904,3996,-1151,723,-1874,-228
"14460",14484,25025,"Suffolk County, MA","County or equivalent",2006,715450,4119,4494,9301,4807,-5308,6819,-12127,4933
"14460",15764,NA,"Cambridge-Newton-Framingham, MA","Metropolitan Division",2006,1463654,1630,6895,17798,10903,-5263,8116,-13379,-2
"14460",15764,25017,"Middlesex County, MA","County or equivalent",2006,1463654,1630,6895,17798,10903,-5263,8116,-13379,-2
"14460",37764,NA,"Peabody, MA","Metropolitan Division",2006,731179,627,2875,9026,6151,-1926,2580,-4506,-322
"14460",37764,25009,"Essex County, MA","County or equivalent",2006,731179,627,2875,9026,6151,-1926,2580,-4506,-322
"14460",40484,NA,"Rockingham County-Strafford County, NH","Metropolitan Division",2006,415676,3818,2422,5218,2796,1596,327,1269,-200
"14460",40484,33015,"Rockingham County, NH","County or equivalent",2006,295180,2303,1773,3720,1947,671,210,461,-141
"14460",40484,33017,"Strafford County, NH","County or equivalent",2006,120496,1515,649,1498,849,925,117,808,-59
"14500",NA,NA,"Boulder, CO /1","Metropolitan Statistical Area",2006,285050,2935,2051,3529,1478,1022,1282,-260,-138
"14500",NA,8013,"Boulder County, CO /1","County or equivalent",2006,285050,2935,2051,3529,1478,1022,1282,-260,-138
"14540",NA,NA,"Bowling Green, KY","Metropolitan Statistical Area",2006,113883,2523,643,1529,886,1940,304,1636,-60
"14540",NA,21061,"Edmonson County, KY","County or equivalent",2006,11869,-49,2,117,115,-47,3,-50,-4
"14540",NA,21227,"Warren County, KY","County or equivalent",2006,102014,2572,641,1412,771,1987,301,1686,-56
"14600",NA,NA,"Bradenton-Sarasota-Venice, FL","Metropolitan Statistical Area",2006,678840,11266,-1171,7060,8231,12792,1701,11091,-355
"14600",NA,12081,"Manatee County, FL","County or equivalent",2006,311504,7151,653,4020,3367,6664,821,5843,-166
"14600",NA,12115,"Sarasota County, FL","County or equivalent",2006,367336,4115,-1824,3040,4864,6128,880,5248,-189
"14740",NA,NA,"Bremerton-Silverdale, WA","Metropolitan Statistical Area",2006,239771,3747,1300,3016,1716,2571,456,2115,-124
"14740",NA,53035,"Kitsap County, WA","County or equivalent",2006,239771,3747,1300,3016,1716,2571,456,2115,-124
"14860",NA,NA,"Bridgeport-Stamford-Norwalk, CT","Metropolitan Statistical Area",2006,890512,-1326,5075,11640,6565,-5992,5671,-11663,-409
"14860",NA,9001,"Fairfield County, CT","County or equivalent",2006,890512,-1326,5075,11640,6565,-5992,5671,-11663,-409
"15180",NA,NA,"Brownsville-Harlingen, TX","Metropolitan Statistical Area",2006,378181,6689,6574,8613,2039,309,1733,-1424,-194
"15180",NA,48061,"Cameron County, TX","County or equivalent",2006,378181,6689,6574,8613,2039,309,1733,-1424,-194
"15260",NA,NA,"Brunswick, GA","Metropolitan Statistical Area",2006,99819,2266,327,1361,1034,1992,116,1876,-53
"15260",NA,13025,"Brantley County, GA","County or equivalent",2006,15403,127,-17,155,172,152,4,148,-8
"15260",NA,13127,"Glynn County, GA","County or equivalent",2006,73291,1923,314,1066,752,1648,111,1537,-39
"15260",NA,13191,"McIntosh County, GA","County or equivalent",2006,11125,216,30,140,110,192,1,191,-6
"15380",NA,NA,"Buffalo-Niagara Falls, NY","Metropolitan Statistical Area",2006,1131989,-8320,521,12016,11495,-8347,1366,-9713,-494
"15380",NA,36029,"Erie County, NY","County or equivalent",2006,917209,-7539,537,9845,9308,-7674,1204,-8878,-402
"15380",NA,36063,"Niagara County, NY","County or equivalent",2006,214780,-781,-16,2171,2187,-673,162,-835,-92
"15500",NA,NA,"Burlington, NC","Metropolitan Statistical Area",2006,141492,2012,529,1849,1320,1555,548,1007,-72
"15500",NA,37001,"Alamance County, NC","County or equivalent",2006,141492,2012,529,1849,1320,1555,548,1007,-72
"15540",NA,NA,"Burlington-South Burlington, VT","Metropolitan Statistical Area",2006,206255,907,904,2230,1326,103,402,-299,-100
"15540",NA,50007,"Chittenden County, VT","County or equivalent",2006,151021,744,633,1585,952,184,379,-195,-73
"15540",NA,50011,"Franklin County, VT","County or equivalent",2006,47698,195,266,586,320,-48,23,-71,-23
"15540",NA,50013,"Grand Isle County, VT","County or equivalent",2006,7536,-32,5,59,54,-33,0,-33,-4
"15940",NA,NA,"Canton-Massillon, OH","Metropolitan Statistical Area",2006,407344,-211,752,4811,4059,-953,76,-1029,-10
"15940",NA,39019,"Carroll County, OH","County or equivalent",2006,28781,-102,50,310,260,-139,2,-141,-13
"15940",NA,39151,"Stark County, OH","County or equivalent",2006,378563,-109,702,4501,3799,-814,74,-888,3
"15980",NA,NA,"Cape Coral-Fort Myers, FL","Metropolitan Statistical Area",2006,568287,27128,1184,7047,5863,26297,1642,24655,-353
"15980",NA,12071,"Lee County, FL","County or equivalent",2006,568287,27128,1184,7047,5863,26297,1642,24655,-353
"16180",NA,NA,"Carson City, NV","Metropolitan Statistical Area",2006,54983,-583,144,766,622,-707,168,-875,-20
"16180",NA,32510,"Carson City, NV","County or equivalent",2006,54983,-583,144,766,622,-707,168,-875,-20
"16220",NA,NA,"Casper, WY","Metropolitan Statistical Area",2006,70220,812,356,983,627,491,35,456,-35
"16220",NA,56025,"Natrona County, WY","County or equivalent",2006,70220,812,356,983,627,491,35,456,-35
"16300",NA,NA,"Cedar Rapids, IA","Metropolitan Statistical Area",2006,249383,2232,1377,3385,2008,864,231,633,-9
"16300",NA,19011,"Benton County, IA","County or equivalent",2006,26564,-83,49,289,240,-131,4,-135,-1
"16300",NA,19105,"Jones County, IA","County or equivalent",2006,20331,18,33,215,182,-5,1,-6,-10
"16300",NA,19113,"Linn County, IA","County or equivalent",2006,202488,2297,1295,2881,1586,1000,226,774,2
"16580",NA,NA,"Champaign-Urbana, IL","Metropolitan Statistical Area",2006,221242,2748,1352,2878,1526,1507,846,661,-111
"16580",NA,17019,"Champaign County, IL","County or equivalent",2006,190738,2718,1369,2528,1159,1445,838,607,-96
"16580",NA,17053,"Ford County, IL","County or equivalent",2006,14007,23,-41,171,212,71,5,66,-7
"16580",NA,17147,"Piatt County, IL","County or equivalent",2006,16497,7,24,179,155,-9,3,-12,-8
"16620",NA,NA,"Charleston, WV","Metropolitan Statistical Area",2006,303600,-877,175,3728,3553,-918,81,-999,-134
"16620",NA,54005,"Boone County, WV","County or equivalent",2006,25142,-176,-6,312,318,-160,6,-166,-10
"16620",NA,54015,"Clay County, WV","County or equivalent",2006,10057,-81,-10,136,146,-65,0,-65,-6
"16620",NA,54039,"Kanawha County, WV","County or equivalent",2006,191752,-1089,-23,2374,2397,-983,67,-1050,-83
"16620",NA,54043,"Lincoln County, WV","County or equivalent",2006,22303,-19,42,268,226,-51,0,-51,-10
"16620",NA,54079,"Putnam County, WV","County or equivalent",2006,54346,488,172,638,466,341,8,333,-25
"16700",NA,NA,"Charleston-North Charleston-Summerville, SC","Metropolitan Statistical Area",2006,616642,15480,4309,8791,4482,11341,1038,10303,-170
"16700",NA,45015,"Berkeley County, SC","County or equivalent",2006,158382,5694,1276,2270,994,4509,291,4218,-91
"16700",NA,45019,"Charleston County, SC","County or equivalent",2006,340625,3760,2138,4891,2753,1632,628,1004,-10
"16700",NA,45035,"Dorchester County, SC","County or equivalent",2006,117635,6026,895,1630,735,5200,119,5081,-69
"16740",NA,NA,"Charlotte-Gastonia-Concord, NC-SC","Metropolitan Statistical Area",2006,1580070,61582,14034,24806,10772,48467,5172,43295,-919
"16740",NA,37007,"Anson County, NC","County or equivalent",2006,25314,-166,49,321,272,-205,6,-211,-10
"16740",NA,37025,"Cabarrus County, NC","County or equivalent",2006,155130,6296,1080,2409,1329,5308,342,4966,-92
"16740",NA,37071,"Gaston County, NC","County or equivalent",2006,197579,2911,704,2651,1947,2307,452,1855,-100
"16740",NA,37119,"Mecklenburg County, NC","County or equivalent",2006,832078,32284,9295,14021,4726,23467,3738,19729,-478
"16740",NA,37179,"Union County, NC","County or equivalent",2006,171760,11218,1627,2625,998,9706,456,9250,-115
"16740",NA,45091,"York County, SC","County or equivalent",2006,198209,9039,1279,2779,1500,7884,178,7706,-124
"16820",NA,NA,"Charlottesville, VA","Metropolitan Statistical Area",2006,190191,2536,975,2386,1411,1640,467,1173,-79
"16820",NA,51003,"Albemarle County, VA","County or equivalent",2006,91870,1604,420,1082,662,1233,301,932,-49
"16820",NA,51065,"Fluvanna County, VA","County or equivalent",2006,24788,328,154,359,205,186,6,180,-12
"16820",NA,51079,"Greene County, VA","County or equivalent",2006,17551,376,152,279,127,234,6,228,-10
"16820",NA,51125,"Nelson County, VA","County or equivalent",2006,15000,51,-22,131,153,81,1,80,-8
"16820",NA,51540,"Charlottesville city, VA","County or equivalent",2006,40982,177,271,535,264,-94,153,-247,0
"16860",NA,NA,"Chattanooga, TN-GA","Metropolitan Statistical Area",2006,509196,6901,1256,6141,4885,3525,477,3048,2120
"16860",NA,13047,"Catoosa County, GA","County or equivalent",2006,60807,1116,170,669,499,977,27,950,-31
"16860",NA,13083,"Dade County, GA","County or equivalent",2006,15978,107,-10,154,164,125,8,117,-8
"16860",NA,13295,"Walker County, GA","County or equivalent",2006,63786,626,105,751,646,553,28,525,-32
"16860",NA,47065,"Hamilton County, TN","County or equivalent",2006,327620,4458,921,4060,3139,1325,404,921,2212
"16860",NA,47115,"Marion County, TN","County or equivalent",2006,27972,255,16,340,324,253,3,250,-14
"16860",NA,47153,"Sequatchie County, TN","County or equivalent",2006,13033,339,54,167,113,292,7,285,-7
"16940",NA,NA,"Cheyenne, WY","Metropolitan Statistical Area",2006,85890,586,639,1330,691,-10,144,-154,-43
"16940",NA,56021,"Laramie County, WY","County or equivalent",2006,85890,586,639,1330,691,-10,144,-154,-43
"16980",NA,NA,"Chicago-Naperville-Joliet, IL-IN-WI","Metropolitan Statistical Area",2006,9439805,49114,70484,138253,67769,-21807,47735,-69542,437
"16980",16974,NA,"Chicago-Naperville-Joliet, IL","Metropolitan Division",2006,7883651,36349,60528,116793,56265,-24468,43126,-67594,289
"16980",16974,17031,"Cook County, IL","County or equivalent",2006,5270146,-18563,36969,78357,41388,-55565,34239,-89804,33
"16980",16974,17037,"DeKalb County, IL","County or equivalent",2006,102573,3118,651,1260,609,2463,259,2204,4
"16980",16974,17043,"DuPage County, IL","County or equivalent",2006,925473,317,6362,12102,5740,-6184,4497,-10681,139
"16980",16974,17063,"Grundy County, IL","County or equivalent",2006,45512,2053,381,694,313,1697,32,1665,-25
"16980",16974,17089,"Kane County, IL","County or equivalent",2006,487279,10065,5976,8631,2655,3978,2478,1500,111
"16980",16974,17093,"Kendall County, IL","County or equivalent",2006,87453,8422,1141,1536,395,7269,63,7206,12
"16980",16974,17111,"McHenry County, IL","County or equivalent",2006,309025,6920,2575,4293,1718,4353,636,3717,-8
"16980",16974,17197,"Will County, IL","County or equivalent",2006,656190,24017,6473,9920,3447,17521,922,16599,23
"16980",23844,NA,"Gary, IN","Metropolitan Division",2006,693127,4279,2956,9301,6345,1655,684,971,-332
"16980",23844,18073,"Jasper County, IN","County or equivalent",2006,31811,541,148,436,288,410,11,399,-17
"16980",23844,18089,"Lake County, IN","County or equivalent",2006,489269,1577,2180,6888,4708,-373,535,-908,-230
"16980",23844,18111,"Newton County, IN","County or equivalent",2006,13988,-208,-19,120,139,-184,12,-196,-5
"16980",23844,18127,"Porter County, IN","County or equivalent",2006,158059,2369,647,1857,1210,1802,126,1676,-80
"16980",29404,NA,"Lake County-Kenosha County, IL-WI","Metropolitan Division",2006,863027,8486,7000,12159,5159,1006,3925,-2919,480
"16980",29404,17097,"Lake County, IL","County or equivalent",2006,701754,6892,6120,9987,3867,210,3720,-3510,562
"16980",29404,55059,"Kenosha County, WI","County or equivalent",2006,161273,1594,880,2172,1292,796,205,591,-82
"17020",NA,NA,"Chico, CA","Metropolitan Statistical Area",2006,217131,2258,274,2571,2297,2095,384,1711,-111
"17020",NA,6007,"Butte County, CA","County or equivalent",2006,217131,2258,274,2571,2297,2095,384,1711,-111
"17140",NA,NA,"Cincinnati-Middletown, OH-KY-IN","Metropolitan Statistical Area",2006,2119959,18744,12133,29706,17573,1444,2124,-680,5167
"17140",NA,18029,"Dearborn County, IN","County or equivalent",2006,49095,477,229,625,396,272,10,262,-24
"17140",NA,18047,"Franklin County, IN","County or equivalent",2006,23018,87,88,284,196,10,2,8,-11
"17140",NA,18115,"Ohio County, IN","County or equivalent",2006,5823,-23,-1,54,55,-19,0,-19,-3
"17140",NA,21015,"Boone County, KY","County or equivalent",2006,108967,3531,1122,1707,585,2472,165,2307,-63
"17140",NA,21023,"Bracken County, KY","County or equivalent",2006,8554,-64,44,118,74,-103,0,-103,-5
"17140",NA,21037,"Campbell County, KY","County or equivalent",2006,86738,-225,382,1196,814,-570,59,-629,-37
"17140",NA,21077,"Gallatin County, KY","County or equivalent",2006,8037,-6,79,145,66,-82,0,-82,-3
"17140",NA,21081,"Grant County, KY","County or equivalent",2006,24790,364,234,440,206,144,9,135,-14
"17140",NA,21117,"Kenton County, KY","County or equivalent",2006,155019,1645,1083,2438,1355,638,100,538,-76
"17140",NA,21191,"Pendleton County, KY","County or equivalent",2006,15013,91,52,187,135,47,7,40,-8
"17140",NA,39015,"Brown County, OH","County or equivalent",2006,43715,34,135,567,432,-81,6,-87,-20
"17140",NA,39017,"Butler County, OH","County or equivalent",2006,353486,5243,2245,4973,2728,3176,291,2885,-178
"17140",NA,39025,"Clermont County, OH","County or equivalent",2006,191703,2390,1385,2787,1402,1100,92,1008,-95
"17140",NA,39061,"Hamilton County, OH","County or equivalent",2006,847184,459,3562,11472,7910,-8917,1252,-10169,5814
"17140",NA,39165,"Warren County, OH","County or equivalent",2006,198817,4741,1494,2713,1219,3357,131,3226,-110
"17300",NA,NA,"Clarksville, TN-KY","Metropolitan Statistical Area",2006,252454,894,2803,4634,1831,-4892,823,-5715,2983
"17300",NA,21047,"Christian County, KY","County or equivalent",2006,78459,378,997,1596,599,-3683,334,-4017,3064
"17300",NA,21221,"Trigg County, KY","County or equivalent",2006,13163,56,-14,132,146,77,8,69,-7
"17300",NA,47125,"Montgomery County, TN","County or equivalent",2006,147961,466,1842,2776,934,-1309,475,-1784,-67
"17300",NA,47161,"Stewart County, TN","County or equivalent",2006,12871,-6,-22,130,152,23,6,17,-7
"17420",NA,NA,"Cleveland, TN","Metropolitan Statistical Area",2006,109325,1385,320,1411,1091,1119,98,1021,-54
"17420",NA,47011,"Bradley County, TN","County or equivalent",2006,93596,1411,360,1226,866,1098,96,1002,-47
"17420",NA,47139,"Polk County, TN","County or equivalent",2006,15729,-26,-40,185,225,21,2,19,-7
"17460",NA,NA,"Cleveland-Elyria-Mentor, OH","Metropolitan Statistical Area",2006,2103850,-12454,5364,25968,20604,-17153,3334,-20487,-665
"17460",NA,39035,"Cuyahoga County, OH","County or equivalent",2006,1307936,-17488,2454,16571,14117,-19406,2607,-22013,-536
"17460",NA,39055,"Geauga County, OH","County or equivalent",2006,94577,254,358,1061,703,-60,26,-86,-44
"17460",NA,39085,"Lake County, OH","County or equivalent",2006,232318,310,429,2548,2119,-118,365,-483,-1
"17460",NA,39093,"Lorain County, OH","County or equivalent",2006,301215,2326,1103,3669,2566,1223,244,979,0
"17460",NA,39103,"Medina County, OH","County or equivalent",2006,167804,2144,1020,2119,1099,1208,92,1116,-84
"17660",NA,NA,"Coeur d'Alene, ID","Metropolitan Statistical Area",2006,130530,3788,659,1592,933,3210,42,3168,-81
"17660",NA,16055,"Kootenai County, ID","County or equivalent",2006,130530,3788,659,1592,933,3210,42,3168,-81
"17780",NA,NA,"College Station-Bryan, TX","Metropolitan Statistical Area",2006,200047,3692,1708,2889,1181,2090,978,1112,-106
"17780",NA,48041,"Brazos County, TX","County or equivalent",2006,167597,3989,1630,2454,824,2452,952,1500,-93
"17780",NA,48051,"Burleson County, TX","County or equivalent",2006,16588,-250,43,206,163,-287,9,-296,-6
"17780",NA,48395,"Robertson County, TX","County or equivalent",2006,15862,-47,35,229,194,-75,17,-92,-7
"17820",NA,NA,"Colorado Springs, CO","Metropolitan Statistical Area",2006,601437,12719,5289,8849,3560,7434,1618,5816,-4
"17820",NA,8041,"El Paso County, CO","County or equivalent",2006,579930,12514,5210,8645,3435,7297,1614,5683,7
"17820",NA,8119,"Teller County, CO","County or equivalent",2006,21507,205,79,204,125,137,4,133,-11
"17860",NA,NA,"Columbia, MO","Metropolitan Statistical Area",2006,159415,3335,1122,2084,962,2297,356,1941,-84
"17860",NA,29019,"Boone County, MO","County or equivalent",2006,149513,3340,1116,1974,858,2304,355,1949,-80
"17860",NA,29089,"Howard County, MO","County or equivalent",2006,9902,-5,6,110,104,-7,1,-8,-4
"17900",NA,NA,"Columbia, SC","Metropolitan Statistical Area",2006,702914,12197,4111,9725,5614,8454,1256,7198,-368
"17900",NA,45017,"Calhoun County, SC","County or equivalent",2006,14782,-80,4,173,169,-77,5,-82,-7
"17900",NA,45039,"Fairfield County, SC","County or equivalent",2006,23608,-69,37,322,285,-95,2,-97,-11
"17900",NA,45055,"Kershaw County, SC","County or equivalent",2006,57010,1225,297,790,493,956,16,940,-28
"17900",NA,45063,"Lexington County, SC","County or equivalent",2006,237957,4968,1422,3281,1859,3677,335,3342,-131
"17900",NA,45079,"Richland County, SC","County or equivalent",2006,350847,6108,2276,4887,2611,4014,798,3216,-182
"17900",NA,45081,"Saluda County, SC","County or equivalent",2006,18710,45,75,272,197,-21,100,-121,-9
"17980",NA,NA,"Columbus, GA-AL","Metropolitan Statistical Area",2006,289967,1976,1572,4314,2742,538,830,-292,-134
"17980",NA,1113,"Russell County, AL","County or equivalent",2006,49642,623,150,747,597,497,56,441,-24
"17980",NA,13053,"Chattahoochee County, GA","County or equivalent",2006,13458,-2795,159,190,31,-2964,200,-3164,10
"17980",NA,13145,"Harris County, GA","County or equivalent",2006,28276,938,106,321,215,847,13,834,-15
"17980",NA,13197,"Marion County, GA","County or equivalent",2006,7013,14,5,88,83,13,20,-7,-4
"17980",NA,13215,"Muscogee County, GA","County or equivalent",2006,191578,3196,1152,2968,1816,2145,541,1604,-101
"18020",NA,NA,"Columbus, IN","Metropolitan Statistical Area",2006,73889,820,451,1092,641,409,194,215,-40
"18020",NA,18005,"Bartholomew County, IN","County or equivalent",2006,73889,820,451,1092,641,409,194,215,-40
"18140",NA,NA,"Columbus, OH","Metropolitan Statistical Area",2006,1732478,20230,13808,26400,12592,7182,3709,3473,-760
"18140",NA,39041,"Delaware County, OH","County or equivalent",2006,155315,5981,1760,2455,695,4218,58,4160,3
"18140",NA,39045,"Fairfield County, OH","County or equivalent",2006,139387,1876,832,1846,1014,1113,21,1092,-69
"18140",NA,39049,"Franklin County, OH","County or equivalent",2006,1107090,8272,9593,17737,8144,-789,3532,-4321,-532
"18140",NA,39089,"Licking County, OH","County or equivalent",2006,155315,1341,797,2105,1308,620,52,568,-76
"18140",NA,39097,"Madison County, OH","County or equivalent",2006,41259,450,159,495,336,310,28,282,-19
"18140",NA,39117,"Morrow County, OH","County or equivalent",2006,34189,162,164,439,275,14,3,11,-16
"18140",NA,39129,"Pickaway County, OH","County or equivalent",2006,53308,924,155,632,477,796,3,793,-27
"18140",NA,39159,"Union County, OH","County or equivalent",2006,46615,1224,348,691,343,900,12,888,-24
"18580",NA,NA,"Corpus Christi, TX","Metropolitan Statistical Area",2006,412661,2152,3245,6390,3145,-894,634,-1528,-199
"18580",NA,48007,"Aransas County, TX","County or equivalent",2006,24396,16,10,282,272,20,33,-13,-14
"18580",NA,48355,"Nueces County, TX","County or equivalent",2006,319758,2144,2646,5007,2361,-348,490,-838,-154
"18580",NA,48409,"San Patricio County, TX","County or equivalent",2006,68507,-8,589,1101,512,-566,111,-677,-31
"18700",NA,NA,"Corvallis, OR","Metropolitan Statistical Area",2006,80110,658,303,791,488,396,297,99,-41
"18700",NA,41003,"Benton County, OR","County or equivalent",2006,80110,658,303,791,488,396,297,99,-41
"19060",NA,NA,"Cumberland, MD-WV","Metropolitan Statistical Area",2006,99097,-449,-247,977,1224,-155,16,-171,-47
"19060",NA,24001,"Allegany County, MD","County or equivalent",2006,72415,-301,-207,702,909,-61,11,-72,-33
"19060",NA,54057,"Mineral County, WV","County or equivalent",2006,26682,-148,-40,275,315,-94,5,-99,-14
"19100",NA,NA,"Dallas-Fort Worth-Arlington, TX","Metropolitan Statistical Area",2006,5995596,177900,68279,101274,32995,106891,35458,71433,2730
"19100",19124,NA,"Dallas-Plano-Irving, TX","Metropolitan Division",2006,4026246,122274,47891,68887,20996,70569,27318,43251,3814
"19100",19124,48085,"Collin County, TX","County or equivalent",2006,697611,37487,8378,10730,2352,28929,2783,26146,180
"19100",19124,48113,"Dallas County, TX","County or equivalent",2006,2355200,38026,29421,43163,13742,4963,22236,-17273,3642
"19100",19124,48119,"Delta County, TX","County or equivalent",2006,5492,56,-7,59,66,66,0,66,-3
"19100",19124,48121,"Denton County, TX","County or equivalent",2006,588081,30252,7170,9261,2091,22977,1566,21411,105
"19100",19124,48139,"Ellis County, TX","County or equivalent",2006,137476,5642,1214,2091,877,4510,309,4201,-82
"19100",19124,48231,"Hunt County, TX","County or equivalent",2006,82215,743,354,1156,802,429,176,253,-40
"19100",19124,48257,"Kaufman County, TX","County or equivalent",2006,91854,3986,709,1418,709,3271,160,3111,6
"19100",19124,48397,"Rockwall County, TX","County or equivalent",2006,68317,6082,652,1009,357,5424,88,5336,6
"19100",23104,NA,"Fort Worth-Arlington, TX","Metropolitan Division",2006,1969350,55626,20388,32387,11999,36322,8140,28182,-1084
"19100",23104,48251,"Johnson County, TX","County or equivalent",2006,145914,2071,997,2055,1058,1148,220,928,-74
"19100",23104,48367,"Parker County, TX","County or equivalent",2006,104543,3251,427,1187,760,2881,74,2807,-57
"19100",23104,48439,"Tarrant County, TX","County or equivalent",2006,1662215,49346,18666,28402,9736,31602,7755,23847,-922
"19100",23104,48497,"Wise County, TX","County or equivalent",2006,56678,958,298,743,445,691,91,600,-31
"19140",NA,NA,"Dalton, GA","Metropolitan Statistical Area",2006,131909,1777,1526,2522,996,320,824,-504,-69
"19140",NA,13213,"Murray County, GA","County or equivalent",2006,40592,472,371,678,307,122,55,67,-21
"19140",NA,13313,"Whitfield County, GA","County or equivalent",2006,91317,1305,1155,1844,689,198,769,-571,-48
"19180",NA,NA,"Danville, IL","Metropolitan Statistical Area",2006,81641,-102,192,1151,959,-257,43,-300,-37
"19180",NA,17183,"Vermilion County, IL","County or equivalent",2006,81641,-102,192,1151,959,-257,43,-300,-37
"19260",NA,NA,"Danville, VA","Metropolitan Statistical Area",2006,106124,-494,-175,1207,1382,-270,80,-350,-49
"19260",NA,51143,"Pittsylvania County, VA","County or equivalent",2006,60856,-105,0,636,636,-78,41,-119,-27
"19260",NA,51590,"Danville city, VA","County or equivalent",2006,45268,-389,-175,571,746,-192,39,-231,-22
"19340",NA,NA,"Davenport-Moline-Rock Island, IA-IL","Metropolitan Statistical Area",2006,373926,865,1598,5020,3422,-640,463,-1103,-93
"19340",NA,17073,"Henry County, IL","County or equivalent",2006,49548,-312,81,600,519,-373,22,-395,-20
"19340",NA,17131,"Mercer County, IL","County or equivalent",2006,16523,-45,-29,163,192,-8,2,-10,-8
"19340",NA,17161,"Rock Island County, IL","County or equivalent",2006,146379,-153,595,1995,1400,-684,239,-923,-64
"19340",NA,19163,"Scott County, IA","County or equivalent",2006,161476,1375,951,2262,1311,425,200,225,-1
"19380",NA,NA,"Dayton, OH","Metropolitan Statistical Area",2006,840982,-2097,2920,10643,7723,-5236,694,-5930,219
"19380",NA,39057,"Greene County, OH","County or equivalent",2006,157561,1432,670,1828,1158,244,258,-14,518
"19380",NA,39109,"Miami County, OH","County or equivalent",2006,100858,263,277,1212,935,35,49,-14,-49
"19380",NA,39113,"Montgomery County, OH","County or equivalent",2006,540718,-3757,1845,7069,5224,-5371,377,-5748,-231
"19380",NA,39135,"Preble County, OH","County or equivalent",2006,41845,-35,128,534,406,-144,10,-154,-19
"19460",NA,NA,"Decatur, AL","Metropolitan Statistical Area",2006,147786,837,434,1909,1475,475,162,313,-72
"19460",NA,1079,"Lawrence County, AL","County or equivalent",2006,33911,-378,36,404,368,-401,9,-410,-13
"19460",NA,1103,"Morgan County, AL","County or equivalent",2006,113875,1215,398,1505,1107,876,153,723,-59
"19500",NA,NA,"Decatur, IL","Metropolitan Statistical Area",2006,109082,-553,254,1422,1168,-759,46,-805,-48
"19500",NA,17115,"Macon County, IL","County or equivalent",2006,109082,-553,254,1422,1168,-759,46,-805,-48
"19660",NA,NA,"Deltona-Daytona Beach-Ormond Beach, FL","Metropolitan Statistical Area",2006,495021,9305,-997,5153,6150,10547,776,9771,-245
"19660",NA,12127,"Volusia County, FL","County or equivalent",2006,495021,9305,-997,5153,6150,10547,776,9771,-245
"19740",NA,NA,"Denver-Aurora, CO /1","Metropolitan Statistical Area",2006,2403113,44842,23475,37477,14002,21487,11326,10161,-120
"19740",NA,8001,"Adams County, CO /1","County or equivalent",2006,410454,11871,5473,7722,2249,6624,2160,4464,-226
"19740",NA,8005,"Arapahoe County, CO /1","County or equivalent",2006,532403,6154,5082,8025,2943,1347,2308,-961,-275
"19740",NA,8014,"Broomfield County, CO /1","County or equivalent",2006,51454,2915,446,674,228,1372,102,1270,1097
"19740",NA,8019,"Clear Creek County, CO /1","County or equivalent",2006,8895,-122,81,122,41,-199,0,-199,-4
"19740",NA,8031,"Denver County, CO /1","County or equivalent",2006,572121,8768,6008,10222,4214,3052,5409,-2357,-292
"19740",NA,8035,"Douglas County, CO /1","County or equivalent",2006,259206,13130,3453,4114,661,9837,356,9481,-160
"19740",NA,8039,"Elbert County, CO /1","County or equivalent",2006,22648,260,110,198,88,162,5,157,-12
"19740",NA,8047,"Gilpin County, CO /1","County or equivalent",2006,5047,112,41,70,29,75,1,74,-4
"19740",NA,8059,"Jefferson County, CO /1","County or equivalent",2006,524240,1674,2686,6170,3484,-776,978,-1754,-236
"19740",NA,8093,"Park County, CO /1","County or equivalent",2006,16645,80,95,160,65,-7,7,-14,-8
"19780",NA,NA,"Des Moines-West Des Moines, IA","Metropolitan Statistical Area",2006,534659,11055,4671,8431,3760,6415,1218,5197,-31
"19780",NA,19049,"Dallas County, IA","County or equivalent",2006,54612,2816,546,868,322,2265,69,2196,5
"19780",NA,19077,"Guthrie County, IA","County or equivalent",2006,11066,-148,2,130,128,-144,2,-146,-6
"19780",NA,19121,"Madison County, IA","County or equivalent",2006,15194,324,57,211,154,276,1,275,-9
"19780",NA,19153,"Polk County, IA","County or equivalent",2006,410089,7327,3850,6681,2831,3475,1136,2339,2
"19780",NA,19181,"Warren County, IA","County or equivalent",2006,43698,736,216,541,325,543,10,533,-23
"19820",NA,NA,"Detroit-Warren-Livonia, MI","Metropolitan Statistical Area",2006,4486620,-9860,18956,56767,37811,-35353,11124,-46477,6537
"19820",19804,NA,"Detroit-Livonia-Dearborn, MI","Metropolitan Division",2006,2009204,-14979,8939,27287,18348,-31189,5089,-36278,7271
"19820",19804,26163,"Wayne County, MI","County or equivalent",2006,2009204,-14979,8939,27287,18348,-31189,5089,-36278,7271
"19820",47644,NA,"Warren-Troy-Farmington Hills, MI","Metropolitan Division",2006,2477416,5119,10017,29480,19463,-4164,6035,-10199,-734
"19820",47644,26087,"Lapeer County, MI","County or equivalent",2006,92206,-34,273,931,658,-266,34,-300,-41
"19820",47644,26093,"Livingston County, MI","County or equivalent",2006,182075,2648,920,1966,1046,1824,134,1690,-96
"19820",47644,26099,"Macomb County, MI","County or equivalent",2006,828282,3054,2852,10131,7279,202,1679,-1477,0
"19820",47644,26125,"Oakland County, MI","County or equivalent",2006,1204666,-1211,5505,14486,8981,-6203,4111,-10314,-513
"19820",47644,26147,"St. Clair County, MI","County or equivalent",2006,170187,662,467,1966,1499,279,77,202,-84
"20020",NA,NA,"Dothan, AL","Metropolitan Statistical Area",2006,137458,1912,377,1850,1473,1608,63,1545,-73
"20020",NA,1061,"Geneva County, AL","County or equivalent",2006,25749,165,-27,326,353,204,9,195,-12
"20020",NA,1067,"Henry County, AL","County or equivalent",2006,16505,80,-28,189,217,116,7,109,-8
"20020",NA,1069,"Houston County, AL","County or equivalent",2006,95204,1667,432,1335,903,1288,47,1241,-53
"20100",NA,NA,"Dover, DE","Metropolitan Statistical Area",2006,147520,4314,993,2234,1241,3409,219,3190,-88
"20100",NA,10001,"Kent County, DE","County or equivalent",2006,147520,4314,993,2234,1241,3409,219,3190,-88
"20220",NA,NA,"Dubuque, IA","Metropolitan Statistical Area",2006,91398,423,254,1133,879,170,93,77,-1
"20220",NA,19061,"Dubuque County, IA","County or equivalent",2006,91398,423,254,1133,879,170,93,77,-1
"20260",NA,NA,"Duluth, MN-WI","Metropolitan Statistical Area",2006,273682,-434,316,3097,2781,-625,116,-741,-125
"20260",NA,27017,"Carlton County, MN","County or equivalent",2006,33677,24,108,435,327,-69,9,-78,-15
"20260",NA,27137,"St. Louis County, MN","County or equivalent",2006,196218,-334,125,2162,2037,-370,80,-450,-89
"20260",NA,55031,"Douglas County, WI","County or equivalent",2006,43787,-124,83,500,417,-186,27,-213,-21
"20500",NA,NA,"Durham, NC","Metropolitan Statistical Area",2006,467134,9191,3405,6645,3240,6034,2654,3380,-248
"20500",NA,37037,"Chatham County, NC","County or equivalent",2006,59561,1626,259,749,490,1400,309,1091,-33
"20500",NA,37063,"Durham County, NC","County or equivalent",2006,248857,5323,2452,4126,1674,3004,1690,1314,-133
"20500",NA,37135,"Orange County, NC","County or equivalent",2006,121664,2145,597,1302,705,1613,636,977,-65
"20500",NA,37145,"Person County, NC","County or equivalent",2006,37052,97,97,468,371,17,19,-2,-17
"20740",NA,NA,"Eau Claire, WI","Metropolitan Statistical Area",2006,156010,1272,744,1925,1181,609,71,538,-81
"20740",NA,55017,"Chippewa County, WI","County or equivalent",2006,59424,246,302,754,452,-26,15,-41,-30
"20740",NA,55035,"Eau Claire County, WI","County or equivalent",2006,96586,1026,442,1171,729,635,56,579,-51
"20940",NA,NA,"El Centro, CA","Metropolitan Statistical Area",2006,156999,3714,2030,2986,956,1768,936,832,-84
"20940",NA,6025,"Imperial County, CA","County or equivalent",2006,156999,3714,2030,2986,956,1768,936,832,-84
"21060",NA,NA,"Elizabethtown, KY","Metropolitan Statistical Area",2006,110601,394,871,1779,908,-428,274,-702,-49
"21060",NA,21093,"Hardin County, KY","County or equivalent",2006,96992,273,835,1588,753,-519,274,-793,-43
"21060",NA,21123,"Larue County, KY","County or equivalent",2006,13609,121,36,191,155,91,0,91,-6
"21140",NA,NA,"Elkhart-Goshen, IN","Metropolitan Statistical Area",2006,196341,2913,2133,3542,1409,880,732,148,-100
"21140",NA,18039,"Elkhart County, IN","County or equivalent",2006,196341,2913,2133,3542,1409,880,732,148,-100
"21300",NA,NA,"Elmira, NY","Metropolitan Statistical Area",2006,88089,-292,17,967,950,-270,38,-308,-39
"21300",NA,36015,"Chemung County, NY","County or equivalent",2006,88089,-292,17,967,950,-270,38,-308,-39
"21340",NA,NA,"El Paso, TX","Metropolitan Statistical Area",2006,722458,12466,9855,14383,4528,2989,4080,-1091,-378
"21340",NA,48141,"El Paso County, TX","County or equivalent",2006,722458,12466,9855,14383,4528,2989,4080,-1091,-378
"21500",NA,NA,"Erie, PA","Metropolitan Statistical Area",2006,279641,860,635,3328,2693,224,368,-144,1
"21500",NA,42049,"Erie County, PA","County or equivalent",2006,279641,860,635,3328,2693,224,368,-144,1
"21660",NA,NA,"Eugene-Springfield, OR","Metropolitan Statistical Area",2006,339422,4000,589,3588,2999,3588,586,3002,-177
"21660",NA,41039,"Lane County, OR","County or equivalent",2006,339422,4000,589,3588,2999,3588,586,3002,-177
"21780",NA,NA,"Evansville, IN-KY","Metropolitan Statistical Area",2006,348596,878,1087,4585,3498,-45,185,-230,-164
"21780",NA,18051,"Gibson County, IN","County or equivalent",2006,32943,25,112,429,317,-71,12,-83,-16
"21780",NA,18129,"Posey County, IN","County or equivalent",2006,26340,-156,7,244,237,-150,8,-158,-13
"21780",NA,18163,"Vanderburgh County, IN","County or equivalent",2006,174274,651,581,2446,1865,152,112,40,-82
"21780",NA,18173,"Warrick County, IN","County or equivalent",2006,56071,467,146,637,491,349,14,335,-28
"21780",NA,21101,"Henderson County, KY","County or equivalent",2006,45126,19,194,621,427,-155,19,-174,-20
"21780",NA,21233,"Webster County, KY","County or equivalent",2006,13842,-128,47,208,161,-170,20,-190,-5
"21820",NA,NA,"Fairbanks, AK","Metropolitan Statistical Area",2006,94803,242,1179,1525,346,-1983,286,-2269,1046
"21820",NA,2090,"Fairbanks North Star Borough, AK","County or equivalent",2006,94803,242,1179,1525,346,-1983,286,-2269,1046
"22020",NA,NA,"Fargo, ND-MN","Metropolitan Statistical Area",2006,188948,3268,1591,2745,1154,1771,301,1470,-94
"22020",NA,27027,"Clay County, MN","County or equivalent",2006,54066,748,334,740,406,440,32,408,-26
"22020",NA,38017,"Cass County, ND","County or equivalent",2006,134882,2520,1257,2005,748,1331,269,1062,-68
"22140",NA,NA,"Farmington, NM","Metropolitan Statistical Area",2006,121620,-223,1302,2107,805,-1473,109,-1582,-52
"22140",NA,35045,"San Juan County, NM","County or equivalent",2006,121620,-223,1302,2107,805,-1473,109,-1582,-52
"22180",NA,NA,"Fayetteville, NC","Metropolitan Statistical Area",2006,348053,3198,3710,6072,2362,-347,1625,-1972,-165
"22180",NA,37051,"Cumberland County, NC","County or equivalent",2006,306984,1775,3185,5295,2110,-1269,1470,-2739,-141
"22180",NA,37093,"Hoke County, NC","County or equivalent",2006,41069,1423,525,777,252,922,155,767,-24
"22220",NA,NA,"Fayetteville-Springdale-Rogers, AR-MO","Metropolitan Statistical Area",2006,422446,14652,4192,7053,2861,11122,1225,9897,-662
"22220",NA,5007,"Benton County, AR","County or equivalent",2006,194658,7905,1796,3086,1290,6846,426,6420,-737
"22220",NA,5087,"Madison County, AR","County or equivalent",2006,15170,327,28,191,163,308,9,299,-9
"22220",NA,5143,"Washington County, AR","County or equivalent",2006,189820,6176,2184,3395,1211,3897,722,3175,95
"22220",NA,29119,"McDonald County, MO","County or equivalent",2006,22798,244,184,381,197,71,68,3,-11
"22380",NA,NA,"Flagstaff, AZ","Metropolitan Statistical Area",2006,125966,1313,1382,2029,647,-6,173,-179,-63
"22380",NA,4005,"Coconino County, AZ","County or equivalent",2006,125966,1313,1382,2029,647,-6,173,-179,-63
"22420",NA,NA,"Flint, MI","Metropolitan Statistical Area",2006,437445,-1668,1959,6001,4042,-3439,139,-3578,-188
"22420",NA,26049,"Genesee County, MI","County or equivalent",2006,437445,-1668,1959,6001,4042,-3439,139,-3578,-188
"22500",NA,NA,"Florence, SC","Metropolitan Statistical Area",2006,197601,931,738,2815,2077,286,89,197,-93
"22500",NA,45031,"Darlington County, SC","County or equivalent",2006,66850,-12,169,912,743,-151,22,-173,-30
"22500",NA,45041,"Florence County, SC","County or equivalent",2006,130751,943,569,1903,1334,437,67,370,-63
"22520",NA,NA,"Florence-Muscle Shoals, AL","Metropolitan Statistical Area",2006,142375,585,-16,1581,1597,669,58,611,-68
"22520",NA,1033,"Colbert County, AL","County or equivalent",2006,54432,57,-38,598,636,121,13,108,-26
"22520",NA,1077,"Lauderdale County, AL","County or equivalent",2006,87943,528,22,983,961,548,45,503,-42
"22540",NA,NA,"Fond du Lac, WI","Metropolitan Statistical Area",2006,98667,275,223,1195,972,98,91,7,-46
"22540",NA,55039,"Fond du Lac County, WI","County or equivalent",2006,98667,275,223,1195,972,98,91,7,-46
"22660",NA,NA,"Fort Collins-Loveland, CO","Metropolitan Statistical Area",2006,280944,5374,1973,3511,1538,3556,535,3021,-155
"22660",NA,8069,"Larimer County, CO","County or equivalent",2006,280944,5374,1973,3511,1538,3556,535,3021,-155
"22900",NA,NA,"Fort Smith, AR-OK","Metropolitan Statistical Area",2006,285898,3607,1366,4208,2842,2385,479,1906,-144
"22900",NA,5033,"Crawford County, AR","County or equivalent",2006,58032,1129,260,800,540,901,23,878,-32
"22900",NA,5047,"Franklin County, AR","County or equivalent",2006,18041,59,39,230,191,28,8,20,-8
"22900",NA,5131,"Sebastian County, AR","County or equivalent",2006,120019,1661,775,1880,1105,947,358,589,-61
"22900",NA,40079,"Le Flore County, OK","County or equivalent",2006,49120,314,171,738,567,166,78,88,-23
"22900",NA,40135,"Sequoyah County, OK","County or equivalent",2006,40686,444,121,560,439,343,12,331,-20
"23020",NA,NA,"Fort Walton Beach-Crestview-Destin, FL","Metropolitan Statistical Area",2006,182834,-425,1384,2790,1406,-1723,514,-2237,-86
"23020",NA,12091,"Okaloosa County, FL","County or equivalent",2006,182834,-425,1384,2790,1406,-1723,514,-2237,-86
"23060",NA,NA,"Fort Wayne, IN","Metropolitan Statistical Area",2006,405685,3548,2963,6170,3207,787,677,110,-202
"23060",NA,18003,"Allen County, IN","County or equivalent",2006,345529,3142,2761,5432,2671,554,663,-109,-173
"23060",NA,18179,"Wells County, IN","County or equivalent",2006,27851,89,95,354,259,7,3,4,-13
"23060",NA,18183,"Whitley County, IN","County or equivalent",2006,32305,317,107,384,277,226,11,215,-16
"23420",NA,NA,"Fresno, CA","Metropolitan Statistical Area",2006,882171,11551,10387,16413,6026,1602,4028,-2426,-438
"23420",NA,6019,"Fresno County, CA","County or equivalent",2006,882171,11551,10387,16413,6026,1602,4028,-2426,-438
"23460",NA,NA,"Gadsden, AL","Metropolitan Statistical Area",2006,102751,318,-124,1259,1383,490,74,416,-48
"23460",NA,1055,"Etowah County, AL","County or equivalent",2006,102751,318,-124,1259,1383,490,74,416,-48
"23540",NA,NA,"Gainesville, FL","Metropolitan Statistical Area",2006,252915,5337,1072,2851,1779,4401,751,3650,-136
"23540",NA,12001,"Alachua County, FL","County or equivalent",2006,236340,4984,1079,2677,1598,4033,748,3285,-128
"23540",NA,12041,"Gilchrist County, FL","County or equivalent",2006,16575,353,-7,174,181,368,3,365,-8
"23580",NA,NA,"Gainesville, GA","Metropolitan Statistical Area",2006,171444,6497,1900,3016,1116,4601,1403,3198,-4
"23580",NA,13139,"Hall County, GA","County or equivalent",2006,171444,6497,1900,3016,1116,4601,1403,3198,-4
"24020",NA,NA,"Glens Falls, NY","Metropolitan Statistical Area",2006,128016,587,46,1228,1182,600,39,561,-59
"24020",NA,36113,"Warren County, NY","County or equivalent",2006,65724,374,3,639,636,402,30,372,-31
"24020",NA,36115,"Washington County, NY","County or equivalent",2006,62292,213,43,589,546,198,9,189,-28
"24140",NA,NA,"Goldsboro, NC","Metropolitan Statistical Area",2006,112603,-600,753,1806,1053,-1304,318,-1622,-49
"24140",NA,37191,"Wayne County, NC","County or equivalent",2006,112603,-600,753,1806,1053,-1304,318,-1622,-49
"24220",NA,NA,"Grand Forks, ND-MN","Metropolitan Statistical Area",2006,97719,483,551,1296,745,-20,184,-204,-48
"24220",NA,27119,"Polk County, MN","County or equivalent",2006,30683,-50,55,386,331,-91,12,-103,-14
"24220",NA,38035,"Grand Forks County, ND","County or equivalent",2006,67036,533,496,910,414,71,172,-101,-34
"24300",NA,NA,"Grand Junction, CO","Metropolitan Statistical Area",2006,133868,4343,587,1866,1279,3835,106,3729,-79
"24300",NA,8077,"Mesa County, CO","County or equivalent",2006,133868,4343,587,1866,1279,3835,106,3729,-79
"24340",NA,NA,"Grand Rapids-Wyoming, MI","Metropolitan Statistical Area",2006,771265,3382,6025,11434,5409,-2288,1875,-4163,-355
"24340",NA,26015,"Barry County, MI","County or equivalent",2006,58884,-104,190,676,486,-267,9,-276,-27
"24340",NA,26067,"Ionia County, MI","County or equivalent",2006,64075,195,347,802,455,-121,15,-136,-31
"24340",NA,26081,"Kent County, MI","County or equivalent",2006,599199,3537,5241,9276,4035,-1429,1825,-3254,-275
"24340",NA,26123,"Newaygo County, MI","County or equivalent",2006,49107,-246,247,680,433,-471,26,-497,-22
"24500",NA,NA,"Great Falls, MT","Metropolitan Statistical Area",2006,81854,63,364,1146,782,-669,113,-782,368
"24500",NA,30013,"Cascade County, MT","County or equivalent",2006,81854,63,364,1146,782,-669,113,-782,368
"24540",NA,NA,"Greeley, CO /1","Metropolitan Statistical Area",2006,234710,8356,2759,4021,1262,5728,752,4976,-131
"24540",NA,8123,"Weld County, CO /1","County or equivalent",2006,234710,8356,2759,4021,1262,5728,752,4976,-131
"24580",NA,NA,"Green Bay, WI","Metropolitan Statistical Area",2006,298307,1923,1889,4031,2142,180,427,-247,-146
"24580",NA,55009,"Brown County, WI","County or equivalent",2006,240404,1725,1739,3379,1640,105,420,-315,-119
"24580",NA,55061,"Kewaunee County, WI","County or equivalent",2006,20550,72,68,245,177,14,5,9,-10
"24580",NA,55083,"Oconto County, WI","County or equivalent",2006,37353,126,82,407,325,61,2,59,-17
"24660",NA,NA,"Greensboro-High Point, NC","Metropolitan Statistical Area",2006,684558,11290,2927,8802,5875,8709,2364,6345,-346
"24660",NA,37081,"Guilford County, NC","County or equivalent",2006,454351,9407,2415,5988,3573,7227,1671,5556,-235
"24660",NA,37151,"Randolph County, NC","County or equivalent",2006,138226,1639,515,1742,1227,1193,527,666,-69
"24660",NA,37157,"Rockingham County, NC","County or equivalent",2006,91981,244,-3,1072,1075,289,166,123,-42
"24780",NA,NA,"Greenville, NC","Metropolitan Statistical Area",2006,168417,4490,1073,2362,1289,3509,330,3179,-92
"24780",NA,37079,"Greene County, NC","County or equivalent",2006,20250,537,62,242,180,486,72,414,-11
"24780",NA,37147,"Pitt County, NC","County or equivalent",2006,148167,3953,1011,2120,1109,3023,258,2765,-81
"24860",NA,NA,"Greenville-Mauldin-Easley, SC","Metropolitan Statistical Area",2006,599509,10795,3188,8204,5016,7919,1346,6573,-312
"24860",NA,45045,"Greenville County, SC","County or equivalent",2006,415675,9855,2630,6010,3380,7450,1086,6364,-225
"24860",NA,45059,"Laurens County, SC","County or equivalent",2006,69370,42,125,840,715,-51,72,-123,-32
"24860",NA,45077,"Pickens County, SC","County or equivalent",2006,114464,898,433,1354,921,520,188,332,-55
"25060",NA,NA,"Gulfport-Biloxi, MS","Metropolitan Statistical Area",2006,227198,-29341,725,3125,2400,-30047,439,-30486,-19
"25060",NA,28045,"Hancock County, MS","County or equivalent",2006,38853,-7235,-19,415,434,-7210,17,-7227,-6
"25060",NA,28047,"Harrison County, MS","County or equivalent",2006,172955,-22801,716,2522,1806,-23516,419,-23935,-1
"25060",NA,28131,"Stone County, MS","County or equivalent",2006,15390,695,28,188,160,679,3,676,-12
"25180",NA,NA,"Hagerstown-Martinsburg, MD-WV","Metropolitan Statistical Area",2006,255874,6364,1193,3385,2192,5307,102,5205,-136
"25180",NA,24043,"Washington County, MD","County or equivalent",2006,142984,1865,586,1879,1293,1349,71,1278,-70
"25180",NA,54003,"Berkeley County, WV","County or equivalent",2006,96723,4185,622,1352,730,3620,23,3597,-57
"25180",NA,54065,"Morgan County, WV","County or equivalent",2006,16167,314,-15,154,169,338,8,330,-9
"25260",NA,NA,"Hanford-Corcoran, CA","Metropolitan Statistical Area",2006,145723,2216,1773,2600,827,517,571,-54,-74
"25260",NA,6031,"Kings County, CA","County or equivalent",2006,145723,2216,1773,2600,827,517,571,-54,-74
"25420",NA,NA,"Harrisburg-Carlisle, PA","Metropolitan Statistical Area",2006,524100,4353,1466,6248,4782,3152,761,2391,-265
"25420",NA,42041,"Cumberland County, PA","County or equivalent",2006,225488,2950,348,2384,2036,2717,290,2427,-115
"25420",NA,42043,"Dauphin County, PA","County or equivalent",2006,253811,1090,973,3325,2352,246,468,-222,-129
"25420",NA,42099,"Perry County, PA","County or equivalent",2006,44801,313,145,539,394,189,3,186,-21
"25500",NA,NA,"Harrisonburg, VA","Metropolitan Statistical Area",2006,116062,1906,560,1451,891,1115,360,755,231
"25500",NA,51165,"Rockingham County, VA","County or equivalent",2006,72620,1063,307,913,606,501,110,391,255
"25500",NA,51660,"Harrisonburg city, VA","County or equivalent",2006,43442,843,253,538,285,614,250,364,-24
"25540",NA,NA,"Hartford-West Hartford-East Hartford, CT","Metropolitan Statistical Area",2006,1183285,4475,3373,13475,10102,1658,3790,-2132,-556
"25540",NA,9003,"Hartford County, CT","County or equivalent",2006,872945,2449,2441,10377,7936,416,3347,-2931,-408
"25540",NA,9007,"Middlesex County, CT","County or equivalent",2006,163128,1198,411,1708,1297,865,225,640,-78
"25540",NA,9013,"Tolland County, CT","County or equivalent",2006,147212,828,521,1390,869,377,218,159,-70
"25620",NA,NA,"Hattiesburg, MS","Metropolitan Statistical Area",2006,135083,3344,883,2072,1189,2540,125,2415,-79
"25620",NA,28035,"Forrest County, MS","County or equivalent",2006,77186,1601,442,1165,723,1202,112,1090,-43
"25620",NA,28073,"Lamar County, MS","County or equivalent",2006,45916,1766,387,740,353,1409,13,1396,-30
"25620",NA,28111,"Perry County, MS","County or equivalent",2006,11981,-23,54,167,113,-71,0,-71,-6
"25860",NA,NA,"Hickory-Lenoir-Morganton, NC","Metropolitan Statistical Area",2006,356231,2699,943,4325,3382,1890,820,1070,-134
"25860",NA,37003,"Alexander County, NC","County or equivalent",2006,35930,340,94,414,320,263,31,232,-17
"25860",NA,37023,"Burke County, NC","County or equivalent",2006,88659,76,113,984,871,4,177,-173,-41
"25860",NA,37027,"Caldwell County, NC","County or equivalent",2006,78994,260,57,915,858,203,82,121,0
"25860",NA,37035,"Catawba County, NC","County or equivalent",2006,152648,2023,679,2012,1333,1420,530,890,-76
"25980",NA,NA,"Hinesville-Fort Stewart, GA","Metropolitan Statistical Area",2006,71462,-2360,851,1197,346,-3195,504,-3699,-16
"25980",NA,13179,"Liberty County, GA","County or equivalent",2006,60320,-2616,780,1062,282,-3386,446,-3832,-10
"25980",NA,13183,"Long County, GA","County or equivalent",2006,11142,256,71,135,64,191,58,133,-6
"26100",NA,NA,"Holland-Grand Haven, MI","Metropolitan Statistical Area",2006,256512,2281,2077,3593,1516,330,297,33,-126
"26100",NA,26139,"Ottawa County, MI","County or equivalent",2006,256512,2281,2077,3593,1516,330,297,33,-126
"26180",NA,NA,"Honolulu, HI","Metropolitan Statistical Area",2006,904134,4461,6982,13362,6380,-2096,4475,-6571,-425
"26180",NA,15003,"Honolulu County, HI","County or equivalent",2006,904134,4461,6982,13362,6380,-2096,4475,-6571,-425
"26300",NA,NA,"Hot Springs, AR","Metropolitan Statistical Area",2006,95127,1930,-27,1158,1185,2007,59,1948,-50
"26300",NA,5051,"Garland County, AR","County or equivalent",2006,95127,1930,-27,1158,1185,2007,59,1948,-50
"26380",NA,NA,"Houma-Bayou Cane-Thibodaux, LA","Metropolitan Statistical Area",2006,200818,3304,948,2725,1777,2463,101,2362,-107
"26380",NA,22057,"Lafourche Parish, LA","County or equivalent",2006,92775,1428,295,1103,808,1183,50,1133,-50
"26380",NA,22109,"Terrebonne Parish, LA","County or equivalent",2006,108043,1876,653,1622,969,1280,51,1229,-57
"26420",NA,NA,"Houston-Sugar Land-Baytown, TX","Metropolitan Statistical Area",2006,5485545,182637,61788,92424,30636,121112,32227,88885,-263
"26420",NA,48015,"Austin County, TX","County or equivalent",2006,26062,318,76,335,259,255,51,204,-13
"26420",NA,48039,"Brazoria County, TX","County or equivalent",2006,283704,9582,2789,4598,1809,6955,605,6350,-162
"26420",NA,48071,"Chambers County, TX","County or equivalent",2006,28302,302,214,408,194,103,46,57,-15
"26420",NA,48157,"Fort Bend County, TX","County or equivalent",2006,484160,25644,4972,6852,1880,20649,1581,19068,23
"26420",NA,48167,"Galveston County, TX","County or equivalent",2006,278763,4145,1620,3977,2357,2664,708,1956,-139
"26420",NA,48201,"Harris County, TX","County or equivalent",2006,3858432,123357,48100,68555,20455,75154,28025,47129,103
"26420",NA,48291,"Liberty County, TX","County or equivalent",2006,74470,15,371,1036,665,-323,94,-417,-33
"26420",NA,48339,"Montgomery County, TX","County or equivalent",2006,392323,18812,3298,5795,2497,15514,1011,14503,0
"26420",NA,48407,"San Jacinto County, TX","County or equivalent",2006,24352,20,52,293,241,-22,21,-43,-10
"26420",NA,48473,"Waller County, TX","County or equivalent",2006,34977,442,296,575,279,163,85,78,-17
"26580",NA,NA,"Huntington-Ashland, WV-KY-OH","Metropolitan Statistical Area",2006,284227,-165,184,3466,3282,-216,70,-286,-133
"26580",NA,21019,"Boyd County, KY","County or equivalent",2006,48677,-106,49,622,573,-130,9,-139,-25
"26580",NA,21089,"Greenup County, KY","County or equivalent",2006,37085,125,24,421,397,118,0,118,-17
"26580",NA,39087,"Lawrence County, OH","County or equivalent",2006,62645,202,89,801,712,143,11,132,-30
"26580",NA,54011,"Cabell County, WV","County or equivalent",2006,94327,23,41,1170,1129,24,41,-17,-42
"26580",NA,54099,"Wayne County, WV","County or equivalent",2006,41493,-409,-19,452,471,-371,9,-380,-19
"26620",NA,NA,"Huntsville, AL","Metropolitan Statistical Area",2006,377747,8579,1840,4747,2907,6770,487,6283,-31
"26620",NA,1083,"Limestone County, AL","County or equivalent",2006,71730,1971,260,877,617,1749,39,1710,-38
"26620",NA,1089,"Madison County, AL","County or equivalent",2006,306017,6608,1580,3870,2290,5021,448,4573,7
"26820",NA,NA,"Idaho Falls, ID","Metropolitan Statistical Area",2006,115265,3350,1511,2264,753,1905,126,1779,-66
"26820",NA,16019,"Bonneville County, ID","County or equivalent",2006,93421,2728,1181,1813,632,1601,93,1508,-54
"26820",NA,16051,"Jefferson County, ID","County or equivalent",2006,21844,622,330,451,121,304,33,271,-12
"26900",NA,NA,"Indianapolis-Carmel, IN","Metropolitan Statistical Area",2006,1668248,25176,13145,25713,12568,12644,2531,10113,-613
"26900",NA,18011,"Boone County, IN","County or equivalent",2006,52902,1503,265,709,444,1269,16,1253,-31
"26900",NA,18013,"Brown County, IN","County or equivalent",2006,14813,-85,-36,99,135,-43,6,-49,-6
"26900",NA,18057,"Hamilton County, IN","County or equivalent",2006,251611,9815,2692,3766,1074,7118,246,6872,5
"26900",NA,18059,"Hancock County, IN","County or equivalent",2006,64485,2072,460,932,472,1648,7,1641,-36
"26900",NA,18063,"Hendricks County, IN","County or equivalent",2006,129806,3563,842,1659,817,2792,58,2734,-71
"26900",NA,18081,"Johnson County, IN","County or equivalent",2006,132575,3326,732,1735,1003,2593,79,2514,1
"26900",NA,18097,"Marion County, IN","County or equivalent",2006,872069,4593,7638,15027,7389,-2640,2035,-4675,-405
"26900",NA,18109,"Morgan County, IN","County or equivalent",2006,69526,352,338,865,527,47,11,36,-33
"26900",NA,18133,"Putnam County, IN","County or equivalent",2006,36852,-144,78,387,309,-206,13,-219,-16
"26900",NA,18145,"Shelby County, IN","County or equivalent",2006,43609,181,136,534,398,66,60,6,-21
"26980",NA,NA,"Iowa City, IA","Metropolitan Statistical Area",2006,144288,1995,1036,1802,766,969,448,521,-10
"26980",NA,19103,"Johnson County, IA","County or equivalent",2006,123126,1890,968,1510,542,921,437,484,1
"26980",NA,19183,"Washington County, IA","County or equivalent",2006,21162,105,68,292,224,48,11,37,-11
"27060",NA,NA,"Ithaca, NY","Metropolitan Statistical Area",2006,100067,180,262,808,546,-37,592,-629,-45
"27060",NA,36109,"Tompkins County, NY","County or equivalent",2006,100067,180,262,808,546,-37,592,-629,-45
"27100",NA,NA,"Jackson, MI","Metropolitan Statistical Area",2006,162867,294,482,2018,1536,-115,92,-207,-73
"27100",NA,26075,"Jackson County, MI","County or equivalent",2006,162867,294,482,2018,1536,-115,92,-207,-73
"27140",NA,NA,"Jackson, MS","Metropolitan Statistical Area",2006,530531,9201,3819,8330,4511,5663,257,5406,-281
"27140",NA,28029,"Copiah County, MS","County or equivalent",2006,29211,297,254,518,264,57,9,48,-14
"27140",NA,28049,"Hinds County, MS","County or equivalent",2006,251044,2124,1978,4065,2087,265,105,160,-119
"27140",NA,28089,"Madison County, MS","County or equivalent",2006,87119,2712,319,1368,1049,2452,43,2409,-59
"27140",NA,28121,"Rankin County, MS","County or equivalent",2006,135283,4007,1143,1980,837,2941,81,2860,-77
"27140",NA,28127,"Simpson County, MS","County or equivalent",2006,27874,61,125,399,274,-52,19,-71,-12
"27180",NA,NA,"Jackson, TN","Metropolitan Statistical Area",2006,111996,1333,486,1524,1038,904,125,779,-57
"27180",NA,47023,"Chester County, TN","County or equivalent",2006,15980,117,29,175,146,96,1,95,-8
"27180",NA,47113,"Madison County, TN","County or equivalent",2006,96016,1216,457,1349,892,808,124,684,-49
"27260",NA,NA,"Jacksonville, FL","Metropolitan Statistical Area",2006,1276495,28701,8246,18747,10501,21151,2398,18753,-696
"27260",NA,12003,"Baker County, FL","County or equivalent",2006,25028,610,171,374,203,452,6,446,-13
"27260",NA,12019,"Clay County, FL","County or equivalent",2006,176101,7980,1020,2335,1315,7066,236,6830,-106
"27260",NA,12031,"Duval County, FL","County or equivalent",2006,840785,10386,6410,13473,7063,4408,1980,2428,-432
"27260",NA,12089,"Nassau County, FL","County or equivalent",2006,66401,1893,164,796,632,1766,41,1725,-37
"27260",NA,12109,"St. Johns County, FL","County or equivalent",2006,168180,7832,481,1769,1288,7459,135,7324,-108
"27340",NA,NA,"Jacksonville, NC","Metropolitan Statistical Area",2006,160896,1970,2404,3223,819,-353,973,-1326,-81
"27340",NA,37133,"Onslow County, NC","County or equivalent",2006,160896,1970,2404,3223,819,-353,973,-1326,-81
"27500",NA,NA,"Janesville, WI","Metropolitan Statistical Area",2006,158046,1652,666,2099,1433,1063,228,835,-77
"27500",NA,55105,"Rock County, WI","County or equivalent",2006,158046,1652,666,2099,1433,1063,228,835,-77
"27620",NA,NA,"Jefferson City, MO","Metropolitan Statistical Area",2006,144485,1078,654,1844,1190,495,119,376,-71
"27620",NA,29027,"Callaway County, MO","County or equivalent",2006,42919,416,162,496,334,276,26,250,-22
"27620",NA,29051,"Cole County, MO","County or equivalent",2006,73052,525,362,956,594,200,90,110,-37
"27620",NA,29135,"Moniteau County, MO","County or equivalent",2006,15058,0,64,210,146,-58,3,-61,-6
"27620",NA,29151,"Osage County, MO","County or equivalent",2006,13456,137,66,182,116,77,0,77,-6
"27740",NA,NA,"Johnson City, TN","Metropolitan Statistical Area",2006,191225,2431,34,2167,2133,2496,114,2382,-99
"27740",NA,47019,"Carter County, TN","County or equivalent",2006,58968,340,-50,635,685,420,17,403,-30
"27740",NA,47171,"Unicoi County, TN","County or equivalent",2006,17621,60,-85,173,258,153,0,153,-8
"27740",NA,47179,"Washington County, TN","County or equivalent",2006,114636,2031,169,1359,1190,1923,97,1826,-61
"27780",NA,NA,"Johnstown, PA","Metropolitan Statistical Area",2006,145922,-842,-433,1454,1887,-341,46,-387,-68
"27780",NA,42021,"Cambria County, PA","County or equivalent",2006,145922,-842,-433,1454,1887,-341,46,-387,-68
"27860",NA,NA,"Jonesboro, AR","Metropolitan Statistical Area",2006,114451,1951,463,1581,1118,1548,112,1436,-60
"27860",NA,5031,"Craighead County, AR","County or equivalent",2006,89563,2155,446,1229,783,1758,98,1660,-49
"27860",NA,5111,"Poinsett County, AR","County or equivalent",2006,24888,-204,17,352,335,-210,14,-224,-11
"27900",NA,NA,"Joplin, MO","Metropolitan Statistical Area",2006,168336,2461,937,2559,1622,1612,168,1444,-88
"27900",NA,29097,"Jasper County, MO","County or equivalent",2006,112918,1982,682,1778,1096,1362,140,1222,-62
"27900",NA,29145,"Newton County, MO","County or equivalent",2006,55418,479,255,781,526,250,28,222,-26
"28020",NA,NA,"Kalamazoo-Portage, MI","Metropolitan Statistical Area",2006,321436,979,1623,4180,2557,-494,494,-988,-150
"28020",NA,26077,"Kalamazoo County, MI","County or equivalent",2006,243442,909,1267,3161,1894,-244,444,-688,-114
"28020",NA,26159,"Van Buren County, MI","County or equivalent",2006,77994,70,356,1019,663,-250,50,-300,-36
"28100",NA,NA,"Kankakee-Bradley, IL","Metropolitan Statistical Area",2006,109944,1513,522,1549,1027,989,117,872,2
"28100",NA,17091,"Kankakee County, IL","County or equivalent",2006,109944,1513,522,1549,1027,989,117,872,2
"28140",NA,NA,"Kansas City, MO-KS","Metropolitan Statistical Area",2006,1958328,20930,14121,29647,15526,7457,3659,3798,-648
"28140",NA,20059,"Franklin County, KS","County or equivalent",2006,26294,296,146,376,230,150,15,135,0
"28140",NA,20091,"Johnson County, KS","County or equivalent",2006,515275,9946,4430,7505,3075,5790,1066,4724,-274
"28140",NA,20103,"Leavenworth County, KS","County or equivalent",2006,72530,774,397,946,549,412,119,293,-35
"28140",NA,20107,"Linn County, KS","County or equivalent",2006,9860,16,-3,106,109,24,0,24,-5
"28140",NA,20121,"Miami County, KS","County or equivalent",2006,30244,332,143,386,243,204,6,198,-15
"28140",NA,20209,"Wyandotte County, KS","County or equivalent",2006,153206,-691,1412,2824,1412,-2035,824,-2859,-68
"28140",NA,29013,"Bates County, MO","County or equivalent",2006,17008,63,23,232,209,50,6,44,-10
"28140",NA,29025,"Caldwell County, MO","County or equivalent",2006,9216,56,25,134,109,36,0,36,-5
"28140",NA,29037,"Cass County, MO","County or equivalent",2006,94530,1774,509,1277,768,1314,60,1254,-49
"28140",NA,29047,"Clay County, MO","County or equivalent",2006,206592,5633,1690,3152,1462,4055,218,3837,-112
"28140",NA,29049,"Clinton County, MO","County or equivalent",2006,20485,-55,46,293,247,-92,2,-94,-9
"28140",NA,29095,"Jackson County, MO","County or equivalent",2006,663603,1746,4627,10591,5964,-2885,1208,-4093,4
"28140",NA,29107,"Lafayette County, MO","County or equivalent",2006,32757,-118,6,422,416,-109,6,-115,-15
"28140",NA,29165,"Platte County, MO","County or equivalent",2006,83104,1001,554,1088,534,489,128,361,-42
"28140",NA,29177,"Ray County, MO","County or equivalent",2006,23624,157,116,315,199,54,1,53,-13
"28420",NA,NA,"Kennewick-Pasco-Richland, WA","Metropolitan Statistical Area",2006,222864,4507,2429,3741,1312,2197,905,1292,-119
"28420",NA,53005,"Benton County, WA","County or equivalent",2006,157049,1119,1220,2249,1029,-24,418,-442,-77
"28420",NA,53021,"Franklin County, WA","County or equivalent",2006,65815,3388,1209,1492,283,2221,487,1734,-42
"28660",NA,NA,"Killeen-Temple-Fort Hood, TX","Metropolitan Statistical Area",2006,357866,3609,4985,7275,2290,-1337,1701,-3038,-39
"28660",NA,48027,"Bell County, TX","County or equivalent",2006,265988,4368,4233,5960,1727,135,1223,-1088,0
"28660",NA,48099,"Coryell County, TX","County or equivalent",2006,71523,-1567,668,1044,376,-2210,442,-2652,-25
"28660",NA,48281,"Lampasas County, TX","County or equivalent",2006,20355,808,84,271,187,738,36,702,-14
"28700",NA,NA,"Kingsport-Bristol-Bristol, TN-VA","Metropolitan Statistical Area",2006,301368,1280,-295,3308,3603,1716,115,1601,-141
"28700",NA,47073,"Hawkins County, TN","County or equivalent",2006,56459,493,53,643,590,469,15,454,-29
"28700",NA,47163,"Sullivan County, TN","County or equivalent",2006,152373,414,-155,1704,1859,640,80,560,-71
"28700",NA,51169,"Scott County, VA","County or equivalent",2006,22905,104,-57,241,298,170,3,167,-9
"28700",NA,51191,"Washington County, VA","County or equivalent",2006,52076,138,-92,516,608,253,12,241,-23
"28700",NA,51520,"Bristol city, VA","County or equivalent",2006,17555,131,-44,204,248,184,5,179,-9
"28740",NA,NA,"Kingston, NY","Metropolitan Statistical Area",2006,181652,231,395,1831,1436,-81,196,-277,-83
"28740",NA,36111,"Ulster County, NY","County or equivalent",2006,181652,231,395,1831,1436,-81,196,-277,-83
"28940",NA,NA,"Knoxville, TN","Metropolitan Statistical Area",2006,669530,12005,1951,8041,6090,10189,557,9632,-135
"28940",NA,47001,"Anderson County, TN","County or equivalent",2006,72735,1010,20,835,815,1026,77,949,-36
"28940",NA,47009,"Blount County, TN","County or equivalent",2006,117748,2596,173,1287,1114,2489,84,2405,-66
"28940",NA,47093,"Knox County, TN","County or equivalent",2006,416014,7205,1702,5190,3488,5499,366,5133,4
"28940",NA,47105,"Loudon County, TN","County or equivalent",2006,44281,1087,-27,478,505,1142,30,1112,-28
"28940",NA,47173,"Union County, TN","County or equivalent",2006,18752,107,83,251,168,33,0,33,-9
"29020",NA,NA,"Kokomo, IN","Metropolitan Statistical Area",2006,99913,-637,348,1310,962,-943,53,-996,-42
"29020",NA,18067,"Howard County, IN","County or equivalent",2006,83795,-516,322,1126,804,-803,51,-854,-35
"29020",NA,18159,"Tipton County, IN","County or equivalent",2006,16118,-121,26,184,158,-140,2,-142,-7
"29100",NA,NA,"La Crosse, WI-MN","Metropolitan Statistical Area",2006,129802,523,353,1428,1075,232,64,168,-62
"29100",NA,27055,"Houston County, MN","County or equivalent",2006,19569,-87,22,203,181,-101,3,-104,-8
"29100",NA,55063,"La Crosse County, WI","County or equivalent",2006,110233,610,331,1225,894,333,61,272,-54
"29140",NA,NA,"Lafayette, IN","Metropolitan Statistical Area",2006,188288,3438,1168,2516,1348,2373,807,1566,-103
"29140",NA,18007,"Benton County, IN","County or equivalent",2006,8831,-10,23,113,90,-28,2,-30,-5
"29140",NA,18015,"Carroll County, IN","County or equivalent",2006,19977,-77,24,214,190,-92,19,-111,-9
"29140",NA,18157,"Tippecanoe County, IN","County or equivalent",2006,159480,3525,1121,2189,1068,2493,786,1707,-89
"29180",NA,NA,"Lafayette, LA","Metropolitan Statistical Area",2006,254366,7152,1780,3723,1943,5517,212,5305,-145
"29180",NA,22055,"Lafayette Parish, LA","County or equivalent",2006,203203,5991,1502,2988,1486,4606,206,4400,-117
"29180",NA,22099,"St. Martin Parish, LA","County or equivalent",2006,51163,1161,278,735,457,911,6,905,-28
"29340",NA,NA,"Lake Charles, LA","Metropolitan Statistical Area",2006,190888,-3073,687,2714,2027,-3687,77,-3764,-73
"29340",NA,22019,"Calcasieu Parish, LA","County or equivalent",2006,183204,-1197,687,2647,1960,-1809,70,-1879,-75
"29340",NA,22023,"Cameron Parish, LA","County or equivalent",2006,7684,-1876,0,67,67,-1878,7,-1885,2
"29420",NA,NA,"Lake Havasu City-Kingman, AZ","Metropolitan Statistical Area",2006,192567,6724,-99,2332,2431,6930,258,6672,-107
"29420",NA,4015,"Mohave County, AZ","County or equivalent",2006,192567,6724,-99,2332,2431,6930,258,6672,-107
"29460",NA,NA,"Lakeland-Winter Haven, FL","Metropolitan Statistical Area",2006,556786,18923,2414,8062,5648,16820,1172,15648,-311
"29460",NA,12105,"Polk County, FL","County or equivalent",2006,556786,18923,2414,8062,5648,16820,1172,15648,-311
"29540",NA,NA,"Lancaster, PA","Metropolitan Statistical Area",2006,493321,4437,2600,7037,4437,2090,608,1482,-253
"29540",NA,42071,"Lancaster County, PA","County or equivalent",2006,493321,4437,2600,7037,4437,2090,608,1482,-253
"29620",NA,NA,"Lansing-East Lansing, MI","Metropolitan Statistical Area",2006,455450,-880,2485,5608,3123,-3173,1060,-4233,-192
"29620",NA,26037,"Clinton County, MI","County or equivalent",2006,69330,473,412,842,430,94,13,81,-33
"29620",NA,26045,"Eaton County, MI","County or equivalent",2006,107109,-30,295,1129,834,-279,76,-355,-46
"29620",NA,26065,"Ingham County, MI","County or equivalent",2006,279011,-1323,1778,3637,1859,-2988,971,-3959,-113
"29700",NA,NA,"Laredo, TX","Metropolitan Statistical Area",2006,226435,5270,4851,5919,1068,543,1407,-864,-124
"29700",NA,48479,"Webb County, TX","County or equivalent",2006,226435,5270,4851,5919,1068,543,1407,-864,-124
"29740",NA,NA,"Las Cruces, NM","Metropolitan Statistical Area",2006,193455,4125,2176,3387,1211,2054,645,1409,-105
"29740",NA,35013,"Dona Ana County, NM","County or equivalent",2006,193455,4125,2176,3387,1211,2054,645,1409,-105
"29820",NA,NA,"Las Vegas-Paradise, NV","Metropolitan Statistical Area",2006,1770676,67719,16039,28629,12590,52685,8249,44436,-1005
"29820",NA,32003,"Clark County, NV","County or equivalent",2006,1770676,67719,16039,28629,12590,52685,8249,44436,-1005
"29940",NA,NA,"Lawrence, KS","Metropolitan Statistical Area",2006,112559,1040,664,1274,610,828,286,542,-452
"29940",NA,20045,"Douglas County, KS","County or equivalent",2006,112559,1040,664,1274,610,828,286,542,-452
"30020",NA,NA,"Lawton, OK","Metropolitan Statistical Area",2006,112256,396,969,1886,917,-521,442,-963,-52
"30020",NA,40031,"Comanche County, OK","County or equivalent",2006,112256,396,969,1886,917,-521,442,-963,-52
"30140",NA,NA,"Lebanon, PA","Metropolitan Statistical Area",2006,126410,1550,201,1585,1384,1414,157,1257,-65
"30140",NA,42075,"Lebanon County, PA","County or equivalent",2006,126410,1550,201,1585,1384,1414,157,1257,-65
"30300",NA,NA,"Lewiston, ID-WA","Metropolitan Statistical Area",2006,59545,584,82,697,615,535,22,513,-33
"30300",NA,16069,"Nez Perce County, ID","County or equivalent",2006,38494,443,23,450,427,443,20,423,-23
"30300",NA,53003,"Asotin County, WA","County or equivalent",2006,21051,141,59,247,188,92,2,90,-10
"30340",NA,NA,"Lewiston-Auburn, ME","Metropolitan Statistical Area",2006,106916,332,358,1388,1030,26,65,-39,-52
"30340",NA,23001,"Androscoggin County, ME","County or equivalent",2006,106916,332,358,1388,1030,26,65,-39,-52
"30460",NA,NA,"Lexington-Fayette, KY","Metropolitan Statistical Area",2006,439859,7576,2952,6245,3293,4856,1111,3745,-232
"30460",NA,21017,"Bourbon County, KY","County or equivalent",2006,19621,-96,38,248,210,-126,32,-158,-8
"30460",NA,21049,"Clark County, KY","County or equivalent",2006,35051,425,135,447,312,307,15,292,-17
"30460",NA,21067,"Fayette County, KY","County or equivalent",2006,275199,3660,1933,3928,1995,1869,951,918,-142
"30460",NA,21113,"Jessamine County, KY","County or equivalent",2006,44550,1380,358,694,336,1049,28,1021,-27
"30460",NA,21209,"Scott County, KY","County or equivalent",2006,41338,2045,438,665,227,1633,37,1596,-26
"30460",NA,21239,"Woodford County, KY","County or equivalent",2006,24100,162,50,263,213,124,48,76,-12
"30620",NA,NA,"Lima, OH","Metropolitan Statistical Area",2006,105202,-348,434,1412,978,-736,30,-766,-46
"30620",NA,39003,"Allen County, OH","County or equivalent",2006,105202,-348,434,1412,978,-736,30,-766,-46
"30700",NA,NA,"Lincoln, NE","Metropolitan Statistical Area",2006,287771,3171,2374,4329,1955,940,818,122,-143
"30700",NA,31109,"Lancaster County, NE","County or equivalent",2006,271091,3104,2362,4126,1764,877,809,68,-135
"30700",NA,31159,"Seward County, NE","County or equivalent",2006,16680,67,12,203,191,63,9,54,-8
"30780",NA,NA,"Little Rock-North Little Rock-Conway, AR","Metropolitan Statistical Area",2006,656613,11350,3912,9530,5618,7502,667,6835,-64
"30780",NA,5045,"Faulkner County, AR","County or equivalent",2006,102011,3447,723,1431,708,2721,71,2650,3
"30780",NA,5053,"Grant County, AR","County or equivalent",2006,17416,156,79,221,142,84,1,83,-7
"30780",NA,5085,"Lonoke County, AR","County or equivalent",2006,61849,2146,431,914,483,1798,33,1765,-83
"30780",NA,5105,"Perry County, AR","County or equivalent",2006,10238,-30,-6,127,133,-20,0,-20,-4
"30780",NA,5119,"Pulaski County, AR","County or equivalent",2006,372157,2936,2429,5759,3330,429,531,-102,78
"30780",NA,5125,"Saline County, AR","County or equivalent",2006,92942,2695,256,1078,822,2490,31,2459,-51
"30860",NA,NA,"Logan, UT-ID","Metropolitan Statistical Area",2006,118402,1798,2128,2631,503,-1494,334,-1828,1164
"30860",NA,16041,"Franklin County, ID","County or equivalent",2006,12003,-6,137,214,77,-139,22,-161,-4
"30860",NA,49005,"Cache County, UT","County or equivalent",2006,106399,1804,1991,2417,426,-1355,312,-1667,1168
"30980",NA,NA,"Longview, TX","Metropolitan Statistical Area",2006,201332,1955,964,3128,2164,1092,320,772,-101
"30980",NA,48183,"Gregg County, TX","County or equivalent",2006,115803,1423,740,1973,1233,741,221,520,-58
"30980",NA,48401,"Rusk County, TX","County or equivalent",2006,47964,360,120,653,533,264,84,180,-24
"30980",NA,48459,"Upshur County, TX","County or equivalent",2006,37565,172,104,502,398,87,15,72,-19
"31020",NA,NA,"Longview, WA","Metropolitan Statistical Area",2006,98685,2454,263,1283,1020,2246,121,2125,-55
"31020",NA,53015,"Cowlitz County, WA","County or equivalent",2006,98685,2454,263,1283,1020,2246,121,2125,-55
"31100",NA,NA,"Los Angeles-Long Beach-Santa Ana, CA","Metropolitan Statistical Area",2006,12796978,-18367,116719,194688,77969,-129739,98254,-227993,-5347
"31100",31084,NA,"Los Angeles-Long Beach-Glendale, CA","Metropolitan Division",2006,9826493,-19517,89663,150496,60833,-105073,76833,-181906,-4107
"31100",31084,6037,"Los Angeles County, CA","County or equivalent",2006,9826493,-19517,89663,150496,60833,-105073,76833,-181906,-4107
"31100",42044,NA,"Santa Ana-Anaheim-Irvine, CA","Metropolitan Division",2006,2970485,1150,27056,44192,17136,-24666,21421,-46087,-1240
"31100",42044,6059,"Orange County, CA","County or equivalent",2006,2970485,1150,27056,44192,17136,-24666,21421,-46087,-1240
"31140",NA,NA,"Louisville/Jefferson County, KY-IN","Metropolitan Statistical Area",2006,1218964,11749,5532,16322,10790,6779,1505,5274,-562
"31140",NA,18019,"Clark County, IN","County or equivalent",2006,103629,2223,475,1428,953,1805,86,1719,-57
"31140",NA,18043,"Floyd County, IN","County or equivalent",2006,72316,527,233,923,690,332,13,319,-38
"31140",NA,18061,"Harrison County, IN","County or equivalent",2006,36614,170,149,455,306,40,16,24,-19
"31140",NA,18175,"Washington County, IN","County or equivalent",2006,27808,198,70,332,262,141,5,136,-13
"31140",NA,21029,"Bullitt County, KY","County or equivalent",2006,72458,1360,340,753,413,1020,12,1008,0
"31140",NA,21103,"Henry County, KY","County or equivalent",2006,15676,98,62,197,135,44,11,33,-8
"31140",NA,21111,"Jefferson County, KY","County or equivalent",2006,702715,2802,3177,9986,6809,-47,1166,-1213,-328
"31140",NA,21163,"Meade County, KY","County or equivalent",2006,27483,-383,87,249,162,-459,41,-500,-11
"31140",NA,21179,"Nelson County, KY","County or equivalent",2006,41700,875,285,586,301,612,27,585,-22
"31140",NA,21185,"Oldham County, KY","County or equivalent",2006,54358,1621,223,547,324,1429,26,1403,-31
"31140",NA,21211,"Shelby County, KY","County or equivalent",2006,39301,1422,329,586,257,1115,99,1016,-22
"31140",NA,21215,"Spencer County, KY","County or equivalent",2006,16026,763,89,178,89,683,3,680,-9
"31140",NA,21223,"Trimble County, KY","County or equivalent",2006,8880,73,13,102,89,64,0,64,-4
"31180",NA,NA,"Lubbock, TX","Metropolitan Statistical Area",2006,265888,3292,1974,4090,2116,1320,242,1078,-2
"31180",NA,48107,"Crosby County, TX","County or equivalent",2006,6484,-43,43,124,81,-82,2,-84,-4
"31180",NA,48303,"Lubbock County, TX","County or equivalent",2006,259404,3335,1931,3966,2035,1402,240,1162,2
"31340",NA,NA,"Lynchburg, VA","Metropolitan Statistical Area",2006,240054,4085,434,2732,2298,3775,182,3593,-124
"31340",NA,51009,"Amherst County, VA","County or equivalent",2006,32049,163,-7,309,316,184,19,165,-14
"31340",NA,51011,"Appomattox County, VA","County or equivalent",2006,13986,177,-3,138,141,187,8,179,-7
"31340",NA,51019,"Bedford County, VA","County or equivalent",2006,65474,1351,153,679,526,1232,23,1209,-34
"31340",NA,51031,"Campbell County, VA","County or equivalent",2006,52412,474,88,563,475,411,24,387,-25
"31340",NA,51515,"Bedford city, VA","County or equivalent",2006,6231,-16,-26,77,103,12,1,11,-2
"31340",NA,51680,"Lynchburg city, VA","County or equivalent",2006,69902,1936,229,966,737,1749,107,1642,-42
"31420",NA,NA,"Macon, GA","Metropolitan Statistical Area",2006,228787,1205,1091,3321,2230,226,161,65,-112
"31420",NA,13021,"Bibb County, GA","County or equivalent",2006,154686,407,786,2441,1655,-306,135,-441,-73
"31420",NA,13079,"Crawford County, GA","County or equivalent",2006,12568,-45,69,149,80,-107,0,-107,-7
"31420",NA,13169,"Jones County, GA","County or equivalent",2006,26913,255,153,346,193,116,11,105,-14
"31420",NA,13207,"Monroe County, GA","County or equivalent",2006,24298,734,58,257,199,690,14,676,-14
"31420",NA,13289,"Twiggs County, GA","County or equivalent",2006,10322,-146,25,128,103,-167,1,-168,-4
"31460",NA,NA,"Madera, CA","Metropolitan Statistical Area",2006,143331,3282,1532,2460,928,1829,706,1123,-79
"31460",NA,6039,"Madera County, CA","County or equivalent",2006,143331,3282,1532,2460,928,1829,706,1123,-79
"31540",NA,NA,"Madison, WI","Metropolitan Statistical Area",2006,546480,6615,3742,6954,3212,3149,1526,1623,-276
"31540",NA,55021,"Columbia County, WI","County or equivalent",2006,54832,264,160,636,476,132,20,112,-28
"31540",NA,55025,"Dane County, WI","County or equivalent",2006,468128,6196,3446,6003,2557,2986,1506,1480,-236
"31540",NA,55049,"Iowa County, WI","County or equivalent",2006,23520,155,136,315,179,31,0,31,-12
"31700",NA,NA,"Manchester-Nashua, NH","Metropolitan Statistical Area",2006,400002,1809,2365,5245,2880,-374,1076,-1450,-182
"31700",NA,33011,"Hillsborough County, NH","County or equivalent",2006,400002,1809,2365,5245,2880,-374,1076,-1450,-182
"31900",NA,NA,"Mansfield, OH","Metropolitan Statistical Area",2006,126298,-637,473,1660,1187,-1053,49,-1102,-57
"31900",NA,39139,"Richland County, OH","County or equivalent",2006,126298,-637,473,1660,1187,-1053,49,-1102,-57
"32580",NA,NA,"McAllen-Edinburg-Mission, TX","Metropolitan Statistical Area",2006,686034,18880,13932,17157,3225,5336,4025,1311,-388
"32580",NA,48215,"Hidalgo County, TX","County or equivalent",2006,686034,18880,13932,17157,3225,5336,4025,1311,-388
"32780",NA,NA,"Medford, OR","Metropolitan Statistical Area",2006,196502,2234,184,2228,2044,2159,224,1935,-109
"32780",NA,41029,"Jackson County, OR","County or equivalent",2006,196502,2234,184,2228,2044,2159,224,1935,-109
"32820",NA,NA,"Memphis, TN-MS-AR","Metropolitan Statistical Area",2006,1270263,17478,9537,20091,10554,8507,1660,6847,-566
"32820",NA,5035,"Crittenden County, AR","County or equivalent",2006,51781,341,350,815,465,-47,25,-72,38
"32820",NA,28033,"DeSoto County, MS","County or equivalent",2006,143612,7646,1172,2058,886,6564,102,6462,-90
"32820",NA,28093,"Marshall County, MS","County or equivalent",2006,36054,288,87,498,411,221,6,215,-20
"32820",NA,28137,"Tate County, MS","County or equivalent",2006,26659,348,131,388,257,231,3,228,-14
"32820",NA,28143,"Tunica County, MS","County or equivalent",2006,10398,239,107,230,123,139,6,133,-7
"32820",NA,47047,"Fayette County, TN","County or equivalent",2006,35730,1737,180,489,309,1579,6,1573,-22
"32820",NA,47157,"Shelby County, TN","County or equivalent",2006,909658,5658,7290,14879,7589,-1210,1490,-2700,-422
"32820",NA,47167,"Tipton County, TN","County or equivalent",2006,56371,1221,220,734,514,1030,22,1008,-29
"32900",NA,NA,"Merced, CA","Metropolitan Statistical Area",2006,241254,3220,3093,4565,1472,250,1085,-835,-123
"32900",NA,6047,"Merced County, CA","County or equivalent",2006,241254,3220,3093,4565,1472,250,1085,-835,-123
"33100",NA,NA,"Miami-Fort Lauderdale-Pompano Beach, FL","Metropolitan Statistical Area",2006,5402334,26924,24452,71959,47507,1376,51971,-50595,1096
"33100",22744,NA,"Fort Lauderdale-Pompano Beach-Deerfield Beach, FL","Metropolitan Division",2006,1764533,827,7666,23165,15499,-6880,12992,-19872,41
"33100",22744,12011,"Broward County, FL","County or equivalent",2006,1764533,827,7666,23165,15499,-6880,12992,-19872,41
"33100",33124,NA,"Miami-Miami Beach-Kendall, FL","Metropolitan Division",2006,2376421,19724,14688,33213,18525,3356,32502,-29146,1680
"33100",33124,12086,"Miami-Dade County, FL","County or equivalent",2006,2376421,19724,14688,33213,18525,3356,32502,-29146,1680
"33100",48424,NA,"West Palm Beach-Boca Raton-Boynton Beach, FL","Metropolitan Division",2006,1261380,6373,2098,15581,13483,4900,6477,-1577,-625
"33100",48424,12099,"Palm Beach County, FL","County or equivalent",2006,1261380,6373,2098,15581,13483,4900,6477,-1577,-625
"33140",NA,NA,"Michigan City-La Porte, IN","Metropolitan Statistical Area",2006,109167,22,306,1382,1076,-235,81,-316,-49
"33140",NA,18091,"LaPorte County, IN","County or equivalent",2006,109167,22,306,1382,1076,-235,81,-316,-49
"33260",NA,NA,"Midland, TX","Metropolitan Statistical Area",2006,123433,2932,1101,1997,896,1897,162,1735,-66
"33260",NA,48329,"Midland County, TX","County or equivalent",2006,123433,2932,1101,1997,896,1897,162,1735,-66
"33340",NA,NA,"Milwaukee-Waukesha-West Allis, WI","Metropolitan Statistical Area",2006,1538721,4559,8677,21522,12845,-8534,3017,-11551,4416
"33340",NA,55079,"Milwaukee County, WI","County or equivalent",2006,951334,2083,6731,15035,8304,-9342,2613,-11955,4694
"33340",NA,55089,"Ozaukee County, WI","County or equivalent",2006,85104,109,201,825,624,-52,64,-116,-40
"33340",NA,55131,"Washington County, WI","County or equivalent",2006,126450,1458,584,1505,921,938,66,872,-64
"33340",NA,55133,"Waukesha County, WI","County or equivalent",2006,375833,909,1161,4157,2996,-78,274,-352,-174
"33460",NA,NA,"Minneapolis-St. Paul-Bloomington, MN-WI","Metropolitan Statistical Area",2006,3164180,32548,27980,46583,18603,6056,8820,-2764,-1488
"33460",NA,27003,"Anoka County, MN","County or equivalent",2006,323367,3154,3040,4431,1391,278,357,-79,-164
"33460",NA,27019,"Carver County, MN","County or equivalent",2006,86271,2389,926,1280,354,1512,119,1393,-49
"33460",NA,27025,"Chisago County, MN","County or equivalent",2006,49344,728,398,703,305,355,3,352,-25
"33460",NA,27037,"Dakota County, MN","County or equivalent",2006,385076,4049,3697,5578,1881,538,598,-60,-186
"33460",NA,27053,"Hennepin County, MN","County or equivalent",2006,1124849,3480,8971,16467,7496,-4976,5436,-10412,-515
"33460",NA,27059,"Isanti County, MN","County or equivalent",2006,38084,879,235,486,251,665,9,656,-21
"33460",NA,27123,"Ramsey County, MN","County or equivalent",2006,496537,-510,3765,7500,3735,-4058,1917,-5975,-217
"33460",NA,27139,"Scott County, MN","County or equivalent",2006,122532,4050,1704,2159,455,2417,115,2302,-71
"33460",NA,27141,"Sherburne County, MN","County or equivalent",2006,84208,3014,975,1388,413,2037,18,2019,2
"33460",NA,27163,"Washington County, MN","County or equivalent",2006,221626,4249,1824,2930,1106,2538,189,2349,-113
"33460",NA,27171,"Wright County, MN","County or equivalent",2006,113698,4074,1499,2077,578,2639,31,2608,-64
"33460",NA,55093,"Pierce County, WI","County or equivalent",2006,39521,524,206,419,213,337,8,329,-19
"33460",NA,55109,"St. Croix County, WI","County or equivalent",2006,79067,2468,740,1165,425,1774,20,1754,-46
"33540",NA,NA,"Missoula, MT","Metropolitan Statistical Area",2006,103973,1833,554,1220,666,1331,67,1264,-52
"33540",NA,30063,"Missoula County, MT","County or equivalent",2006,103973,1833,554,1220,666,1331,67,1264,-52
"33660",NA,NA,"Mobile, AL","Metropolitan Statistical Area",2006,401629,3720,1913,5901,3988,2002,423,1579,-195
"33660",NA,1097,"Mobile County, AL","County or equivalent",2006,401629,3720,1913,5901,3988,2002,423,1579,-195
"33700",NA,NA,"Modesto, CA","Metropolitan Statistical Area",2006,505205,5383,4735,8431,3696,899,1796,-897,-251
"33700",NA,6099,"Stanislaus County, CA","County or equivalent",2006,505205,5383,4735,8431,3696,899,1796,-897,-251
"33740",NA,NA,"Monroe, LA","Metropolitan Statistical Area",2006,172421,1522,821,2575,1754,786,56,730,-85
"33740",NA,22073,"Ouachita Parish, LA","County or equivalent",2006,149618,1437,767,2270,1503,745,43,702,-75
"33740",NA,22111,"Union Parish, LA","County or equivalent",2006,22803,85,54,305,251,41,13,28,-10
"33780",NA,NA,"Monroe, MI","Metropolitan Statistical Area",2006,153150,908,548,1782,1234,434,96,338,-74
"33780",NA,26115,"Monroe County, MI","County or equivalent",2006,153150,908,548,1782,1234,434,96,338,-74
"33860",NA,NA,"Montgomery, AL","Metropolitan Statistical Area",2006,362447,6337,1919,5209,3290,4602,256,4346,-184
"33860",NA,1001,"Autauga County, AL","County or equivalent",2006,49039,1157,191,646,455,992,22,970,-26
"33860",NA,1051,"Elmore County, AL","County or equivalent",2006,75382,2128,395,998,603,1774,28,1746,-41
"33860",NA,1085,"Lowndes County, AL","County or equivalent",2006,12740,-163,20,170,150,-178,0,-178,-5
"33860",NA,1101,"Montgomery County, AL","County or equivalent",2006,225286,3215,1313,3395,2082,2014,206,1808,-112
"34060",NA,NA,"Morgantown, WV","Metropolitan Statistical Area",2006,116759,841,325,1226,901,574,202,372,-58
"34060",NA,54061,"Monongalia County, WV","County or equivalent",2006,86649,520,299,912,613,263,201,62,-42
"34060",NA,54077,"Preston County, WV","County or equivalent",2006,30110,321,26,314,288,311,1,310,-16
"34100",NA,NA,"Morristown, TN","Metropolitan Statistical Area",2006,131915,2117,439,1732,1293,1747,324,1423,-69
"34100",NA,47057,"Grainger County, TN","County or equivalent",2006,22336,246,40,262,222,217,14,203,-11
"34100",NA,47063,"Hamblen County, TN","County or equivalent",2006,60538,691,273,880,607,449,260,189,-31
"34100",NA,47089,"Jefferson County, TN","County or equivalent",2006,49041,1180,126,590,464,1081,50,1031,-27
"34580",NA,NA,"Mount Vernon-Anacortes, WA","Metropolitan Statistical Area",2006,114136,2173,381,1440,1059,1857,342,1515,-65
"34580",NA,53057,"Skagit County, WA","County or equivalent",2006,114136,2173,381,1440,1059,1857,342,1515,-65
"34620",NA,NA,"Muncie, IN","Metropolitan Statistical Area",2006,115498,-1102,59,1282,1223,-1117,109,-1226,-44
"34620",NA,18035,"Delaware County, IN","County or equivalent",2006,115498,-1102,59,1282,1223,-1117,109,-1226,-44
"34740",NA,NA,"Muskegon-Norton Shores, MI","Metropolitan Statistical Area",2006,174045,120,728,2370,1642,-531,90,-621,-77
"34740",NA,26121,"Muskegon County, MI","County or equivalent",2006,174045,120,728,2370,1642,-531,90,-621,-77
"34820",NA,NA,"Myrtle Beach-North Myrtle Beach-Conway, SC","Metropolitan Statistical Area",2006,239496,11242,834,3092,2258,10567,364,10203,-159
"34820",NA,45051,"Horry County, SC","County or equivalent",2006,239496,11242,834,3092,2258,10567,364,10203,-159
"34900",NA,NA,"Napa, CA","Metropolitan Statistical Area",2006,130866,810,545,1733,1188,328,681,-353,-63
"34900",NA,6055,"Napa County, CA","County or equivalent",2006,130866,810,545,1733,1188,328,681,-353,-63
"34940",NA,NA,"Naples-Marco Island, FL","Metropolitan Statistical Area",2006,311602,6121,1589,4221,2632,4713,1977,2736,-181
"34940",NA,12021,"Collier County, FL","County or equivalent",2006,311602,6121,1589,4221,2632,4713,1977,2736,-181
"34980",NA,NA,"Nashville-Davidson--Murfreesboro--Franklin, TN","Metropolitan Statistical Area",2006,1485689,36286,10825,21892,11067,25959,3125,22834,-498
"34980",NA,47015,"Cannon County, TN","County or equivalent",2006,13290,145,12,151,139,140,5,135,-7
"34980",NA,47021,"Cheatham County, TN","County or equivalent",2006,38485,461,197,487,290,283,10,273,-19
"34980",NA,47037,"Davidson County, TN","County or equivalent",2006,614200,6787,4796,9708,4912,1991,2267,-276,0
"34980",NA,47043,"Dickson County, TN","County or equivalent",2006,46316,638,249,668,419,412,6,406,-23
"34980",NA,47081,"Hickman County, TN","County or equivalent",2006,23513,137,50,274,224,98,2,96,-11
"34980",NA,47111,"Macon County, TN","County or equivalent",2006,21421,213,124,314,190,99,30,69,-10
"34980",NA,47147,"Robertson County, TN","County or equivalent",2006,61582,1735,492,1013,521,1275,114,1161,-32
"34980",NA,47149,"Rutherford County, TN","County or equivalent",2006,230581,11029,2249,3542,1293,8925,292,8633,-145
"34980",NA,47159,"Smith County, TN","County or equivalent",2006,18578,119,22,220,198,105,9,96,-8
"34980",NA,47165,"Sumner County, TN","County or equivalent",2006,148303,4576,799,1976,1177,3862,142,3720,-85
"34980",NA,47169,"Trousdale County, TN","County or equivalent",2006,7511,97,-4,92,96,105,6,99,-4
"34980",NA,47187,"Williamson County, TN","County or equivalent",2006,158866,6995,1296,2139,843,5794,196,5598,-95
"34980",NA,47189,"Wilson County, TN","County or equivalent",2006,103043,3354,543,1308,765,2870,46,2824,-59
"35300",NA,NA,"New Haven-Milford, CT","Metropolitan Statistical Area",2006,841881,1764,2554,10196,7642,-406,2972,-3378,-384
"35300",NA,9009,"New Haven County, CT","County or equivalent",2006,841881,1764,2554,10196,7642,-406,2972,-3378,-384
"35380",NA,NA,"New Orleans-Metairie-Kenner, LA","Metropolitan Statistical Area",2006,991902,-320498,398,11888,11490,-320507,1470,-321977,-389
"35380",NA,22051,"Jefferson Parish, LA","County or equivalent",2006,422222,-28626,769,4882,4113,-29419,727,-30146,24
"35380",NA,22071,"Orleans Parish, LA","County or equivalent",2006,210768,-244278,-1588,2444,4032,-242585,511,-243096,-105
"35380",NA,22075,"Plaquemines Parish, LA","County or equivalent",2006,21610,-6955,49,240,191,-7025,9,-7034,21
"35380",NA,22087,"St. Bernard Parish, LA","County or equivalent",2006,13924,-50966,-329,234,563,-50562,27,-50589,-75
"35380",NA,22089,"St. Charles Parish, LA","County or equivalent",2006,51868,1752,273,646,373,1516,40,1476,-37
"35380",NA,22095,"St. John the Baptist Parish, LA","County or equivalent",2006,47647,2079,353,723,370,1762,26,1736,-36
"35380",NA,22103,"St. Tammany Parish, LA","County or equivalent",2006,223863,6496,871,2719,1848,5806,130,5676,-181
"35620",NA,NA,"New York-Northern New Jersey-Long Island, NY-NJ-PA","Metropolitan Statistical Area",2006,18848240,36203,115477,250264,134787,-138714,135277,-273991,59440
"35620",20764,NA,"Edison-New Brunswick, NJ","Metropolitan Division",2006,2299417,4749,9680,29081,19401,-4432,10936,-15368,-499
"35620",20764,34023,"Middlesex County, NJ","County or equivalent",2006,778806,-1723,4804,10242,5438,-6193,6737,-12930,-334
"35620",20764,34025,"Monmouth County, NJ","County or equivalent",2006,641205,-618,2102,7247,5145,-2727,1753,-4480,7
"35620",20764,34029,"Ocean County, NJ","County or equivalent",2006,560952,4256,765,7609,6844,3508,615,2893,-17
"35620",20764,34035,"Somerset County, NJ","County or equivalent",2006,318454,2834,2009,3983,1974,980,1831,-851,-155
"35620",35004,NA,"Nassau-Suffolk, NY","Metropolitan Division",2006,2861958,1717,12596,34157,21561,-24435,7727,-32162,13556
"35620",35004,36059,"Nassau County, NY","County or equivalent",2006,1353766,-2028,4787,15251,10464,-12703,4012,-16715,5888
"35620",35004,36103,"Suffolk County, NY","County or equivalent",2006,1508192,3745,7809,18906,11097,-11732,3715,-15447,7668
"35620",35084,NA,"Newark-Union, NJ-PA","Metropolitan Division",2006,2120189,-1993,11594,27414,15820,-12606,11806,-24412,-981
"35620",35084,34013,"Essex County, NJ","County or equivalent",2006,775041,-5148,5099,11275,6176,-9904,5393,-15297,-343
"35620",35084,34019,"Hunterdon County, NJ","County or equivalent",2006,128997,392,471,1231,760,-15,181,-196,-64
"35620",35084,34027,"Morris County, NJ","County or equivalent",2006,485658,1655,2313,5632,3319,-430,2284,-2714,-228
"35620",35084,34037,"Sussex County, NJ","County or equivalent",2006,151030,301,634,1587,953,-265,141,-406,-68
"35620",35084,34039,"Union County, NJ","County or equivalent",2006,522279,-1024,3019,7247,4228,-3796,3797,-7593,-247
"35620",35084,42103,"Pike County, PA","County or equivalent",2006,57184,1831,58,442,384,1804,10,1794,-31
"35620",35644,NA,"New York-White Plains-Wayne, NY-NJ","Metropolitan Division",2006,11566676,31730,81607,159612,78005,-97241,104808,-202049,47364
"35620",35644,34003,"Bergen County, NJ","County or equivalent",2006,888834,-1403,2298,9119,6821,-3267,5936,-9203,-434
"35620",35644,34017,"Hudson County, NJ","County or equivalent",2006,595220,-3276,3989,8083,4094,-6992,7749,-14741,-273
"35620",35644,34031,"Passaic County, NJ","County or equivalent",2006,489796,-953,3946,7526,3580,-4686,3844,-8530,-213
"35620",35644,36005,"Bronx County, NY","County or equivalent",2006,1371353,6787,12648,22040,9392,-17947,11735,-29682,12086
"35620",35644,36047,"Kings County, NY","County or equivalent",2006,2523047,11639,23082,39552,16470,-30556,24934,-55490,19113
"35620",35644,36061,"New York County, NY","County or equivalent",2006,1612630,6355,9737,20149,10412,18,13830,-13812,-3400
"35620",35644,36079,"Putnam County, NY","County or equivalent",2006,99133,-137,464,1045,581,-557,190,-747,-44
"35620",35644,36081,"Queens County, NY","County or equivalent",2006,2264661,8085,15476,29945,14469,-23425,27874,-51299,16034
"35620",35644,36085,"Richmond County, NY","County or equivalent",2006,478876,3862,2302,5707,3405,-947,1662,-2609,2507
"35620",35644,36087,"Rockland County, NY","County or equivalent",2006,295927,1291,2569,4521,1952,-3276,1261,-4537,1998
"35620",35644,36119,"Westchester County, NY","County or equivalent",2006,947199,-520,5096,11925,6829,-5606,5793,-11399,-10
"35660",NA,NA,"Niles-Benton Harbor, MI","Metropolitan Statistical Area",2006,159366,-668,537,2159,1622,-1138,294,-1432,-67
"35660",NA,26021,"Berrien County, MI","County or equivalent",2006,159366,-668,537,2159,1622,-1138,294,-1432,-67
"35980",NA,NA,"Norwich-New London, CT","Metropolitan Statistical Area",2006,267877,2673,911,3088,2177,1893,610,1283,-131
"35980",NA,9011,"New London County, CT","County or equivalent",2006,267877,2673,911,3088,2177,1893,610,1283,-131
"36100",NA,NA,"Ocala, FL","Metropolitan Statistical Area",2006,313761,12325,-464,3555,4019,13002,325,12677,-213
"36100",NA,12083,"Marion County, FL","County or equivalent",2006,313761,12325,-464,3555,4019,13002,325,12677,-213
"36140",NA,NA,"Ocean City, NJ","Metropolitan Statistical Area",2006,97538,-1019,-363,922,1285,-609,102,-711,-47
"36140",NA,34009,"Cape May County, NJ","County or equivalent",2006,97538,-1019,-363,922,1285,-609,102,-711,-47
"36220",NA,NA,"Odessa, TX","Metropolitan Statistical Area",2006,126449,2099,1230,2326,1096,932,178,754,-63
"36220",NA,48135,"Ector County, TX","County or equivalent",2006,126449,2099,1230,2326,1096,932,178,754,-63
"36260",NA,NA,"Ogden-Clearfield, UT","Metropolitan Statistical Area",2006,503221,11785,7281,10055,2774,4049,916,3133,455
"36260",NA,49011,"Davis County, UT","County or equivalent",2006,278759,9020,4665,5955,1290,3895,352,3543,460
"36260",NA,49029,"Morgan County, UT","County or equivalent",2006,8017,255,107,135,28,153,4,149,-5
"36260",NA,49057,"Weber County, UT","County or equivalent",2006,216445,2510,2509,3965,1456,1,560,-559,0
"36420",NA,NA,"Oklahoma City, OK","Metropolitan Statistical Area",2006,1173292,18805,8048,18136,10088,11358,2714,8644,-601
"36420",NA,40017,"Canadian County, OK","County or equivalent",2006,99956,2887,682,1392,710,2256,76,2180,-51
"36420",NA,40027,"Cleveland County, OK","County or equivalent",2006,231848,6296,1239,2784,1545,5180,426,4754,-123
"36420",NA,40051,"Grady County, OK","County or equivalent",2006,50037,1070,127,672,545,970,7,963,-27
"36420",NA,40081,"Lincoln County, OK","County or equivalent",2006,32240,234,52,414,362,196,9,187,-14
"36420",NA,40083,"Logan County, OK","County or equivalent",2006,35763,357,125,445,320,248,11,237,-16
"36420",NA,40087,"McClain County, OK","County or equivalent",2006,30771,879,142,436,294,754,25,729,-17
"36420",NA,40109,"Oklahoma County, OK","County or equivalent",2006,692677,7082,5681,11993,6312,1754,2160,-406,-353
"36500",NA,NA,"Olympia, WA","Metropolitan Statistical Area",2006,232862,5386,917,2682,1765,4604,328,4276,-135
"36500",NA,53067,"Thurston County, WA","County or equivalent",2006,232862,5386,917,2682,1765,4604,328,4276,-135
"36540",NA,NA,"Omaha-Council Bluffs, NE-IA","Metropolitan Statistical Area",2006,819073,8918,7300,13251,5951,2020,1671,349,-402
"36540",NA,19085,"Harrison County, IA","County or equivalent",2006,15507,-23,-21,178,199,5,4,1,-7
"36540",NA,19129,"Mills County, IA","County or equivalent",2006,15117,264,58,192,134,213,3,210,-7
"36540",NA,19155,"Pottawattamie County, IA","County or equivalent",2006,89284,303,422,1299,877,-75,46,-121,-44
"36540",NA,31025,"Cass County, NE","County or equivalent",2006,25434,61,101,317,216,-28,11,-39,-12
"36540",NA,31055,"Douglas County, NE","County or equivalent",2006,491408,4911,4773,8314,3541,377,1302,-925,-239
"36540",NA,31153,"Sarpy County, NE","County or equivalent",2006,142467,3373,1806,2452,646,1642,281,1361,-75
"36540",NA,31155,"Saunders County, NE","County or equivalent",2006,20057,-144,69,252,183,-204,10,-214,-9
"36540",NA,31177,"Washington County, NE","County or equivalent",2006,19799,173,92,247,155,90,14,76,-9
"36740",NA,NA,"Orlando-Kissimmee, FL","Metropolitan Statistical Area",2006,1993945,58443,14663,28799,14136,44787,10480,34307,-1007
"36740",NA,12069,"Lake County, FL","County or equivalent",2006,288632,13534,33,3344,3311,13738,349,13389,-237
"36740",NA,12095,"Orange County, FL","County or equivalent",2006,1052515,25256,10220,16779,6559,15600,6676,8924,-564
"36740",NA,12097,"Osceola County, FL","County or equivalent",2006,244365,13588,2173,3747,1574,11412,2135,9277,3
"36740",NA,12117,"Seminole County, FL","County or equivalent",2006,408433,6065,2237,4929,2692,4037,1320,2717,-209
"36780",NA,NA,"Oshkosh-Neenah, WI","Metropolitan Statistical Area",2006,160247,799,603,1861,1258,273,160,113,-77
"36780",NA,55139,"Winnebago County, WI","County or equivalent",2006,160247,799,603,1861,1258,273,160,113,-77
"36980",NA,NA,"Owensboro, KY","Metropolitan Statistical Area",2006,111288,535,481,1552,1071,105,41,64,-51
"36980",NA,21059,"Daviess County, KY","County or equivalent",2006,93029,602,421,1310,889,225,32,193,-44
"36980",NA,21091,"Hancock County, KY","County or equivalent",2006,8551,13,46,114,68,-30,1,-31,-3
"36980",NA,21149,"McLean County, KY","County or equivalent",2006,9708,-80,14,128,114,-90,8,-98,-4
"37100",NA,NA,"Oxnard-Thousand Oaks-Ventura, CA","Metropolitan Statistical Area",2006,791247,2682,7433,12405,4972,-4402,3449,-7851,-349
"37100",NA,6111,"Ventura County, CA","County or equivalent",2006,791247,2682,7433,12405,4972,-4402,3449,-7851,-349
"37340",NA,NA,"Palm Bay-Melbourne-Titusville, FL","Metropolitan Statistical Area",2006,530970,4890,-271,5445,5716,5422,661,4761,-261
"37340",NA,12009,"Brevard County, FL","County or equivalent",2006,530970,4890,-271,5445,5716,5422,661,4761,-261
"37380",NA,NA,"Palm Coast, FL","Metropolitan Statistical Area",2006,82274,6936,-45,777,822,7047,66,6981,-66
"37380",NA,12035,"Flagler County, FL","County or equivalent",2006,82274,6936,-45,777,822,7047,66,6981,-66
"37460",NA,NA,"Panama City-Lynn Haven, FL","Metropolitan Statistical Area",2006,163916,2458,840,2328,1488,1701,228,1473,-83
"37460",NA,12005,"Bay County, FL","County or equivalent",2006,163916,2458,840,2328,1488,1701,228,1473,-83
"37620",NA,NA,"Parkersburg-Marietta-Vienna, WV-OH","Metropolitan Statistical Area",2006,160941,-694,117,1872,1755,-743,24,-767,-68
"37620",NA,39167,"Washington County, OH","County or equivalent",2006,61756,-215,79,701,622,-268,3,-271,-26
"37620",NA,54073,"Pleasants County, WV","County or equivalent",2006,7232,-46,-18,68,86,-26,1,-27,-2
"37620",NA,54105,"Wirt County, WV","County or equivalent",2006,5773,-4,-13,59,72,12,1,11,-3
"37620",NA,54107,"Wood County, WV","County or equivalent",2006,86180,-429,69,1044,975,-461,19,-480,-37
"37700",NA,NA,"Pascagoula, MS","Metropolitan Statistical Area",2006,149486,-5595,618,2066,1448,-6164,224,-6388,-49
"37700",NA,28039,"George County, MS","County or equivalent",2006,21525,687,145,340,195,555,15,540,-13
"37700",NA,28059,"Jackson County, MS","County or equivalent",2006,127961,-6282,473,1726,1253,-6719,209,-6928,-36
"37860",NA,NA,"Pensacola-Ferry Pass-Brent, FL","Metropolitan Statistical Area",2006,450703,6108,2166,6169,4003,4173,765,3408,-231
"37860",NA,12033,"Escambia County, FL","County or equivalent",2006,306243,3951,1393,4356,2963,2714,600,2114,-156
"37860",NA,12113,"Santa Rosa County, FL","County or equivalent",2006,144460,2157,773,1813,1040,1459,165,1294,-75
"37900",NA,NA,"Peoria, IL","Metropolitan Statistical Area",2006,368636,1282,1395,4955,3560,46,273,-227,-159
"37900",NA,17123,"Marshall County, IL","County or equivalent",2006,12826,-112,-44,125,169,-63,2,-65,-5
"37900",NA,17143,"Peoria County, IL","County or equivalent",2006,182545,505,1009,2708,1699,-418,226,-644,-86
"37900",NA,17175,"Stark County, IL","County or equivalent",2006,6135,38,-23,53,76,64,0,64,-3
"37900",NA,17179,"Tazewell County, IL","County or equivalent",2006,129765,515,370,1627,1257,209,39,170,-64
"37900",NA,17203,"Woodford County, IL","County or equivalent",2006,37365,336,83,442,359,254,6,248,-1
"37980",NA,NA,"Philadelphia-Camden-Wilmington, PA-NJ-DE-MD","Metropolitan Statistical Area",2006,5805349,18713,24048,76408,52360,-3399,12720,-16119,-1936
"37980",15804,NA,"Camden, NJ","Metropolitan Division",2006,1244821,7081,4613,15102,10489,2267,1988,279,201
"37980",15804,34005,"Burlington County, NJ","County or equivalent",2006,447091,557,1516,5090,3574,-751,720,-1471,-208
"37980",15804,34007,"Camden County, NJ","County or equivalent",2006,516461,1759,2315,6832,4517,-798,1123,-1921,242
"37980",15804,34015,"Gloucester County, NJ","County or equivalent",2006,281269,4765,782,3180,2398,3816,145,3671,167
"37980",37964,NA,"Philadelphia, PA","Metropolitan Division",2006,3873010,6017,15687,52046,36359,-7863,9220,-17083,-1807
"37980",37964,42017,"Bucks County, PA","County or equivalent",2006,618466,2613,1872,6893,5021,1033,834,199,-292
"37980",37964,42029,"Chester County, PA","County or equivalent",2006,478161,7688,2884,6241,3357,5050,822,4228,-246
"37980",37964,42045,"Delaware County, PA","County or equivalent",2006,552922,1443,1463,7012,5549,245,1033,-788,-265
"37980",37964,42091,"Montgomery County, PA","County or equivalent",2006,772753,715,2367,9522,7155,-1305,1343,-2648,-347
"37980",37964,42101,"Philadelphia County, PA","County or equivalent",2006,1450708,-6442,7101,22378,15277,-12886,5188,-18074,-657
"37980",48864,NA,"Wilmington, DE-MD-NJ","Metropolitan Division",2006,687518,5615,3748,9260,5512,2197,1512,685,-330
"37980",48864,10003,"New Castle County, DE","County or equivalent",2006,523194,3370,3194,7278,4084,422,1385,-963,-246
"37980",48864,24015,"Cecil County, MD","County or equivalent",2006,98520,1894,561,1283,722,1385,52,1333,-52
"37980",48864,34033,"Salem County, NJ","County or equivalent",2006,65804,351,-7,699,706,390,75,315,-32
"38060",NA,NA,"Phoenix-Mesa-Scottsdale, AZ","Metropolitan Statistical Area",2006,4035176,161772,40443,68174,27731,123556,20602,102954,-2227
"38060",NA,4013,"Maricopa County, AZ","County or equivalent",2006,3766461,130211,38524,64212,25688,93943,20144,73799,-2256
"38060",NA,4021,"Pinal County, AZ","County or equivalent",2006,268715,31561,1919,3962,2043,29613,458,29155,29
"38220",NA,NA,"Pine Bluff, AR","Metropolitan Statistical Area",2006,102728,-908,389,1423,1034,-1251,57,-1308,-46
"38220",NA,5025,"Cleveland County, AR","County or equivalent",2006,8675,-58,15,106,91,-70,2,-72,-3
"38220",NA,5069,"Jefferson County, AR","County or equivalent",2006,80239,-564,358,1173,815,-885,55,-940,-37
"38220",NA,5079,"Lincoln County, AR","County or equivalent",2006,13814,-286,16,144,128,-296,0,-296,-6
"38300",NA,NA,"Pittsburgh, PA","Metropolitan Statistical Area",2006,2360750,-11606,-2664,24513,27177,-7891,1969,-9860,-1051
"38300",NA,42003,"Allegheny County, PA","County or equivalent",2006,1223379,-9208,-1207,13105,14312,-7461,1733,-9194,-540
"38300",NA,42005,"Armstrong County, PA","County or equivalent",2006,69268,-571,-100,723,823,-443,1,-444,-28
"38300",NA,42007,"Beaver County, PA","County or equivalent",2006,173950,-1405,-269,1789,2058,-1059,46,-1105,-77
"38300",NA,42019,"Butler County, PA","County or equivalent",2006,181070,1080,417,2087,1670,752,66,686,-89
"38300",NA,42051,"Fayette County, PA","County or equivalent",2006,144770,-535,-397,1391,1788,-74,16,-90,-64
"38300",NA,42125,"Washington County, PA","County or equivalent",2006,205136,231,-262,2036,2298,585,48,537,-92
"38300",NA,42129,"Westmoreland County, PA","County or equivalent",2006,363177,-1198,-846,3382,4228,-191,59,-250,-161
"38340",NA,NA,"Pittsfield, MA","Metropolitan Statistical Area",2006,130350,-843,-185,1283,1468,-604,119,-723,-54
"38340",NA,25003,"Berkshire County, MA","County or equivalent",2006,130350,-843,-185,1283,1468,-604,119,-723,-54
"38540",NA,NA,"Pocatello, ID","Metropolitan Statistical Area",2006,87043,899,913,1547,634,-14,83,-97,0
"38540",NA,16005,"Bannock County, ID","County or equivalent",2006,79387,796,820,1418,598,-23,59,-82,-1
"38540",NA,16077,"Power County, ID","County or equivalent",2006,7656,103,93,129,36,9,24,-15,1
"38860",NA,NA,"Portland-South Portland-Biddeford, ME","Metropolitan Statistical Area",2006,511179,90,1221,5547,4326,-905,472,-1377,-226
"38860",NA,23005,"Cumberland County, ME","County or equivalent",2006,274101,194,705,3073,2368,-389,353,-742,-122
"38860",NA,23023,"Sagadahoc County, ME","County or equivalent",2006,36421,88,75,417,342,29,31,-2,-16
"38860",NA,23031,"York County, ME","County or equivalent",2006,200657,-192,441,2057,1616,-545,88,-633,-88
"38900",NA,NA,"Portland-Vancouver-Beaverton, OR-WA","Metropolitan Statistical Area",2006,2126475,39409,13893,28833,14940,26670,8304,18366,-1154
"38900",NA,41005,"Clackamas County, OR","County or equivalent",2006,370591,4979,963,3779,2816,4214,786,3428,-198
"38900",NA,41009,"Columbia County, OR","County or equivalent",2006,48212,1204,179,531,352,1051,12,1039,-26
"38900",NA,41051,"Multnomah County, OR","County or equivalent",2006,684693,9518,4481,9927,5446,5379,3406,1973,-342
"38900",NA,41067,"Washington County, OR","County or equivalent",2006,510927,12776,4826,7561,2735,8238,2595,5643,-288
"38900",NA,41071,"Yamhill County, OR","County or equivalent",2006,93474,2298,411,1203,792,1942,269,1673,-55
"38900",NA,53011,"Clark County, WA","County or equivalent",2006,408071,8411,3014,5733,2719,5636,1233,4403,-239
"38900",NA,53059,"Skamania County, WA","County or equivalent",2006,10507,223,19,99,80,210,3,207,-6
"38940",NA,NA,"Port St. Lucie, FL","Metropolitan Statistical Area",2006,387653,11992,497,4603,4106,11708,799,10909,-213
"38940",NA,12085,"Martin County, FL","County or equivalent",2006,138035,-195,-289,1380,1669,164,283,-119,-70
"38940",NA,12111,"St. Lucie County, FL","County or equivalent",2006,249618,12187,786,3223,2437,11544,516,11028,-143
"39100",NA,NA,"Poughkeepsie-Newburgh-Middletown, NY","Metropolitan Statistical Area",2006,665536,3396,3913,8470,4557,-205,1411,-1616,-312
"39100",NA,36027,"Dutchess County, NY","County or equivalent",2006,291897,62,988,3114,2126,-796,591,-1387,-130
"39100",NA,36071,"Orange County, NY","County or equivalent",2006,373639,3334,2925,5356,2431,591,820,-229,-182
"39140",NA,NA,"Prescott, AZ","Metropolitan Statistical Area",2006,206300,8933,-175,2221,2396,9245,281,8964,-137
"39140",NA,4025,"Yavapai County, AZ","County or equivalent",2006,206300,8933,-175,2221,2396,9245,281,8964,-137
"39300",NA,NA,"Providence-New Bedford-Fall River, RI-MA","Metropolitan Statistical Area",2006,1603632,-6306,4546,18983,14437,-10164,4118,-14282,-688
"39300",NA,25005,"Bristol County, MA","County or equivalent",2006,544641,-858,1727,6626,4899,-2349,833,-3182,-236
"39300",NA,44001,"Bristol County, RI","County or equivalent",2006,50154,-399,-75,435,510,-303,25,-328,-21
"39300",NA,44003,"Kent County, RI","County or equivalent",2006,169256,-1182,37,1734,1697,-1149,139,-1288,-70
"39300",NA,44005,"Newport County, RI","County or equivalent",2006,83154,389,128,837,709,301,181,120,-40
"39300",NA,44007,"Providence County, RI","County or equivalent",2006,629543,-3560,2538,8152,5614,-5831,2831,-8662,-267
"39300",NA,44009,"Washington County, RI","County or equivalent",2006,126884,-696,191,1199,1008,-833,109,-942,-54
"39340",NA,NA,"Provo-Orem, UT","Metropolitan Statistical Area",2006,491159,27426,9897,11705,1808,6669,1180,5489,10860
"39340",NA,49023,"Juab County, UT","County or equivalent",2006,9112,218,127,192,65,97,0,97,-6
"39340",NA,49049,"Utah County, UT","County or equivalent",2006,482047,27208,9770,11513,1743,6572,1180,5392,10866
"39380",NA,NA,"Pueblo, CO","Metropolitan Statistical Area",2006,151698,1995,600,2024,1424,1470,151,1319,-75
"39380",NA,8101,"Pueblo County, CO","County or equivalent",2006,151698,1995,600,2024,1424,1470,151,1319,-75
"39460",NA,NA,"Punta Gorda, FL","Metropolitan Statistical Area",2006,152804,-338,-909,1128,2037,695,152,543,-124
"39460",NA,12015,"Charlotte County, FL","County or equivalent",2006,152804,-338,-909,1128,2037,695,152,543,-124
"39540",NA,NA,"Racine, WI","Metropolitan Statistical Area",2006,198083,1285,1060,2596,1536,-251,239,-490,476
"39540",NA,55101,"Racine County, WI","County or equivalent",2006,198083,1285,1060,2596,1536,-251,239,-490,476
"39580",NA,NA,"Raleigh-Cary, NC","Metropolitan Statistical Area",2006,997115,44022,10619,15756,5137,33488,4138,29350,-85
"39580",NA,37069,"Franklin County, NC","County or equivalent",2006,55315,1082,279,743,464,832,119,713,-29
"39580",NA,37101,"Johnston County, NC","County or equivalent",2006,150586,5315,1278,2287,1009,4121,450,3671,-84
"39580",NA,37183,"Wake County, NC","County or equivalent",2006,791214,37625,9062,12726,3664,28535,3569,24966,28
"39660",NA,NA,"Rapid City, SD","Metropolitan Statistical Area",2006,118945,914,1027,1917,890,-56,140,-196,-57
"39660",NA,46093,"Meade County, SD","County or equivalent",2006,24283,-207,145,380,235,-342,58,-400,-10
"39660",NA,46103,"Pennington County, SD","County or equivalent",2006,94662,1121,882,1537,655,286,82,204,-47
"39740",NA,NA,"Reading, PA","Metropolitan Statistical Area",2006,398353,5048,1592,5060,3468,3651,761,2890,-195
"39740",NA,42011,"Berks County, PA","County or equivalent",2006,398353,5048,1592,5060,3468,3651,761,2890,-195
"39820",NA,NA,"Redding, CA","Metropolitan Statistical Area",2006,178252,711,188,2135,1947,605,103,502,-82
"39820",NA,6089,"Shasta County, CA","County or equivalent",2006,178252,711,188,2135,1947,605,103,502,-82
"39900",NA,NA,"Reno-Sparks, NV","Metropolitan Statistical Area",2006,401136,7390,2984,5953,2969,4622,1494,3128,-216
"39900",NA,32029,"Storey County, NV","County or equivalent",2006,4076,60,23,37,14,39,2,37,-2
"39900",NA,32031,"Washoe County, NV","County or equivalent",2006,397060,7330,2961,5916,2955,4583,1492,3091,-214
"40060",NA,NA,"Richmond, VA","Metropolitan Statistical Area",2006,1193875,20784,6261,15945,9684,15149,1857,13292,-626
"40060",NA,51007,"Amelia County, VA","County or equivalent",2006,12388,297,35,161,126,269,0,269,-7
"40060",NA,51033,"Caroline County, VA","County or equivalent",2006,26422,1180,151,376,225,1043,9,1034,-14
"40060",NA,51036,"Charles City County, VA","County or equivalent",2006,7116,75,4,72,68,74,2,72,-3
"40060",NA,51041,"Chesterfield County, VA","County or equivalent",2006,293361,7470,2118,3845,1727,5504,425,5079,-152
"40060",NA,51049,"Cumberland County, VA","County or equivalent",2006,9437,107,26,116,90,86,9,77,-5
"40060",NA,51053,"Dinwiddie County, VA","County or equivalent",2006,25390,219,35,274,239,196,8,188,-12
"40060",NA,51075,"Goochland County, VA","County or equivalent",2006,19972,745,49,210,161,707,12,695,-11
"40060",NA,51085,"Hanover County, VA","County or equivalent",2006,97992,1534,324,1053,729,1262,40,1222,-52
"40060",NA,51087,"Henrico County, VA","County or equivalent",2006,285187,4018,1729,4063,2334,2442,772,1670,-153
"40060",NA,51097,"King and Queen County, VA","County or equivalent",2006,6831,99,-5,72,77,108,0,108,-4
"40060",NA,51101,"King William County, VA","County or equivalent",2006,15134,632,72,187,115,570,6,564,-10
"40060",NA,51109,"Louisa County, VA","County or equivalent",2006,31008,1160,128,380,252,1051,5,1046,-19
"40060",NA,51127,"New Kent County, VA","County or equivalent",2006,16642,696,59,167,108,647,3,644,-10
"40060",NA,51145,"Powhatan County, VA","County or equivalent",2006,27292,1017,108,263,155,925,0,925,-16
"40060",NA,51149,"Prince George County, VA","County or equivalent",2006,35941,-386,166,357,191,-538,125,-663,-14
"40060",NA,51183,"Sussex County, VA","County or equivalent",2006,12073,235,-10,120,130,252,7,245,-7
"40060",NA,51570,"Colonial Heights city, VA","County or equivalent",2006,17784,268,26,233,207,251,17,234,-9
"40060",NA,51670,"Hopewell city, VA","County or equivalent",2006,22727,213,89,354,265,135,18,117,-11
"40060",NA,51730,"Petersburg city, VA","County or equivalent",2006,32698,311,86,522,436,242,27,215,-17
"40060",NA,51760,"Richmond city, VA","County or equivalent",2006,198480,894,1071,3120,2049,-77,372,-449,-100
"40140",NA,NA,"Riverside-San Bernardino-Ontario, CA","Metropolitan Statistical Area",2006,3982512,110921,39567,66345,26778,73557,12380,61177,-2203
"40140",NA,6065,"Riverside County, CA","County or equivalent",2006,2000816,78430,18284,32516,14232,61333,6044,55289,-1187
"40140",NA,6071,"San Bernardino County, CA","County or equivalent",2006,1981696,32491,21283,33829,12546,12224,6336,5888,-1016
"40220",NA,NA,"Roanoke, VA","Metropolitan Statistical Area",2006,294181,2371,156,3463,3307,2363,286,2077,-148
"40220",NA,51023,"Botetourt County, VA","County or equivalent",2006,31862,357,6,296,290,367,2,365,-16
"40220",NA,51045,"Craig County, VA","County or equivalent",2006,5088,15,-13,40,53,31,0,31,-3
"40220",NA,51067,"Franklin County, VA","County or equivalent",2006,50340,585,90,579,489,520,10,510,-25
"40220",NA,51161,"Roanoke County, VA","County or equivalent",2006,89425,1060,72,992,920,1032,94,938,-44
"40220",NA,51770,"Roanoke city, VA","County or equivalent",2006,92408,67,114,1345,1231,0,160,-160,-47
"40220",NA,51775,"Salem city, VA","County or equivalent",2006,25058,287,-113,211,324,413,20,393,-13
"40340",NA,NA,"Rochester, MN","Metropolitan Statistical Area",2006,178361,2432,1662,2792,1130,862,556,306,-92
"40340",NA,27039,"Dodge County, MN","County or equivalent",2006,19436,168,165,293,128,13,15,-2,-10
"40340",NA,27109,"Olmsted County, MN","County or equivalent",2006,137080,2178,1398,2222,824,850,517,333,-70
"40340",NA,27157,"Wabasha County, MN","County or equivalent",2006,21845,86,99,277,178,-1,24,-25,-12
"40380",NA,NA,"Rochester, NY","Metropolitan Statistical Area",2006,1032857,-1915,3474,11972,8498,-4942,1831,-6773,-447
"40380",NA,36051,"Livingston County, NY","County or equivalent",2006,63278,-240,148,647,499,-360,7,-367,-28
"40380",NA,36055,"Monroe County, NY","County or equivalent",2006,731983,-1009,2696,8726,6030,-3391,1686,-5077,-314
"40380",NA,36069,"Ontario County, NY","County or equivalent",2006,103334,35,193,1111,918,-112,85,-197,-46
"40380",NA,36073,"Orleans County, NY","County or equivalent",2006,42517,-230,91,426,335,-302,13,-315,-19
"40380",NA,36117,"Wayne County, NY","County or equivalent",2006,91745,-471,346,1062,716,-777,40,-817,-40
"40420",NA,NA,"Rockford, IL","Metropolitan Statistical Area",2006,344634,5440,1924,4753,2829,3545,809,2736,-29
"40420",NA,17007,"Boone County, IL","County or equivalent",2006,51531,1975,420,756,336,1584,120,1464,-29
"40420",NA,17201,"Winnebago County, IL","County or equivalent",2006,293103,3465,1504,3997,2493,1961,689,1272,0
"40580",NA,NA,"Rocky Mount, NC","Metropolitan Statistical Area",2006,144375,571,398,1874,1476,224,174,50,-51
"40580",NA,37065,"Edgecombe County, NC","County or equivalent",2006,53106,-288,138,710,572,-423,73,-496,-3
"40580",NA,37127,"Nash County, NC","County or equivalent",2006,91269,859,260,1164,904,647,101,546,-48
"40660",NA,NA,"Rome, GA","Metropolitan Statistical Area",2006,95006,813,476,1461,985,384,211,173,-47
"40660",NA,13115,"Floyd County, GA","County or equivalent",2006,95006,813,476,1461,985,384,211,173,-47
"40900",NA,NA,"Sacramento--Arden-Arcade--Roseville, CA","Metropolitan Statistical Area",2006,2055989,23603,15101,30037,14936,9548,7769,1779,-1046
"40900",NA,6017,"El Dorado County, CA","County or equivalent",2006,174871,1461,759,2025,1266,797,259,538,-95
"40900",NA,6061,"Placer County, CA","County or equivalent",2006,323758,8983,1452,3876,2424,7736,439,7297,-205
"40900",NA,6067,"Sacramento County, CA","County or equivalent",2006,1367737,9821,11491,21578,10087,-1025,5812,-6837,-645
"40900",NA,6113,"Yolo County, CA","County or equivalent",2006,189623,3338,1399,2558,1159,2040,1259,781,-101
"40980",NA,NA,"Saginaw-Saginaw Township North, MI","Metropolitan Statistical Area",2006,204862,-1595,535,2632,2097,-2048,129,-2177,-82
"40980",NA,26145,"Saginaw County, MI","County or equivalent",2006,204862,-1595,535,2632,2097,-2048,129,-2177,-82
"41060",NA,NA,"St. Cloud, MN","Metropolitan Statistical Area",2006,183257,1923,1493,2604,1111,430,148,282,0
"41060",NA,27009,"Benton County, MN","County or equivalent",2006,38971,330,302,623,321,29,26,3,-1
"41060",NA,27145,"Stearns County, MN","County or equivalent",2006,144286,1593,1191,1981,790,401,122,279,1
"41100",NA,NA,"St. George, UT","Metropolitan Statistical Area",2006,127073,7997,1753,2677,924,6348,142,6206,-104
"41100",NA,49053,"Washington County, UT","County or equivalent",2006,127073,7997,1753,2677,924,6348,142,6206,-104
"41140",NA,NA,"St. Joseph, MO-KS","Metropolitan Statistical Area",2006,124277,705,233,1552,1319,188,41,147,284
"41140",NA,20043,"Doniphan County, KS","County or equivalent",2006,7733,16,-5,69,74,24,1,23,-3
"41140",NA,29003,"Andrew County, MO","County or equivalent",2006,16790,285,-1,186,187,295,2,293,-9
"41140",NA,29021,"Buchanan County, MO","County or equivalent",2006,87472,375,229,1177,948,-156,34,-190,302
"41140",NA,29063,"DeKalb County, MO","County or equivalent",2006,12282,29,10,120,110,25,4,21,-6
"41180",NA,NA,"St. Louis, MO-IL","Metropolitan Statistical Area",2006,2790760,17604,11837,36635,24798,-59,3611,-3670,5826
"41180",NA,17005,"Bond County, IL","County or equivalent",2006,18116,-18,65,210,145,-74,2,-76,-9
"41180",NA,17013,"Calhoun County, IL","County or equivalent",2006,5124,5,0,59,59,8,0,8,-3
"41180",NA,17027,"Clinton County, IL","County or equivalent",2006,36305,293,47,390,343,264,18,246,-18
"41180",NA,17083,"Jersey County, IL","County or equivalent",2006,22331,146,28,266,238,129,1,128,-11
"41180",NA,17117,"Macoupin County, IL","County or equivalent",2006,48130,-307,-67,523,590,-220,5,-225,-20
"41180",NA,17119,"Madison County, IL","County or equivalent",2006,265984,1159,726,3317,2591,432,98,334,1
"41180",NA,17133,"Monroe County, IL","County or equivalent",2006,31878,587,67,360,293,520,4,516,0
"41180",NA,17163,"St. Clair County, IL","County or equivalent",2006,260470,1694,1247,3740,2493,4,330,-326,443
"41180",NA,29071,"Franklin County, MO","County or equivalent",2006,99006,847,454,1299,845,443,8,435,-50
"41180",NA,29099,"Jefferson County, MO","County or equivalent",2006,213659,3026,1268,2932,1664,1865,72,1793,-107
"41180",NA,29113,"Lincoln County, MO","County or equivalent",2006,49594,2176,376,725,349,1830,9,1821,-30
"41180",NA,29183,"St. Charles County, MO","County or equivalent",2006,335820,8445,2514,4540,2026,6120,166,5954,-189
"41180",NA,29189,"St. Louis County, MO","County or equivalent",2006,996953,-2864,2931,12225,9294,-5359,1507,-6866,-436
"41180",NA,29219,"Warren County, MO","County or equivalent",2006,29470,885,222,441,219,679,7,672,-16
"41180",NA,29221,"Washington County, MO","County or equivalent",2006,24083,265,133,364,231,144,5,139,-12
"41180",NA,29510,"St. Louis city, MO","County or equivalent",2006,353837,1265,1826,5244,3418,-6844,1379,-8223,6283
"41420",NA,NA,"Salem, OR","Metropolitan Statistical Area",2006,378599,6820,2769,5688,2919,4257,1565,2692,-206
"41420",NA,41047,"Marion County, OR","County or equivalent",2006,305962,4263,2415,4817,2402,2006,1408,598,-158
"41420",NA,41053,"Polk County, OR","County or equivalent",2006,72637,2557,354,871,517,2251,157,2094,-48
"41500",NA,NA,"Salinas, CA","Metropolitan Statistical Area",2006,403922,-2965,5045,7429,2384,-7849,3475,-11324,-161
"41500",NA,6053,"Monterey County, CA","County or equivalent",2006,403922,-2965,5045,7429,2384,-7849,3475,-11324,-161
"41540",NA,NA,"Salisbury, MD","Metropolitan Statistical Area",2006,117871,2011,430,1512,1082,1646,158,1488,-65
"41540",NA,24039,"Somerset County, MD","County or equivalent",2006,25775,245,52,278,226,206,26,180,-13
"41540",NA,24045,"Wicomico County, MD","County or equivalent",2006,92096,1766,378,1234,856,1440,132,1308,-52
"41620",NA,NA,"Salt Lake City, UT","Metropolitan Statistical Area",2006,1074254,28349,14924,20517,5593,7112,4816,2296,6313
"41620",NA,49035,"Salt Lake County, UT","County or equivalent",2006,987035,25937,13649,18874,5225,5928,4622,1306,6360
"41620",NA,49043,"Summit County, UT","County or equivalent",2006,34867,208,415,533,118,-192,126,-318,-15
"41620",NA,49045,"Tooele County, UT","County or equivalent",2006,52352,2204,860,1110,250,1376,68,1308,-32
"41660",NA,NA,"San Angelo, TX","Metropolitan Statistical Area",2006,107515,870,632,1605,973,290,175,115,-52
"41660",NA,48235,"Irion County, TX","County or equivalent",2006,1743,44,3,11,8,42,0,42,-1
"41660",NA,48451,"Tom Green County, TX","County or equivalent",2006,105772,826,629,1594,965,248,175,73,-51
"41700",NA,NA,"San Antonio, TX","Metropolitan Statistical Area",2006,1931994,52865,17633,31015,13382,36278,4857,31421,-1046
"41700",NA,48013,"Atascosa County, TX","County or equivalent",2006,42950,506,347,651,304,180,34,146,-21
"41700",NA,48019,"Bandera County, TX","County or equivalent",2006,19641,150,-18,158,176,177,16,161,-9
"41700",NA,48029,"Bexar County, TX","County or equivalent",2006,1551362,38708,15697,26211,10514,23833,4452,19381,-822
"41700",NA,48091,"Comal County, TX","County or equivalent",2006,99779,5153,435,1178,743,4781,100,4681,-63
"41700",NA,48187,"Guadalupe County, TX","County or equivalent",2006,107436,5177,742,1451,709,4500,194,4306,-65
"41700",NA,48259,"Kendall County, TX","County or equivalent",2006,29749,1358,40,310,270,1340,33,1307,-22
"41700",NA,48325,"Medina County, TX","County or equivalent",2006,43158,809,243,594,351,588,19,569,-22
"41700",NA,48493,"Wilson County, TX","County or equivalent",2006,37919,1004,147,462,315,879,9,870,-22
"41740",NA,NA,"San Diego-Carlsbad-San Marcos, CA","Metropolitan Statistical Area",2006,2937023,5334,26395,46298,19903,-19778,16007,-35785,-1283
"41740",NA,6073,"San Diego County, CA","County or equivalent",2006,2937023,5334,26395,46298,19903,-19778,16007,-35785,-1283
"41780",NA,NA,"Sandusky, OH","Metropolitan Statistical Area",2006,77423,-363,31,804,773,-361,23,-384,-33
"41780",NA,39043,"Erie County, OH","County or equivalent",2006,77423,-363,31,804,773,-361,23,-384,-33
"41860",NA,NA,"San Francisco-Oakland-Fremont, CA","Metropolitan Statistical Area",2006,4177611,20008,26678,55505,28827,-10366,30138,-40504,3696
"41860",36084,NA,"Oakland-Fremont-Hayward, CA","Metropolitan Division",2006,2449191,7397,18089,34382,16293,-9604,16340,-25944,-1088
"41860",36084,6001,"Alameda County, CA","County or equivalent",2006,1443492,3749,11684,21022,9338,-7300,11833,-19133,-635
"41860",36084,6013,"Contra Costa County, CA","County or equivalent",2006,1005699,3648,6405,13360,6955,-2304,4507,-6811,-453
"41860",41884,NA,"San Francisco-San Mateo-Redwood City, CA","Metropolitan Division",2006,1728420,12611,8589,21123,12534,-762,13798,-14560,4784
"41860",41884,6041,"Marin County, CA","County or equivalent",2006,245228,708,923,2747,1824,-102,1167,-1269,-113
"41860",41884,6075,"San Francisco County, CA","County or equivalent",2006,786367,9753,2466,8411,5945,2077,6764,-4687,5210
"41860",41884,6081,"San Mateo County, CA","County or equivalent",2006,696825,2150,5200,9965,4765,-2737,5867,-8604,-313
"41940",NA,NA,"San Jose-Sunnyvale-Santa Clara, CA","Metropolitan Statistical Area",2006,1762258,19375,18422,27618,9196,1813,19610,-17797,-860
"41940",NA,6069,"San Benito County, CA","County or equivalent",2006,54448,-479,651,912,261,-1109,266,-1375,-21
"41940",NA,6085,"Santa Clara County, CA","County or equivalent",2006,1707810,19854,17771,26706,8935,2922,19344,-16422,-839
"42020",NA,NA,"San Luis Obispo-Paso Robles, CA","Metropolitan Statistical Area",2006,259650,1871,511,2686,2175,1485,492,993,-125
"42020",NA,6079,"San Luis Obispo County, CA","County or equivalent",2006,259650,1871,511,2686,2175,1485,492,993,-125
"42060",NA,NA,"Santa Barbara-Santa Maria-Goleta, CA","Metropolitan Statistical Area",2006,400393,-1183,3306,6195,2889,-4315,2274,-6589,-174
"42060",NA,6083,"Santa Barbara County, CA","County or equivalent",2006,400393,-1183,3306,6195,2889,-4315,2274,-6589,-174
"42100",NA,NA,"Santa Cruz-Watsonville, CA","Metropolitan Statistical Area",2006,249643,40,1893,3460,1567,-1746,1176,-2922,-107
"42100",NA,6087,"Santa Cruz County, CA","County or equivalent",2006,249643,40,1893,3460,1567,-1746,1176,-2922,-107
"42140",NA,NA,"Santa Fe, NM","Metropolitan Statistical Area",2006,140648,1458,798,1690,892,732,595,137,-72
"42140",NA,35049,"Santa Fe County, NM","County or equivalent",2006,140648,1458,798,1690,892,732,595,137,-72
"42220",NA,NA,"Santa Rosa-Petaluma, CA","Metropolitan Statistical Area",2006,460947,-1352,2001,5774,3773,-3155,1942,-5097,-198
"42220",NA,6097,"Sonoma County, CA","County or equivalent",2006,460947,-1352,2001,5774,3773,-3155,1942,-5097,-198
"42340",NA,NA,"Savannah, GA","Metropolitan Statistical Area",2006,321185,7007,2233,4931,2698,4941,539,4402,-167
"42340",NA,13029,"Bryan County, GA","County or equivalent",2006,28705,903,197,404,207,721,23,698,-15
"42340",NA,13051,"Chatham County, GA","County or equivalent",2006,243847,3986,1592,3804,2212,2517,504,2013,-123
"42340",NA,13103,"Effingham County, GA","County or equivalent",2006,48633,2118,444,723,279,1703,12,1691,-29
"42540",NA,NA,"Scranton--Wilkes-Barre, PA","Metropolitan Statistical Area",2006,548031,-225,-1480,5704,7184,1502,266,1236,-247
"42540",NA,42069,"Lackawanna County, PA","County or equivalent",2006,208911,-104,-550,2237,2787,541,110,431,-95
"42540",NA,42079,"Luzerne County, PA","County or equivalent",2006,311291,-40,-956,3164,4120,1055,152,903,-139
"42540",NA,42131,"Wyoming County, PA","County or equivalent",2006,27829,-81,26,303,277,-94,4,-98,-13
"42660",NA,NA,"Seattle-Tacoma-Bellevue, WA","Metropolitan Statistical Area",2006,3253977,56607,22560,43358,20798,34765,13513,21252,-718
"42660",42644,NA,"Seattle-Bellevue-Everett, WA","Metropolitan Division",2006,2490290,42122,16995,32428,15433,25452,11625,13827,-325
"42660",42644,53033,"King County, WA","County or equivalent",2006,1827533,28448,12118,23432,11314,16314,9715,6599,16
"42660",42644,53061,"Snohomish County, WA","County or equivalent",2006,662757,13674,4877,8996,4119,9138,1910,7228,-341
"42660",45104,NA,"Tacoma, WA","Metropolitan Division",2006,763687,14485,5565,10930,5365,9313,1888,7425,-393
"42660",45104,53053,"Pierce County, WA","County or equivalent",2006,763687,14485,5565,10930,5365,9313,1888,7425,-393
"42680",NA,NA,"Sebastian-Vero Beach, FL","Metropolitan Statistical Area",2006,129300,2722,-224,1409,1633,3017,236,2781,-71
"42680",NA,12061,"Indian River County, FL","County or equivalent",2006,129300,2722,-224,1409,1633,3017,236,2781,-71
"43100",NA,NA,"Sheboygan, WI","Metropolitan Statistical Area",2006,113898,235,351,1448,1097,-63,143,-206,-53
"43100",NA,55117,"Sheboygan County, WI","County or equivalent",2006,113898,235,351,1448,1097,-63,143,-206,-53
"43300",NA,NA,"Sherman-Denison, TX","Metropolitan Statistical Area",2006,116829,1252,359,1600,1241,953,190,763,-60
"43300",NA,48181,"Grayson County, TX","County or equivalent",2006,116829,1252,359,1600,1241,953,190,763,-60
"43340",NA,NA,"Shreveport-Bossier City, LA","Metropolitan Statistical Area",2006,386913,5522,1915,5750,3835,3802,315,3487,-195
"43340",NA,22015,"Bossier Parish, LA","County or equivalent",2006,107602,2345,811,1683,872,1591,169,1422,-57
"43340",NA,22017,"Caddo Parish, LA","County or equivalent",2006,253260,3072,1017,3674,2657,2180,140,2040,-125
"43340",NA,22031,"De Soto Parish, LA","County or equivalent",2006,26051,105,87,393,306,31,6,25,-13
"43580",NA,NA,"Sioux City, IA-NE-SD","Metropolitan Statistical Area",2006,141656,839,1084,2276,1192,-179,474,-653,-66
"43580",NA,19193,"Woodbury County, IA","County or equivalent",2006,101796,408,766,1632,866,-313,324,-637,-45
"43580",NA,31043,"Dakota County, NE","County or equivalent",2006,20116,127,198,380,182,-60,121,-181,-11
"43580",NA,31051,"Dixon County, NE","County or equivalent",2006,6153,15,27,86,59,-9,7,-16,-3
"43580",NA,46127,"Union County, SD","County or equivalent",2006,13591,289,93,178,85,203,22,181,-7
"43620",NA,NA,"Sioux Falls, SD","Metropolitan Statistical Area",2006,221462,6791,1903,3484,1581,3830,384,3446,1058
"43620",NA,46083,"Lincoln County, SD","County or equivalent",2006,35699,1996,470,703,233,1456,20,1436,70
"43620",NA,46087,"McCook County, SD","County or equivalent",2006,5721,-102,-8,64,72,-91,0,-91,-3
"43620",NA,46099,"Minnehaha County, SD","County or equivalent",2006,171694,4954,1446,2616,1170,2514,363,2151,994
"43620",NA,46125,"Turner County, SD","County or equivalent",2006,8348,-57,-5,101,106,-49,1,-50,-3
"43780",NA,NA,"South Bend-Mishawaka, IN-MI","Metropolitan Statistical Area",2006,315812,348,1494,4411,2917,-998,534,-1532,-148
"43780",NA,18141,"St. Joseph County, IN","County or equivalent",2006,265212,680,1494,3916,2422,-694,520,-1214,-120
"43780",NA,26027,"Cass County, MI","County or equivalent",2006,50600,-332,0,495,495,-304,14,-318,-28
"43900",NA,NA,"Spartanburg, SC","Metropolitan Statistical Area",2006,269546,4264,1022,3581,2559,3385,390,2995,-143
"43900",NA,45083,"Spartanburg County, SC","County or equivalent",2006,269546,4264,1022,3581,2559,3385,390,2995,-143
"44060",NA,NA,"Spokane, WA","Metropolitan Statistical Area",2006,446932,6501,2093,5738,3645,4644,760,3884,-236
"44060",NA,53063,"Spokane County, WA","County or equivalent",2006,446932,6501,2093,5738,3645,4644,760,3884,-236
"44100",NA,NA,"Springfield, IL","Metropolitan Statistical Area",2006,205654,678,587,2565,1978,100,103,-3,-9
"44100",NA,17129,"Menard County, IL","County or equivalent",2006,12338,-61,-2,122,124,-52,3,-55,-7
"44100",NA,17167,"Sangamon County, IL","County or equivalent",2006,193316,739,589,2443,1854,152,100,52,-2
"44140",NA,NA,"Springfield, MA","Metropolitan Statistical Area",2006,686715,784,1290,7685,6395,-192,2163,-2355,-314
"44140",NA,25011,"Franklin County, MA","County or equivalent",2006,71693,-244,8,671,663,-220,95,-315,-32
"44140",NA,25013,"Hampden County, MA","County or equivalent",2006,460727,510,1275,5780,4505,-559,1775,-2334,-206
"44140",NA,25015,"Hampshire County, MA","County or equivalent",2006,154295,518,7,1234,1227,587,293,294,-76
"44180",NA,NA,"Springfield, MO","Metropolitan Statistical Area",2006,410123,9713,1937,5626,3689,7999,193,7806,-223
"44180",NA,29043,"Christian County, MO","County or equivalent",2006,69688,3279,538,1033,495,2785,8,2777,-44
"44180",NA,29059,"Dallas County, MO","County or equivalent",2006,16449,245,57,244,187,194,4,190,-6
"44180",NA,29077,"Greene County, MO","County or equivalent",2006,259363,4887,1028,3410,2382,3998,155,3843,-139
"44180",NA,29167,"Polk County, MO","County or equivalent",2006,29643,601,74,388,314,542,21,521,-15
"44180",NA,29225,"Webster County, MO","County or equivalent",2006,34980,701,240,551,311,480,5,475,-19
"44220",NA,NA,"Springfield, OH","Metropolitan Statistical Area",2006,140966,-588,183,1764,1581,-708,35,-743,-63
"44220",NA,39023,"Clark County, OH","County or equivalent",2006,140966,-588,183,1764,1581,-708,35,-743,-63
"44300",NA,NA,"State College, PA","Metropolitan Statistical Area",2006,143769,2330,433,1313,880,1969,543,1426,-72
"44300",NA,42027,"Centre County, PA","County or equivalent",2006,143769,2330,433,1313,880,1969,543,1426,-72
"44700",NA,NA,"Stockton, CA","Metropolitan Statistical Area",2006,662395,6529,6892,11753,4861,-33,2565,-2598,-330
"44700",NA,6077,"San Joaquin County, CA","County or equivalent",2006,662395,6529,6892,11753,4861,-33,2565,-2598,-330
"44940",NA,NA,"Sumter, SC","Metropolitan Statistical Area",2006,104101,-648,748,1696,948,-1353,189,-1542,-43
"44940",NA,45085,"Sumter County, SC","County or equivalent",2006,104101,-648,748,1696,948,-1353,189,-1542,-43
"45060",NA,NA,"Syracuse, NY","Metropolitan Statistical Area",2006,644872,-1580,1873,7398,5525,-3161,980,-4141,-292
"45060",NA,36053,"Madison County, NY","County or equivalent",2006,69630,91,186,708,522,-62,22,-84,-33
"45060",NA,36067,"Onondaga County, NY","County or equivalent",2006,453647,-1253,1363,5343,3980,-2409,926,-3335,-207
"45060",NA,36075,"Oswego County, NY","County or equivalent",2006,121595,-418,324,1347,1023,-690,32,-722,-52
"45220",NA,NA,"Tallahassee, FL","Metropolitan Statistical Area",2006,347328,5780,2018,4391,2373,3943,510,3433,-181
"45220",NA,12039,"Gadsden County, FL","County or equivalent",2006,46092,307,318,778,460,12,59,-47,-23
"45220",NA,12065,"Jefferson County, FL","County or equivalent",2006,14530,146,10,161,151,144,0,144,-8
"45220",NA,12073,"Leon County, FL","County or equivalent",2006,257617,3944,1648,3180,1532,2426,445,1981,-130
"45220",NA,12129,"Wakulla County, FL","County or equivalent",2006,29089,1383,42,272,230,1361,6,1355,-20
"45300",NA,NA,"Tampa-St. Petersburg-Clearwater, FL","Metropolitan Statistical Area",2006,2687091,50055,4137,32782,28645,47355,8024,39331,-1437
"45300",NA,12053,"Hernando County, FL","County or equivalent",2006,163216,6882,-714,1531,2245,7697,95,7602,-101
"45300",NA,12057,"Hillsborough County, FL","County or equivalent",2006,1158277,27207,7804,16977,9173,20045,4747,15298,-642
"45300",NA,12101,"Pasco County, FL","County or equivalent",2006,445065,19569,-406,5020,5426,20255,583,19672,-280
"45300",NA,12103,"Pinellas County, FL","County or equivalent",2006,920533,-3603,-2547,9254,11801,-642,2599,-3241,-414
"45460",NA,NA,"Terre Haute, IN","Metropolitan Statistical Area",2006,169932,820,313,2148,1835,588,112,476,-81
"45460",NA,18021,"Clay County, IN","County or equivalent",2006,26747,-86,59,360,301,-133,13,-146,-12
"45460",NA,18153,"Sullivan County, IN","County or equivalent",2006,21359,-164,-16,230,246,-140,1,-141,-8
"45460",NA,18165,"Vermillion County, IN","County or equivalent",2006,16436,-11,-22,196,218,19,4,15,-8
"45460",NA,18167,"Vigo County, IN","County or equivalent",2006,105390,1081,292,1362,1070,842,94,748,-53
"45500",NA,NA,"Texarkana, TX-Texarkana, AR","Metropolitan Statistical Area",2006,133842,1592,519,1831,1312,1140,66,1074,-67
"45500",NA,5091,"Miller County, AR","County or equivalent",2006,42713,416,211,598,387,225,21,204,-20
"45500",NA,48037,"Bowie County, TX","County or equivalent",2006,91129,1176,308,1233,925,915,45,870,-47
"45780",NA,NA,"Toledo, OH","Metropolitan Statistical Area",2006,651747,-2613,2645,8724,6079,-4992,559,-5551,-266
"45780",NA,39051,"Fulton County, OH","County or equivalent",2006,42512,-121,206,569,363,-307,11,-318,-20
"45780",NA,39095,"Lucas County, OH","County or equivalent",2006,443908,-2550,2122,6376,4254,-4485,436,-4921,-187
"45780",NA,39123,"Ottawa County, OH","County or equivalent",2006,41200,-94,-60,416,476,-34,5,-39,0
"45780",NA,39173,"Wood County, OH","County or equivalent",2006,124127,152,377,1363,986,-166,107,-273,-59
"45820",NA,NA,"Topeka, KS","Metropolitan Statistical Area",2006,227301,276,917,3170,2253,-533,202,-735,-108
"45820",NA,20085,"Jackson County, KS","County or equivalent",2006,13347,-14,18,171,153,-26,2,-28,-6
"45820",NA,20087,"Jefferson County, KS","County or equivalent",2006,18429,-218,19,207,188,-229,4,-233,-8
"45820",NA,20139,"Osage County, KS","County or equivalent",2006,16605,-160,16,199,183,-167,4,-171,-9
"45820",NA,20177,"Shawnee County, KS","County or equivalent",2006,172206,752,852,2510,1658,-18,192,-210,-82
"45820",NA,20197,"Wabaunsee County, KS","County or equivalent",2006,6714,-84,12,83,71,-93,0,-93,-3
"45940",NA,NA,"Trenton-Ewing, NJ","Metropolitan Statistical Area",2006,363263,895,1725,4599,2874,-661,1917,-2578,-169
"45940",NA,34021,"Mercer County, NJ","County or equivalent",2006,363263,895,1725,4599,2874,-661,1917,-2578,-169
"46060",NA,NA,"Tucson, AZ","Metropolitan Statistical Area",2006,974121,26588,5248,13325,8077,17076,2876,14200,4264
"46060",NA,4019,"Pima County, AZ","County or equivalent",2006,974121,26588,5248,13325,8077,17076,2876,14200,4264
"46140",NA,NA,"Tulsa, OK","Metropolitan Statistical Area",2006,891185,10186,4786,13253,8467,5850,1553,4297,-450
"46140",NA,40037,"Creek County, OK","County or equivalent",2006,68206,114,70,876,806,77,8,69,-33
"46140",NA,40111,"Okmulgee County, OK","County or equivalent",2006,39119,-213,54,524,470,-250,11,-261,-17
"46140",NA,40113,"Osage County, OK","County or equivalent",2006,45047,107,53,493,440,77,13,64,-23
"46140",NA,40117,"Pawnee County, OK","County or equivalent",2006,16427,-46,38,221,183,-78,0,-78,-6
"46140",NA,40131,"Rogers County, OK","County or equivalent",2006,81212,1598,276,969,693,1364,29,1335,-42
"46140",NA,40143,"Tulsa County, OK","County or equivalent",2006,576166,6759,3990,9391,5401,3061,1456,1605,-292
"46140",NA,40145,"Wagoner County, OK","County or equivalent",2006,65008,1867,305,779,474,1599,36,1563,-37
"46220",NA,NA,"Tuscaloosa, AL","Metropolitan Statistical Area",2006,202375,4240,819,2613,1794,3525,202,3323,-104
"46220",NA,1063,"Greene County, AL","County or equivalent",2006,9153,-319,24,130,106,-341,0,-341,-2
"46220",NA,1065,"Hale County, AL","County or equivalent",2006,17883,-21,10,186,176,-23,0,-23,-8
"46220",NA,1125,"Tuscaloosa County, AL","County or equivalent",2006,175339,4580,785,2297,1512,3889,202,3687,-94
"46340",NA,NA,"Tyler, TX","Metropolitan Statistical Area",2006,194302,4373,1451,2938,1487,3027,478,2549,-105
"46340",NA,48423,"Smith County, TX","County or equivalent",2006,194302,4373,1451,2938,1487,3027,478,2549,-105
"46540",NA,NA,"Utica-Rome, NY","Metropolitan Statistical Area",2006,294045,-863,135,3240,3105,-870,670,-1540,-128
"46540",NA,36043,"Herkimer County, NY","County or equivalent",2006,62450,-456,-36,671,707,-392,16,-408,-28
"46540",NA,36065,"Oneida County, NY","County or equivalent",2006,231595,-407,171,2569,2398,-478,654,-1132,-100
"46660",NA,NA,"Valdosta, GA","Metropolitan Statistical Area",2006,128281,2162,1142,2123,981,1089,214,875,-69
"46660",NA,13027,"Brooks County, GA","County or equivalent",2006,16273,167,60,226,166,115,12,103,-8
"46660",NA,13101,"Echols County, GA","County or equivalent",2006,4026,-49,40,60,20,-87,42,-129,-2
"46660",NA,13173,"Lanier County, GA","County or equivalent",2006,7642,237,50,118,68,192,10,182,-5
"46660",NA,13185,"Lowndes County, GA","County or equivalent",2006,100340,1807,992,1719,727,869,150,719,-54
"46700",NA,NA,"Vallejo-Fairfield, CA","Metropolitan Statistical Area",2006,407085,-184,3069,5810,2741,-3079,1533,-4612,-174
"46700",NA,6095,"Solano County, CA","County or equivalent",2006,407085,-184,3069,5810,2741,-3079,1533,-4612,-174
"47020",NA,NA,"Victoria, TX","Metropolitan Statistical Area",2006,112490,284,712,1743,1031,-376,178,-554,-52
"47020",NA,48057,"Calhoun County, TX","County or equivalent",2006,20276,37,95,282,187,-49,78,-127,-9
"47020",NA,48175,"Goliad County, TX","County or equivalent",2006,7060,84,-4,71,75,92,2,90,-4
"47020",NA,48469,"Victoria County, TX","County or equivalent",2006,85154,163,621,1390,769,-419,98,-517,-39
"47220",NA,NA,"Vineland-Millville-Bridgeton, NJ","Metropolitan Statistical Area",2006,153926,1486,860,2352,1492,701,492,209,-75
"47220",NA,34011,"Cumberland County, NJ","County or equivalent",2006,153926,1486,860,2352,1492,701,492,209,-75
"47260",NA,NA,"Virginia Beach-Norfolk-Newport News, VA-NC","Metropolitan Statistical Area",2006,1661643,12239,12260,24195,11935,456,4183,-3727,-477
"47260",NA,37053,"Currituck County, NC","County or equivalent",2006,23446,572,91,256,165,492,11,481,-11
"47260",NA,51073,"Gloucester County, VA","County or equivalent",2006,37646,399,58,372,314,361,18,343,-20
"47260",NA,51093,"Isle of Wight County, VA","County or equivalent",2006,34013,1120,75,347,272,1064,11,1053,-19
"47260",NA,51095,"James City County, VA","County or equivalent",2006,59484,2297,92,555,463,2240,55,2185,-35
"47260",NA,51115,"Mathews County, VA","County or equivalent",2006,9005,18,-78,61,139,100,4,96,-4
"47260",NA,51181,"Surry County, VA","County or equivalent",2006,7000,118,20,78,58,101,0,101,-3
"47260",NA,51199,"York County, VA","County or equivalent",2006,60867,141,175,549,374,-6,165,-171,-28
"47260",NA,51550,"Chesapeake city, VA","County or equivalent",2006,218370,1891,1439,2833,1394,558,276,282,-106
"47260",NA,51650,"Hampton city, VA","County or equivalent",2006,146503,-356,1057,2080,1023,-1350,308,-1658,-63
"47260",NA,51700,"Newport News city, VA","County or equivalent",2006,181812,-401,1873,3233,1360,-2198,541,-2739,-76
"47260",NA,51710,"Norfolk city, VA","County or equivalent",2006,238832,1642,2165,4124,1959,-709,1071,-1780,186
"47260",NA,51735,"Poquoson city, VA","County or equivalent",2006,11760,66,1,77,76,71,10,61,-6
"47260",NA,51740,"Portsmouth city, VA","County or equivalent",2006,102677,1869,639,1675,1036,1282,144,1138,-52
"47260",NA,51800,"Suffolk city, VA","County or equivalent",2006,80144,2261,512,1199,687,1794,67,1727,-45
"47260",NA,51810,"Virginia Beach city, VA","County or equivalent",2006,437908,317,4020,6527,2507,-3514,1480,-4994,-189
"47260",NA,51830,"Williamsburg city, VA","County or equivalent",2006,12176,285,121,229,108,170,22,148,-6
"47300",NA,NA,"Visalia-Porterville, CA","Metropolitan Statistical Area",2006,412048,6906,5319,8099,2780,1801,1986,-185,-214
"47300",NA,6107,"Tulare County, CA","County or equivalent",2006,412048,6906,5319,8099,2780,1801,1986,-185,-214
"47380",NA,NA,"Waco, TX","Metropolitan Statistical Area",2006,225715,1704,1456,3471,2015,357,514,-157,-109
"47380",NA,48309,"McLennan County, TX","County or equivalent",2006,225715,1704,1456,3471,2015,357,514,-157,-109
"47580",NA,NA,"Warner Robins, GA","Metropolitan Statistical Area",2006,127986,2184,1107,1972,865,1142,273,869,-65
"47580",NA,13153,"Houston County, GA","County or equivalent",2006,127986,2184,1107,1972,865,1142,273,869,-65
"47900",NA,NA,"Washington-Arlington-Alexandria, DC-VA-MD-WV","Metropolitan Statistical Area",2006,5259797,37903,50088,80061,29973,-13269,31879,-45148,1084
"47900",13644,NA,"Bethesda-Frederick-Gaithersburg, MD","Metropolitan Division",2006,1157562,8098,10029,16738,6709,-3839,8147,-11986,1908
"47900",13644,24021,"Frederick County, MD","County or equivalent",2006,221492,2314,1688,3056,1368,735,278,457,-109
"47900",13644,24031,"Montgomery County, MD","County or equivalent",2006,936070,5784,8341,13682,5341,-4574,7869,-12443,2017
"47900",47894,NA,"Washington-Arlington-Alexandria, DC-VA-MD-WV","Metropolitan Division",2006,4102235,29805,40059,63323,23264,-9430,23732,-33162,-824
"47900",47894,11001,"District of Columbia, DC","County or equivalent",2006,585419,3370,2833,8198,5365,539,3177,-2638,-2
"47900",47894,24009,"Calvert County, MD","County or equivalent",2006,87536,798,408,1020,612,436,58,378,-46
"47900",47894,24017,"Charles County, MD","County or equivalent",2006,139164,2020,1067,1921,854,1023,125,898,-70
"47900",47894,24033,"Prince George's County, MD","County or equivalent",2006,831602,-3986,7394,12555,5161,-11029,3979,-15008,-351
"47900",47894,51013,"Arlington County, VA","County or equivalent",2006,200789,1028,1725,2729,1004,-703,2707,-3410,6
"47900",47894,51043,"Clarke County, VA","County or equivalent",2006,14238,239,8,134,126,237,10,227,-6
"47900",47894,51059,"Fairfax County, VA","County or equivalent",2006,998488,-2008,10565,14836,4271,-12157,9033,-21190,-416
"47900",47894,51061,"Fauquier County, VA","County or equivalent",2006,65512,1287,369,821,452,951,61,890,-33
"47900",47894,51107,"Loudoun County, VA","County or equivalent",2006,264958,11905,4279,5160,881,7795,740,7055,-169
"47900",47894,51153,"Prince William County, VA","County or equivalent",2006,351835,7263,5609,6871,1262,1846,1295,551,-192
"47900",47894,51177,"Spotsylvania County, VA","County or equivalent",2006,117661,2801,1034,1687,653,1831,79,1752,-64
"47900",47894,51179,"Stafford County, VA","County or equivalent",2006,118299,1763,1139,1662,523,684,150,534,-60
"47900",47894,51187,"Warren County, VA","County or equivalent",2006,35766,779,201,524,323,597,7,590,-19
"47900",47894,51510,"Alexandria city, VA","County or equivalent",2006,138237,635,1908,2638,730,-1948,1674,-3622,675
"47900",47894,51600,"Fairfax city, VA","County or equivalent",2006,22772,862,178,339,161,698,251,447,-14
"47900",47894,51610,"Falls Church city, VA","County or equivalent",2006,10811,21,54,127,73,-27,68,-95,-6
"47900",47894,51630,"Fredericksburg city, VA","County or equivalent",2006,22004,740,174,390,216,582,43,539,-16
"47900",47894,51683,"Manassas city, VA","County or equivalent",2006,36034,-753,574,785,211,-1315,191,-1506,-12
"47900",47894,51685,"Manassas Park city, VA","County or equivalent",2006,11444,-118,273,310,37,-388,64,-452,-3
"47900",47894,54037,"Jefferson County, WV","County or equivalent",2006,49666,1159,267,616,349,918,20,898,-26
"47940",NA,NA,"Waterloo-Cedar Falls, IA","Metropolitan Statistical Area",2006,162825,618,676,2098,1422,22,342,-320,-80
"47940",NA,19013,"Black Hawk County, IA","County or equivalent",2006,127005,456,622,1705,1083,-104,335,-439,-62
"47940",NA,19017,"Bremer County, IA","County or equivalent",2006,23583,163,76,279,203,98,7,91,-11
"47940",NA,19075,"Grundy County, IA","County or equivalent",2006,12237,-1,-22,114,136,28,0,28,-7
"48140",NA,NA,"Wausau, WI","Metropolitan Statistical Area",2006,128803,1235,649,1582,933,648,89,559,-62
"48140",NA,55073,"Marathon County, WI","County or equivalent",2006,128803,1235,649,1582,933,648,89,559,-62
"48260",NA,NA,"Weirton-Steubenville, WV-OH","Metropolitan Statistical Area",2006,123852,-1447,-410,1284,1694,-985,22,-1007,-52
"48260",NA,39081,"Jefferson County, OH","County or equivalent",2006,69348,-743,-237,741,978,-478,18,-496,-28
"48260",NA,54009,"Brooke County, WV","County or equivalent",2006,23877,-367,-102,219,321,-255,2,-257,-10
"48260",NA,54029,"Hancock County, WV","County or equivalent",2006,30627,-337,-71,324,395,-252,2,-254,-14
"48300",NA,NA,"Wenatchee, WA","Metropolitan Statistical Area",2006,104967,1732,614,1447,833,1179,371,808,-61
"48300",NA,53007,"Chelan County, WA","County or equivalent",2006,69825,933,383,961,578,591,247,344,-41
"48300",NA,53017,"Douglas County, WA","County or equivalent",2006,35142,799,231,486,255,588,124,464,-20
"48540",NA,NA,"Wheeling, WV-OH","Metropolitan Statistical Area",2006,146672,-777,-235,1535,1770,-475,31,-506,-67
"48540",NA,39013,"Belmont County, OH","County or equivalent",2006,68567,-108,-150,696,846,76,10,66,-34
"48540",NA,54051,"Marshall County, WV","County or equivalent",2006,33481,-402,-65,328,393,-323,1,-324,-14
"48540",NA,54069,"Ohio County, WV","County or equivalent",2006,44624,-267,-20,511,531,-228,20,-248,-19
"48620",NA,NA,"Wichita, KS","Metropolitan Statistical Area",2006,588020,4229,4316,9314,4998,199,1293,-1094,-286
"48620",NA,20015,"Butler County, KS","County or equivalent",2006,62376,770,275,794,519,525,36,489,-30
"48620",NA,20079,"Harvey County, KS","County or equivalent",2006,33307,-32,104,436,332,-122,45,-167,-14
"48620",NA,20173,"Sedgwick County, KS","County or equivalent",2006,468235,3811,3901,7765,3864,140,1210,-1070,-230
"48620",NA,20191,"Sumner County, KS","County or equivalent",2006,24102,-320,36,319,283,-344,2,-346,-12
"48660",NA,NA,"Wichita Falls, TX","Metropolitan Statistical Area",2006,149294,-437,675,2145,1470,-1043,430,-1473,-69
"48660",NA,48009,"Archer County, TX","County or equivalent",2006,8958,1,1,82,81,4,1,3,-4
"48660",NA,48077,"Clay County, TX","County or equivalent",2006,11219,-150,-16,96,112,-129,2,-131,-5
"48660",NA,48485,"Wichita County, TX","County or equivalent",2006,129117,-288,690,1967,1277,-918,427,-1345,-60
"48700",NA,NA,"Williamsport, PA","Metropolitan Statistical Area",2006,117242,-441,132,1397,1265,-524,17,-541,-49
"48700",NA,42081,"Lycoming County, PA","County or equivalent",2006,117242,-441,132,1397,1265,-524,17,-541,-49
"48900",NA,NA,"Wilmington, NC","Metropolitan Statistical Area",2006,328589,12318,1220,3982,2762,11289,416,10873,-191
"48900",NA,37019,"Brunswick County, NC","County or equivalent",2006,93874,5587,122,1010,888,5524,105,5419,-59
"48900",NA,37129,"New Hanover County, NC","County or equivalent",2006,186938,4692,982,2435,1453,3813,240,3573,-103
"48900",NA,37141,"Pender County, NC","County or equivalent",2006,47777,2039,116,537,421,1952,71,1881,-29
"49020",NA,NA,"Winchester, VA-WV","Metropolitan Statistical Area",2006,118654,2881,628,1596,968,2314,155,2159,-61
"49020",NA,51069,"Frederick County, VA","County or equivalent",2006,70693,2201,450,946,496,1788,45,1743,-37
"49020",NA,51840,"Winchester city, VA","County or equivalent",2006,25743,182,130,399,269,65,107,-42,-13
"49020",NA,54027,"Hampshire County, WV","County or equivalent",2006,22218,498,48,251,203,461,3,458,-11
"49180",NA,NA,"Winston-Salem, NC","Metropolitan Statistical Area",2006,453722,7961,2255,6228,3973,5935,1366,4569,-229
"49180",NA,37059,"Davie County, NC","County or equivalent",2006,39583,889,152,478,326,757,62,695,-20
"49180",NA,37067,"Forsyth County, NC","County or equivalent",2006,330926,6496,2013,4839,2826,4652,1193,3459,-169
"49180",NA,37169,"Stokes County, NC","County or equivalent",2006,45699,338,16,458,442,344,36,308,-22
"49180",NA,37197,"Yadkin County, NC","County or equivalent",2006,37514,238,74,453,379,182,75,107,-18
"49340",NA,NA,"Worcester, MA","Metropolitan Statistical Area",2006,780636,3007,3204,9858,6654,164,2504,-2340,-361
"49340",NA,25027,"Worcester County, MA","County or equivalent",2006,780636,3007,3204,9858,6654,164,2504,-2340,-361
"49420",NA,NA,"Yakima, WA","Metropolitan Statistical Area",2006,230139,1917,2490,4303,1813,-464,930,-1394,-109
"49420",NA,53077,"Yakima County, WA","County or equivalent",2006,230139,1917,2490,4303,1813,-464,930,-1394,-109
"49620",NA,NA,"York-Hanover, PA","Metropolitan Statistical Area",2006,413973,7852,1661,5056,3395,6399,337,6062,-208
"49620",NA,42133,"York County, PA","County or equivalent",2006,413973,7852,1661,5056,3395,6399,337,6062,-208
"49660",NA,NA,"Youngstown-Warren-Boardman, OH-PA","Metropolitan Statistical Area",2006,576221,-4653,-433,6332,6765,-3968,221,-4189,-252
"49660",NA,39099,"Mahoning County, OH","County or equivalent",2006,243487,-2182,-159,2733,2892,-1914,140,-2054,-109
"49660",NA,39155,"Trumbull County, OH","County or equivalent",2006,215273,-1838,-113,2377,2490,-1635,49,-1684,-90
"49660",NA,42085,"Mercer County, PA","County or equivalent",2006,117461,-633,-161,1222,1383,-419,32,-451,-53
"49700",NA,NA,"Yuba City, CA","Metropolitan Statistical Area",2006,159801,5123,1557,2741,1184,3654,721,2933,-88
"49700",NA,6101,"Sutter County, CA","County or equivalent",2006,89800,2141,767,1430,663,1422,454,968,-48
"49700",NA,6115,"Yuba County, CA","County or equivalent",2006,70001,2982,790,1311,521,2232,267,1965,-40
"49740",NA,NA,"Yuma, AZ","Metropolitan Statistical Area",2006,185113,5104,2009,3303,1294,3204,1015,2189,-109
"49740",NA,4027,"Yuma County, AZ","County or equivalent",2006,185113,5104,2009,3303,1294,3204,1015,2189,-109
" ",NA,NA,"","",2006,NA,NA,NA,NA,NA,NA,NA,NA,NA
" ",NA,NA,"Micropolitan Statistical Area","",2006,NA,NA,NA,NA,NA,NA,NA,NA,NA
" ",NA,NA,"","",2006,NA,NA,NA,NA,NA,NA,NA,NA,NA
"10020",NA,NA,"Abbeville, LA","Micropolitan Statistical Area",2006,55371,495,147,749,602,377,47,330,-29
"10020",NA,22113,"Vermilion Parish, LA","County or equivalent",2006,55371,495,147,749,602,377,47,330,-29
"10100",NA,NA,"Aberdeen, SD","Micropolitan Statistical Area",2006,38865,-89,125,502,377,-197,8,-205,-17
"10100",NA,46013,"Brown County, SD","County or equivalent",2006,34861,-14,127,458,331,-126,8,-134,-15
"10100",NA,46045,"Edmunds County, SD","County or equivalent",2006,4004,-75,-2,44,46,-71,0,-71,-2
"10140",NA,NA,"Aberdeen, WA","Micropolitan Statistical Area",2006,70727,618,147,860,713,505,82,423,-34
"10140",NA,53027,"Grays Harbor County, WA","County or equivalent",2006,70727,618,147,860,713,505,82,423,-34
"10220",NA,NA,"Ada, OK","Micropolitan Statistical Area",2006,35762,301,97,523,426,221,14,207,-17
"10220",NA,40123,"Pontotoc County, OK","County or equivalent",2006,35762,301,97,523,426,221,14,207,-17
"10300",NA,NA,"Adrian, MI","Micropolitan Statistical Area",2006,101313,330,345,1260,915,34,42,-8,-49
"10300",NA,26091,"Lenawee County, MI","County or equivalent",2006,101313,330,345,1260,915,34,42,-8,-49
"10460",NA,NA,"Alamogordo, NM","Micropolitan Statistical Area",2006,62539,-580,330,848,518,-885,419,-1304,-25
"10460",NA,35035,"Otero County, NM","County or equivalent",2006,62539,-580,330,848,518,-885,419,-1304,-25
"10540",NA,NA,"Albany-Lebanon, OR","Micropolitan Statistical Area",2006,110844,2508,387,1477,1090,2185,88,2097,-64
"10540",NA,41043,"Linn County, OR","County or equivalent",2006,110844,2508,387,1477,1090,2185,88,2097,-64
"10620",NA,NA,"Albemarle, NC","Micropolitan Statistical Area",2006,58563,130,65,717,652,92,74,18,-27
"10620",NA,37167,"Stanly County, NC","County or equivalent",2006,58563,130,65,717,652,92,74,18,-27
"10660",NA,NA,"Albert Lea, MN","Micropolitan Statistical Area",2006,31318,-172,3,360,357,-161,31,-192,-14
"10660",NA,27047,"Freeborn County, MN","County or equivalent",2006,31318,-172,3,360,357,-161,31,-192,-14
"10700",NA,NA,"Albertville, AL","Micropolitan Statistical Area",2006,86247,1355,469,1449,980,930,216,714,-44
"10700",NA,1095,"Marshall County, AL","County or equivalent",2006,86247,1355,469,1449,980,930,216,714,-44
"10760",NA,NA,"Alexander City, AL","Micropolitan Statistical Area",2006,51581,179,-72,603,675,277,8,269,-26
"10760",NA,1037,"Coosa County, AL","County or equivalent",2006,10880,-109,-42,89,131,-63,1,-64,-4
"10760",NA,1123,"Tallapoosa County, AL","County or equivalent",2006,40701,288,-30,514,544,340,7,333,-22
"10820",NA,NA,"Alexandria, MN","Micropolitan Statistical Area",2006,35502,346,96,429,333,269,3,266,-19
"10820",NA,27041,"Douglas County, MN","County or equivalent",2006,35502,346,96,429,333,269,3,266,-19
"10860",NA,NA,"Alice, TX","Micropolitan Statistical Area",2006,40701,74,360,693,333,-268,13,-281,-18
"10860",NA,48249,"Jim Wells County, TX","County or equivalent",2006,40701,74,360,693,333,-268,13,-281,-18
"10880",NA,NA,"Allegan, MI","Micropolitan Statistical Area",2006,112265,335,743,1550,807,-359,96,-455,-49
"10880",NA,26005,"Allegan County, MI","County or equivalent",2006,112265,335,743,1550,807,-359,96,-455,-49
"10940",NA,NA,"Alma, MI","Micropolitan Statistical Area",2006,42254,96,90,490,400,26,15,11,-20
"10940",NA,26057,"Gratiot County, MI","County or equivalent",2006,42254,96,90,490,400,26,15,11,-20
"10980",NA,NA,"Alpena, MI","Micropolitan Statistical Area",2006,29814,-354,-40,316,356,-301,15,-316,-13
"10980",NA,26007,"Alpena County, MI","County or equivalent",2006,29814,-354,-40,316,356,-301,15,-316,-13
"11060",NA,NA,"Altus, OK","Micropolitan Statistical Area",2006,26194,-249,151,445,294,-389,84,-473,-11
"11060",NA,40065,"Jackson County, OK","County or equivalent",2006,26194,-249,151,445,294,-389,84,-473,-11
"11140",NA,NA,"Americus, GA","Micropolitan Statistical Area",2006,36503,186,219,594,375,-14,32,-46,-19
"11140",NA,13249,"Schley County, GA","County or equivalent",2006,3980,39,15,65,50,27,4,23,-3
"11140",NA,13261,"Sumter County, GA","County or equivalent",2006,32523,147,204,529,325,-41,28,-69,-16
"11220",NA,NA,"Amsterdam, NY","Micropolitan Statistical Area",2006,48797,129,-17,614,631,169,43,126,-23
"11220",NA,36057,"Montgomery County, NY","County or equivalent",2006,48797,129,-17,614,631,169,43,126,-23
"11380",NA,NA,"Andrews, TX","Micropolitan Statistical Area",2006,12841,145,70,203,133,82,11,71,-7
"11380",NA,48003,"Andrews County, TX","County or equivalent",2006,12841,145,70,203,133,82,11,71,-7
"11420",NA,NA,"Angola, IN","Micropolitan Statistical Area",2006,33502,-27,145,402,257,-157,20,-177,-15
"11420",NA,18151,"Steuben County, IN","County or equivalent",2006,33502,-27,145,402,257,-157,20,-177,-15
"11580",NA,NA,"Arcadia, FL","Micropolitan Statistical Area",2006,34232,150,186,483,297,-14,332,-346,-22
"11580",NA,12027,"DeSoto County, FL","County or equivalent",2006,34232,150,186,483,297,-14,332,-346,-22
"11620",NA,NA,"Ardmore, OK","Micropolitan Statistical Area",2006,56114,438,31,763,732,435,34,401,-28
"11620",NA,40019,"Carter County, OK","County or equivalent",2006,47046,404,31,644,613,396,25,371,-23
"11620",NA,40085,"Love County, OK","County or equivalent",2006,9068,34,0,119,119,39,9,30,-5
"11660",NA,NA,"Arkadelphia, AR","Micropolitan Statistical Area",2006,23416,244,33,286,253,224,27,197,-13
"11660",NA,5019,"Clark County, AR","County or equivalent",2006,23416,244,33,286,253,224,27,197,-13
"11740",NA,NA,"Ashland, OH","Micropolitan Statistical Area",2006,54327,349,183,688,505,192,15,177,-26
"11740",NA,39005,"Ashland County, OH","County or equivalent",2006,54327,349,183,688,505,192,15,177,-26
"11780",NA,NA,"Ashtabula, OH","Micropolitan Statistical Area",2006,101471,-534,217,1256,1039,-707,61,-768,-44
"11780",NA,39007,"Ashtabula County, OH","County or equivalent",2006,101471,-534,217,1256,1039,-707,61,-768,-44
"11820",NA,NA,"Astoria, OR","Micropolitan Statistical Area",2006,36930,441,59,420,361,401,83,318,-19
"11820",NA,41007,"Clatsop County, OR","County or equivalent",2006,36930,441,59,420,361,401,83,318,-19
"11860",NA,NA,"Atchison, KS","Micropolitan Statistical Area",2006,16614,26,29,212,183,5,6,-1,-8
"11860",NA,20005,"Atchison County, KS","County or equivalent",2006,16614,26,29,212,183,5,6,-1,-8
"11900",NA,NA,"Athens, OH","Micropolitan Statistical Area",2006,63193,18,136,577,441,-90,147,-237,-28
"11900",NA,39009,"Athens County, OH","County or equivalent",2006,63193,18,136,577,441,-90,147,-237,-28
"11940",NA,NA,"Athens, TN","Micropolitan Statistical Area",2006,51574,550,56,610,554,520,32,488,-26
"11940",NA,47107,"McMinn County, TN","County or equivalent",2006,51574,550,56,610,554,520,32,488,-26
"11980",NA,NA,"Athens, TX","Micropolitan Statistical Area",2006,78812,311,149,977,828,201,85,116,-39
"11980",NA,48213,"Henderson County, TX","County or equivalent",2006,78812,311,149,977,828,201,85,116,-39
"12140",NA,NA,"Auburn, IN","Micropolitan Statistical Area",2006,41467,74,177,508,331,-83,16,-99,-20
"12140",NA,18033,"DeKalb County, IN","County or equivalent",2006,41467,74,177,508,331,-83,16,-99,-20
"12180",NA,NA,"Auburn, NY","Micropolitan Statistical Area",2006,80339,-242,83,837,754,-290,24,-314,-35
"12180",NA,36011,"Cayuga County, NY","County or equivalent",2006,80339,-242,83,837,754,-290,24,-314,-35
"12300",NA,NA,"Augusta-Waterville, ME","Micropolitan Statistical Area",2006,120488,331,153,1257,1104,235,43,192,-57
"12300",NA,23011,"Kennebec County, ME","County or equivalent",2006,120488,331,153,1257,1104,235,43,192,-57
"12380",NA,NA,"Austin, MN","Micropolitan Statistical Area",2006,38059,-93,128,528,400,-203,81,-284,-18
"12380",NA,27099,"Mower County, MN","County or equivalent",2006,38059,-93,128,528,400,-203,81,-284,-18
"12460",NA,NA,"Bainbridge, GA","Micropolitan Statistical Area",2006,28338,392,119,416,297,288,42,246,-15
"12460",NA,13087,"Decatur County, GA","County or equivalent",2006,28338,392,119,416,297,288,42,246,-15
"12660",NA,NA,"Baraboo, WI","Micropolitan Statistical Area",2006,57844,442,232,757,525,238,22,216,-28
"12660",NA,55111,"Sauk County, WI","County or equivalent",2006,57844,442,232,757,525,238,22,216,-28
"12740",NA,NA,"Barre, VT","Micropolitan Statistical Area",2006,58930,-16,74,555,481,-64,64,-128,-26
"12740",NA,50023,"Washington County, VT","County or equivalent",2006,58930,-16,74,555,481,-64,64,-128,-26
"12780",NA,NA,"Bartlesville, OK","Micropolitan Statistical Area",2006,48899,301,7,613,606,317,62,255,-23
"12780",NA,40147,"Washington County, OK","County or equivalent",2006,48899,301,7,613,606,317,62,255,-23
"12820",NA,NA,"Bastrop, LA","Micropolitan Statistical Area",2006,29225,-196,-5,387,392,-179,1,-180,-12
"12820",NA,22067,"Morehouse Parish, LA","County or equivalent",2006,29225,-196,-5,387,392,-179,1,-180,-12
"12860",NA,NA,"Batavia, NY","Micropolitan Statistical Area",2006,58374,-374,98,646,548,-448,29,-477,-24
"12860",NA,36037,"Genesee County, NY","County or equivalent",2006,58374,-374,98,646,548,-448,29,-477,-24
"12900",NA,NA,"Batesville, AR","Micropolitan Statistical Area",2006,34393,123,73,463,390,67,20,47,-17
"12900",NA,5063,"Independence County, AR","County or equivalent",2006,34393,123,73,463,390,67,20,47,-17
"13060",NA,NA,"Bay City, TX","Micropolitan Statistical Area",2006,36993,-303,224,538,314,-511,131,-642,-16
"13060",NA,48321,"Matagorda County, TX","County or equivalent",2006,36993,-303,224,538,314,-511,131,-642,-16
"13100",NA,NA,"Beatrice, NE","Micropolitan Statistical Area",2006,23129,86,0,278,278,98,4,94,-12
"13100",NA,31067,"Gage County, NE","County or equivalent",2006,23129,86,0,278,278,98,4,94,-12
"13180",NA,NA,"Beaver Dam, WI","Micropolitan Statistical Area",2006,87851,670,104,930,826,608,31,577,-42
"13180",NA,55027,"Dodge County, WI","County or equivalent",2006,87851,670,104,930,826,608,31,577,-42
"13220",NA,NA,"Beckley, WV","Micropolitan Statistical Area",2006,78649,74,16,906,890,95,37,58,-37
"13220",NA,54081,"Raleigh County, WV","County or equivalent",2006,78649,74,16,906,890,95,37,58,-37
"13260",NA,NA,"Bedford, IN","Micropolitan Statistical Area",2006,45866,-96,79,543,464,-155,13,-168,-20
"13260",NA,18093,"Lawrence County, IN","County or equivalent",2006,45866,-96,79,543,464,-155,13,-168,-20
"13300",NA,NA,"Beeville, TX","Micropolitan Statistical Area",2006,32469,18,172,401,229,-140,5,-145,-14
"13300",NA,48025,"Bee County, TX","County or equivalent",2006,32469,18,172,401,229,-140,5,-145,-14
"13340",NA,NA,"Bellefontaine, OH","Micropolitan Statistical Area",2006,46069,-217,157,613,456,-354,21,-375,-20
"13340",NA,39091,"Logan County, OH","County or equivalent",2006,46069,-217,157,613,456,-354,21,-375,-20
"13420",NA,NA,"Bemidji, MN","Micropolitan Statistical Area",2006,43101,425,320,658,338,127,17,110,-22
"13420",NA,27007,"Beltrami County, MN","County or equivalent",2006,43101,425,320,658,338,127,17,110,-22
"13500",NA,NA,"Bennettsville, SC","Micropolitan Statistical Area",2006,28943,1356,37,374,337,1335,3,1332,-16
"13500",NA,45069,"Marlboro County, SC","County or equivalent",2006,28943,1356,37,374,337,1335,3,1332,-16
"13540",NA,NA,"Bennington, VT","Micropolitan Statistical Area",2006,36517,-5,-30,350,380,43,24,19,-18
"13540",NA,50003,"Bennington County, VT","County or equivalent",2006,36517,-5,-30,350,380,43,24,19,-18
"13620",NA,NA,"Berlin, NH-VT","Micropolitan Statistical Area",2006,38985,-312,-103,350,453,-193,13,-206,-16
"13620",NA,33007,"Coos County, NH","County or equivalent",2006,32589,-215,-87,308,395,-115,11,-126,-13
"13620",NA,50009,"Essex County, VT","County or equivalent",2006,6396,-97,-16,42,58,-78,2,-80,-3
"13660",NA,NA,"Big Rapids, MI","Micropolitan Statistical Area",2006,42111,-192,159,481,322,-331,41,-372,-20
"13660",NA,26107,"Mecosta County, MI","County or equivalent",2006,42111,-192,159,481,322,-331,41,-372,-20
"13700",NA,NA,"Big Spring, TX","Micropolitan Statistical Area",2006,31911,-133,92,475,383,-210,19,-229,-15
"13700",NA,48227,"Howard County, TX","County or equivalent",2006,31911,-133,92,475,383,-210,19,-229,-15
"13860",NA,NA,"Bishop, CA","Micropolitan Statistical Area",2006,17534,-183,3,218,215,-176,24,-200,-10
"13860",NA,6027,"Inyo County, CA","County or equivalent",2006,17534,-183,3,218,215,-176,24,-200,-10
"13940",NA,NA,"Blackfoot, ID","Micropolitan Statistical Area",2006,43029,194,524,819,295,-310,62,-372,-20
"13940",NA,16011,"Bingham County, ID","County or equivalent",2006,43029,194,524,819,295,-310,62,-372,-20
"14100",NA,NA,"Bloomsburg-Berwick, PA","Micropolitan Statistical Area",2006,82436,-7,-53,868,921,83,26,57,-37
"14100",NA,42037,"Columbia County, PA","County or equivalent",2006,64609,73,-8,654,662,111,22,89,-30
"14100",NA,42093,"Montour County, PA","County or equivalent",2006,17827,-80,-45,214,259,-28,4,-32,-7
"14140",NA,NA,"Bluefield, WV-VA","Micropolitan Statistical Area",2006,104892,-151,-196,1171,1367,95,23,72,-50
"14140",NA,51185,"Tazewell County, VA","County or equivalent",2006,43883,31,-63,508,571,115,10,105,-21
"14140",NA,54055,"Mercer County, WV","County or equivalent",2006,61009,-182,-133,663,796,-20,13,-33,-29
"14180",NA,NA,"Blytheville, AR","Micropolitan Statistical Area",2006,46768,-358,236,771,535,-574,19,-593,-20
"14180",NA,5093,"Mississippi County, AR","County or equivalent",2006,46768,-358,236,771,535,-574,19,-593,-20
"14220",NA,NA,"Bogalusa, LA","Micropolitan Statistical Area",2006,44028,109,12,612,600,119,3,116,-22
"14220",NA,22117,"Washington Parish, LA","County or equivalent",2006,44028,109,12,612,600,119,3,116,-22
"14300",NA,NA,"Bonham, TX","Micropolitan Statistical Area",2006,32814,167,-10,411,421,194,24,170,-17
"14300",NA,48147,"Fannin County, TX","County or equivalent",2006,32814,167,-10,411,421,194,24,170,-17
"14340",NA,NA,"Boone, IA","Micropolitan Statistical Area",2006,26314,-20,44,345,301,-51,8,-59,-13
"14340",NA,19015,"Boone County, IA","County or equivalent",2006,26314,-20,44,345,301,-51,8,-59,-13
"14380",NA,NA,"Boone, NC","Micropolitan Statistical Area",2006,44138,678,107,400,293,594,43,551,-23
"14380",NA,37189,"Watauga County, NC","County or equivalent",2006,44138,678,107,400,293,594,43,551,-23
"14420",NA,NA,"Borger, TX","Micropolitan Statistical Area",2006,21896,-4,41,283,242,-32,39,-71,-13
"14420",NA,48233,"Hutchinson County, TX","County or equivalent",2006,21896,-4,41,283,242,-32,39,-71,-13
"14580",NA,NA,"Bozeman, MT","Micropolitan Statistical Area",2006,84370,3699,773,1166,393,2977,71,2906,-51
"14580",NA,30031,"Gallatin County, MT","County or equivalent",2006,84370,3699,773,1166,393,2977,71,2906,-51
"14620",NA,NA,"Bradford, PA","Micropolitan Statistical Area",2006,44008,110,16,538,522,114,7,107,-20
"14620",NA,42083,"McKean County, PA","County or equivalent",2006,44008,110,16,538,522,114,7,107,-20
"14660",NA,NA,"Brainerd, MN","Micropolitan Statistical Area",2006,89460,1073,351,1177,826,770,15,755,-48
"14660",NA,27021,"Cass County, MN","County or equivalent",2006,28780,108,125,397,272,0,2,-2,-17
"14660",NA,27035,"Crow Wing County, MN","County or equivalent",2006,60680,965,226,780,554,770,13,757,-31
"14700",NA,NA,"Branson, MO","Micropolitan Statistical Area",2006,75304,1758,119,858,739,1684,35,1649,-45
"14700",NA,29209,"Stone County, MO","County or equivalent",2006,31150,676,-17,278,295,713,8,705,-20
"14700",NA,29213,"Taney County, MO","County or equivalent",2006,44154,1082,136,580,444,971,27,944,-25
"14780",NA,NA,"Brenham, TX","Micropolitan Statistical Area",2006,31771,344,73,418,345,288,60,228,-17
"14780",NA,48477,"Washington County, TX","County or equivalent",2006,31771,344,73,418,345,288,60,228,-17
"14820",NA,NA,"Brevard, NC","Micropolitan Statistical Area",2006,29658,230,-7,327,334,252,26,226,-15
"14820",NA,37175,"Transylvania County, NC","County or equivalent",2006,29658,230,-7,327,334,252,26,226,-15
"14940",NA,NA,"Brigham City, UT","Micropolitan Statistical Area",2006,46695,770,632,919,287,139,45,94,-1
"14940",NA,49003,"Box Elder County, UT","County or equivalent",2006,46695,770,632,919,287,139,45,94,-1
"15020",NA,NA,"Brookhaven, MS","Micropolitan Statistical Area",2006,34241,570,68,491,423,523,5,518,-21
"15020",NA,28085,"Lincoln County, MS","County or equivalent",2006,34241,570,68,491,423,523,5,518,-21
"15060",NA,NA,"Brookings, OR","Micropolitan Statistical Area",2006,21946,-136,-171,123,294,44,13,31,-9
"15060",NA,41015,"Curry County, OR","County or equivalent",2006,21946,-136,-171,123,294,44,13,31,-9
"15100",NA,NA,"Brookings, SD","Micropolitan Statistical Area",2006,29025,551,178,348,170,388,34,354,-15
"15100",NA,46011,"Brookings County, SD","County or equivalent",2006,29025,551,178,348,170,388,34,354,-15
"15140",NA,NA,"Brownsville, TN","Micropolitan Statistical Area",2006,19256,-125,29,242,213,-146,18,-164,-8
"15140",NA,47075,"Haywood County, TN","County or equivalent",2006,19256,-125,29,242,213,-146,18,-164,-8
"15220",NA,NA,"Brownwood, TX","Micropolitan Statistical Area",2006,38478,285,48,489,441,257,25,232,-20
"15220",NA,48049,"Brown County, TX","County or equivalent",2006,38478,285,48,489,441,257,25,232,-20
"15340",NA,NA,"Bucyrus, OH","Micropolitan Statistical Area",2006,44470,-694,40,542,502,-716,3,-719,-18
"15340",NA,39033,"Crawford County, OH","County or equivalent",2006,44470,-694,40,542,502,-716,3,-719,-18
"15420",NA,NA,"Burley, ID","Micropolitan Statistical Area",2006,39216,-203,323,693,370,-508,107,-615,-18
"15420",NA,16031,"Cassia County, ID","County or equivalent",2006,20725,-158,206,374,168,-354,46,-400,-10
"15420",NA,16067,"Minidoka County, ID","County or equivalent",2006,18491,-45,117,319,202,-154,61,-215,-8
"15460",NA,NA,"Burlington, IA-IL","Micropolitan Statistical Area",2006,48074,-250,57,600,543,-287,25,-312,-20
"15460",NA,17071,"Henderson County, IL","County or equivalent",2006,7615,-169,-36,54,90,-130,0,-130,-3
"15460",NA,19057,"Des Moines County, IA","County or equivalent",2006,40459,-81,93,546,453,-157,25,-182,-17
"15580",NA,NA,"Butte-Silver Bow, MT","Micropolitan Statistical Area",2006,32644,-111,-31,393,424,-64,8,-72,-16
"15580",NA,30093,"Silver Bow County, MT","County or equivalent",2006,32644,-111,-31,393,424,-64,8,-72,-16
"15620",NA,NA,"Cadillac, MI","Micropolitan Statistical Area",2006,46670,30,173,600,427,-119,10,-129,-24
"15620",NA,26113,"Missaukee County, MI","County or equivalent",2006,14996,-68,43,174,131,-103,0,-103,-8
"15620",NA,26165,"Wexford County, MI","County or equivalent",2006,31674,98,130,426,296,-16,10,-26,-16
"15660",NA,NA,"Calhoun, GA","Micropolitan Statistical Area",2006,50743,1229,467,912,445,789,173,616,-27
"15660",NA,13129,"Gordon County, GA","County or equivalent",2006,50743,1229,467,912,445,789,173,616,-27
"15700",NA,NA,"Cambridge, MD","Micropolitan Statistical Area",2006,31358,242,3,379,376,254,12,242,-15
"15700",NA,24019,"Dorchester County, MD","County or equivalent",2006,31358,242,3,379,376,254,12,242,-15
"15740",NA,NA,"Cambridge, OH","Micropolitan Statistical Area",2006,40409,-205,40,484,444,-227,5,-232,-18
"15740",NA,39059,"Guernsey County, OH","County or equivalent",2006,40409,-205,40,484,444,-227,5,-232,-18
"15780",NA,NA,"Camden, AR","Micropolitan Statistical Area",2006,31877,-286,26,453,427,-298,14,-312,-14
"15780",NA,5013,"Calhoun County, AR","County or equivalent",2006,5553,20,9,65,56,14,5,9,-3
"15780",NA,5103,"Ouachita County, AR","County or equivalent",2006,26324,-306,17,388,371,-312,9,-321,-11
"15820",NA,NA,"Campbellsville, KY","Micropolitan Statistical Area",2006,23780,179,63,287,224,129,5,124,-13
"15820",NA,21217,"Taylor County, KY","County or equivalent",2006,23780,179,63,287,224,129,5,124,-13
"15860",NA,NA,"Canon City, CO","Micropolitan Statistical Area",2006,47163,206,-48,439,487,276,20,256,-22
"15860",NA,8043,"Fremont County, CO","County or equivalent",2006,47163,206,-48,439,487,276,20,256,-22
"15900",NA,NA,"Canton, IL","Micropolitan Statistical Area",2006,36947,-187,-58,397,455,-112,2,-114,-17
"15900",NA,17057,"Fulton County, IL","County or equivalent",2006,36947,-187,-58,397,455,-112,2,-114,-17
"16020",NA,NA,"Cape Girardeau-Jackson, MO-IL","Micropolitan Statistical Area",2006,92637,729,243,1213,970,533,42,491,-47
"16020",NA,17003,"Alexander County, IL","County or equivalent",2006,8413,-220,-2,123,125,-216,0,-216,-2
"16020",NA,29017,"Bollinger County, MO","County or equivalent",2006,12112,-39,10,143,133,-43,1,-44,-6
"16020",NA,29031,"Cape Girardeau County, MO","County or equivalent",2006,72112,988,235,947,712,792,41,751,-39
"16060",NA,NA,"Carbondale, IL","Micropolitan Statistical Area",2006,59005,-71,299,704,405,-346,229,-575,-24
"16060",NA,17077,"Jackson County, IL","County or equivalent",2006,59005,-71,299,704,405,-346,229,-575,-24
"16100",NA,NA,"Carlsbad-Artesia, NM","Micropolitan Statistical Area",2006,50638,465,181,720,539,310,38,272,-26
"16100",NA,35015,"Eddy County, NM","County or equivalent",2006,50638,465,181,720,539,310,38,272,-26
"16260",NA,NA,"Cedar City, UT","Micropolitan Statistical Area",2006,41746,2413,713,953,240,1729,61,1668,-29
"16260",NA,49021,"Iron County, UT","County or equivalent",2006,41746,2413,713,953,240,1729,61,1668,-29
"16340",NA,NA,"Cedartown, GA","Micropolitan Statistical Area",2006,40833,628,279,712,433,370,118,252,-21
"16340",NA,13233,"Polk County, GA","County or equivalent",2006,40833,628,279,712,433,370,118,252,-21
"16380",NA,NA,"Celina, OH","Micropolitan Statistical Area",2006,40764,3,149,536,387,-129,10,-139,-17
"16380",NA,39107,"Mercer County, OH","County or equivalent",2006,40764,3,149,536,387,-129,10,-139,-17
"16420",NA,NA,"Central City, KY","Micropolitan Statistical Area",2006,31340,-63,13,382,369,-63,2,-65,-13
"16420",NA,21177,"Muhlenberg County, KY","County or equivalent",2006,31340,-63,13,382,369,-63,2,-65,-13
"16460",NA,NA,"Centralia, IL","Micropolitan Statistical Area",2006,39747,44,31,530,499,31,2,29,-18
"16460",NA,17121,"Marion County, IL","County or equivalent",2006,39747,44,31,530,499,31,2,29,-18
"16500",NA,NA,"Centralia, WA","Micropolitan Statistical Area",2006,72662,1065,171,898,727,932,98,834,-38
"16500",NA,53041,"Lewis County, WA","County or equivalent",2006,72662,1065,171,898,727,932,98,834,-38
"16540",NA,NA,"Chambersburg, PA","Micropolitan Statistical Area",2006,139683,2796,616,1913,1297,2256,122,2134,-76
"16540",NA,42055,"Franklin County, PA","County or equivalent",2006,139683,2796,616,1913,1297,2256,122,2134,-76
"16660",NA,NA,"Charleston-Mattoon, IL","Micropolitan Statistical Area",2006,63206,270,68,687,619,232,33,199,-30
"16660",NA,17029,"Coles County, IL","County or equivalent",2006,52321,235,61,553,492,199,32,167,-25
"16660",NA,17035,"Cumberland County, IL","County or equivalent",2006,10885,35,7,134,127,33,1,32,-5
"16900",NA,NA,"Chester, SC","Micropolitan Statistical Area",2006,32642,-245,56,449,393,-288,12,-300,-13
"16900",NA,45023,"Chester County, SC","County or equivalent",2006,32642,-245,56,449,393,-288,12,-300,-13
"17060",NA,NA,"Chillicothe, OH","Micropolitan Statistical Area",2006,75240,432,200,935,735,268,21,247,-36
"17060",NA,39141,"Ross County, OH","County or equivalent",2006,75240,432,200,935,735,268,21,247,-36
"17180",NA,NA,"City of The Dalles, OR","Micropolitan Statistical Area",2006,23552,151,40,294,254,122,28,94,-11
"17180",NA,41065,"Wasco County, OR","County or equivalent",2006,23552,151,40,294,254,122,28,94,-11
"17200",NA,NA,"Claremont, NH","Micropolitan Statistical Area",2006,42522,211,49,454,405,185,17,168,-23
"17200",NA,33019,"Sullivan County, NH","County or equivalent",2006,42522,211,49,454,405,185,17,168,-23
"17220",NA,NA,"Clarksburg, WV","Micropolitan Statistical Area",2006,91641,240,-72,1035,1107,358,29,329,-46
"17220",NA,54017,"Doddridge County, WV","County or equivalent",2006,7218,-79,-4,72,76,-72,0,-72,-3
"17220",NA,54033,"Harrison County, WV","County or equivalent",2006,68324,230,-38,812,850,302,28,274,-34
"17220",NA,54091,"Taylor County, WV","County or equivalent",2006,16099,89,-30,151,181,128,1,127,-9
"17260",NA,NA,"Clarksdale, MS","Micropolitan Statistical Area",2006,27971,-278,210,513,303,-477,12,-489,-11
"17260",NA,28027,"Coahoma County, MS","County or equivalent",2006,27971,-278,210,513,303,-477,12,-489,-11
"17340",NA,NA,"Clearlake, CA","Micropolitan Statistical Area",2006,64662,530,-71,707,778,633,89,544,-32
"17340",NA,6033,"Lake County, CA","County or equivalent",2006,64662,530,-71,707,778,633,89,544,-32
"17380",NA,NA,"Cleveland, MS","Micropolitan Statistical Area",2006,37659,77,188,608,420,-93,6,-99,-18
"17380",NA,28011,"Bolivar County, MS","County or equivalent",2006,37659,77,188,608,420,-93,6,-99,-18
"17500",NA,NA,"Clewiston, FL","Micropolitan Statistical Area",2006,38978,647,442,719,277,225,348,-123,-20
"17500",NA,12051,"Hendry County, FL","County or equivalent",2006,38978,647,442,719,277,225,348,-123,-20
"17540",NA,NA,"Clinton, IA","Micropolitan Statistical Area",2006,49183,-85,106,630,524,-169,30,-199,-22
"17540",NA,19045,"Clinton County, IA","County or equivalent",2006,49183,-85,106,630,524,-169,30,-199,-22
"17580",NA,NA,"Clovis, NM","Micropolitan Statistical Area",2006,45538,-254,519,890,371,-755,148,-903,-18
"17580",NA,35009,"Curry County, NM","County or equivalent",2006,45538,-254,519,890,371,-755,148,-903,-18
"17700",NA,NA,"Coffeyville, KS","Micropolitan Statistical Area",2006,34314,64,-8,480,488,88,20,68,-16
"17700",NA,20125,"Montgomery County, KS","County or equivalent",2006,34314,64,-8,480,488,88,20,68,-16
"17740",NA,NA,"Coldwater, MI","Micropolitan Statistical Area",2006,46217,-106,211,618,407,-295,65,-360,-22
"17740",NA,26023,"Branch County, MI","County or equivalent",2006,46217,-106,211,618,407,-295,65,-360,-22
"17940",NA,NA,"Columbia, TN","Micropolitan Statistical Area",2006,77379,1942,342,1035,693,1643,96,1547,-43
"17940",NA,47119,"Maury County, TN","County or equivalent",2006,77379,1942,342,1035,693,1643,96,1547,-43
"18060",NA,NA,"Columbus, MS","Micropolitan Statistical Area",2006,59512,45,370,914,544,-298,60,-358,-27
"18060",NA,28087,"Lowndes County, MS","County or equivalent",2006,59512,45,370,914,544,-298,60,-358,-27
"18100",NA,NA,"Columbus, NE","Micropolitan Statistical Area",2006,31356,230,241,477,236,10,52,-42,-21
"18100",NA,31141,"Platte County, NE","County or equivalent",2006,31356,230,241,477,236,10,52,-42,-21
"18180",NA,NA,"Concord, NH","Micropolitan Statistical Area",2006,147541,1334,342,1537,1195,1065,135,930,-73
"18180",NA,33013,"Merrimack County, NH","County or equivalent",2006,147541,1334,342,1537,1195,1065,135,930,-73
"18220",NA,NA,"Connersville, IN","Micropolitan Statistical Area",2006,24363,-227,31,295,264,-248,3,-251,-10
"18220",NA,18041,"Fayette County, IN","County or equivalent",2006,24363,-227,31,295,264,-248,3,-251,-10
"18260",NA,NA,"Cookeville, TN","Micropolitan Statistical Area",2006,100170,1743,276,1331,1055,1526,131,1395,-59
"18260",NA,47087,"Jackson County, TN","County or equivalent",2006,10818,-160,-22,98,120,-132,3,-135,-6
"18260",NA,47133,"Overton County, TN","County or equivalent",2006,20721,272,17,259,242,265,0,265,-10
"18260",NA,47141,"Putnam County, TN","County or equivalent",2006,68631,1631,281,974,693,1393,128,1265,-43
"18300",NA,NA,"Coos Bay, OR","Micropolitan Statistical Area",2006,63675,-10,-214,652,866,234,43,191,-30
"18300",NA,41011,"Coos County, OR","County or equivalent",2006,63675,-10,-214,652,866,234,43,191,-30
"18340",NA,NA,"Corbin, KY","Micropolitan Statistical Area",2006,37946,245,55,470,415,210,7,203,-20
"18340",NA,21235,"Whitley County, KY","County or equivalent",2006,37946,245,55,470,415,210,7,203,-20
"18380",NA,NA,"Cordele, GA","Micropolitan Statistical Area",2006,21877,132,74,353,279,68,33,35,-10
"18380",NA,13081,"Crisp County, GA","County or equivalent",2006,21877,132,74,353,279,68,33,35,-10
"18420",NA,NA,"Corinth, MS","Micropolitan Statistical Area",2006,35333,305,59,483,424,263,15,248,-17
"18420",NA,28003,"Alcorn County, MS","County or equivalent",2006,35333,305,59,483,424,263,15,248,-17
"18460",NA,NA,"Cornelia, GA","Micropolitan Statistical Area",2006,40796,1491,275,606,331,1241,115,1126,-25
"18460",NA,13137,"Habersham County, GA","County or equivalent",2006,40796,1491,275,606,331,1241,115,1126,-25
"18500",NA,NA,"Corning, NY","Micropolitan Statistical Area",2006,96844,-501,161,1100,939,-618,43,-661,-44
"18500",NA,36101,"Steuben County, NY","County or equivalent",2006,96844,-501,161,1100,939,-618,43,-661,-44
"18620",NA,NA,"Corsicana, TX","Micropolitan Statistical Area",2006,48914,733,178,700,522,585,204,381,-30
"18620",NA,48349,"Navarro County, TX","County or equivalent",2006,48914,733,178,700,522,585,204,381,-30
"18660",NA,NA,"Cortland, NY","Micropolitan Statistical Area",2006,48374,11,110,556,446,-77,29,-106,-22
"18660",NA,36023,"Cortland County, NY","County or equivalent",2006,48374,11,110,556,446,-77,29,-106,-22
"18740",NA,NA,"Coshocton, OH","Micropolitan Statistical Area",2006,36495,-158,61,434,373,-203,25,-228,-16
"18740",NA,39031,"Coshocton County, OH","County or equivalent",2006,36495,-158,61,434,373,-203,25,-228,-16
"18820",NA,NA,"Crawfordsville, IN","Micropolitan Statistical Area",2006,37625,-158,118,466,348,-261,41,-302,-15
"18820",NA,18107,"Montgomery County, IN","County or equivalent",2006,37625,-158,118,466,348,-261,41,-302,-15
"18860",NA,NA,"Crescent City, CA","Micropolitan Statistical Area",2006,28577,73,47,341,294,41,53,-12,-15
"18860",NA,6015,"Del Norte County, CA","County or equivalent",2006,28577,73,47,341,294,41,53,-12,-15
"18900",NA,NA,"Crossville, TN","Micropolitan Statistical Area",2006,51984,1114,-72,525,597,1213,8,1205,-27
"18900",NA,47035,"Cumberland County, TN","County or equivalent",2006,51984,1114,-72,525,597,1213,8,1205,-27
"18940",NA,NA,"Crowley, LA","Micropolitan Statistical Area",2006,59648,880,273,912,639,640,8,632,-33
"18940",NA,22001,"Acadia Parish, LA","County or equivalent",2006,59648,880,273,912,639,640,8,632,-33
"18980",NA,NA,"Cullman, AL","Micropolitan Statistical Area",2006,79697,429,104,998,894,365,77,288,-40
"18980",NA,1043,"Cullman County, AL","County or equivalent",2006,79697,429,104,998,894,365,77,288,-40
"19020",NA,NA,"Culpeper, VA","Micropolitan Statistical Area",2006,44097,2204,285,627,342,1946,58,1888,-27
"19020",NA,51047,"Culpeper County, VA","County or equivalent",2006,44097,2204,285,627,342,1946,58,1888,-27
"19220",NA,NA,"Danville, KY","Micropolitan Statistical Area",2006,53498,315,158,683,525,185,50,135,-28
"19220",NA,21021,"Boyle County, KY","County or equivalent",2006,28429,161,31,337,306,146,39,107,-16
"19220",NA,21137,"Lincoln County, KY","County or equivalent",2006,25069,154,127,346,219,39,11,28,-12
"19300",NA,NA,"Daphne-Fairhope-Foley, AL","Micropolitan Statistical Area",2006,168154,6005,569,2199,1630,5443,139,5304,-7
"19300",NA,1003,"Baldwin County, AL","County or equivalent",2006,168154,6005,569,2199,1630,5443,139,5304,-7
"19540",NA,NA,"Decatur, IN","Micropolitan Statistical Area",2006,33732,-22,363,660,297,-370,10,-380,-15
"19540",NA,18001,"Adams County, IN","County or equivalent",2006,33732,-22,363,660,297,-370,10,-380,-15
"19580",NA,NA,"Defiance, OH","Micropolitan Statistical Area",2006,38717,120,169,531,362,-31,16,-47,-18
"19580",NA,39039,"Defiance County, OH","County or equivalent",2006,38717,120,169,531,362,-31,16,-47,-18
"19620",NA,NA,"Del Rio, TX","Micropolitan Statistical Area",2006,47210,169,625,945,320,-434,219,-653,-22
"19620",NA,48465,"Val Verde County, TX","County or equivalent",2006,47210,169,625,945,320,-434,219,-653,-22
"19700",NA,NA,"Deming, NM","Micropolitan Statistical Area",2006,26427,417,96,402,306,336,136,200,-15
"19700",NA,35029,"Luna County, NM","County or equivalent",2006,26427,417,96,402,306,336,136,200,-15
"19760",NA,NA,"De Ridder, LA","Micropolitan Statistical Area",2006,34683,447,118,491,373,349,9,340,-20
"19760",NA,22011,"Beauregard Parish, LA","County or equivalent",2006,34683,447,118,491,373,349,9,340,-20
"19860",NA,NA,"Dickinson, ND","Micropolitan Statistical Area",2006,22883,-25,45,263,218,-60,14,-74,-10
"19860",NA,38007,"Billings County, ND","County or equivalent",2006,773,-15,3,5,2,-18,1,-19,0
"19860",NA,38089,"Stark County, ND","County or equivalent",2006,22110,-10,42,258,216,-42,13,-55,-10
"19900",NA,NA,"Dillon, SC","Micropolitan Statistical Area",2006,30682,-8,142,451,309,-137,16,-153,-13
"19900",NA,45033,"Dillon County, SC","County or equivalent",2006,30682,-8,142,451,309,-137,16,-153,-13
"19940",NA,NA,"Dixon, IL","Micropolitan Statistical Area",2006,34924,39,50,386,336,6,15,-9,-17
"19940",NA,17103,"Lee County, IL","County or equivalent",2006,34924,39,50,386,336,6,15,-9,-17
"19980",NA,NA,"Dodge City, KS","Micropolitan Statistical Area",2006,32751,-125,429,642,213,-541,351,-892,-13
"19980",NA,20057,"Ford County, KS","County or equivalent",2006,32751,-125,429,642,213,-541,351,-892,-13
"20060",NA,NA,"Douglas, GA","Micropolitan Statistical Area",2006,47788,744,435,851,416,331,152,179,-22
"20060",NA,13003,"Atkinson County, GA","County or equivalent",2006,8022,81,84,170,86,0,39,-39,-3
"20060",NA,13069,"Coffee County, GA","County or equivalent",2006,39766,663,351,681,330,331,113,218,-19
"20140",NA,NA,"Dublin, GA","Micropolitan Statistical Area",2006,56059,535,264,831,567,298,30,268,-27
"20140",NA,13167,"Johnson County, GA","County or equivalent",2006,9008,107,23,122,99,88,2,86,-4
"20140",NA,13175,"Laurens County, GA","County or equivalent",2006,47051,428,241,709,468,210,28,182,-23
"20180",NA,NA,"DuBois, PA","Micropolitan Statistical Area",2006,82736,732,-121,790,911,892,13,879,-39
"20180",NA,42033,"Clearfield County, PA","County or equivalent",2006,82736,732,-121,790,911,892,13,879,-39
"20300",NA,NA,"Dumas, TX","Micropolitan Statistical Area",2006,19975,148,264,396,132,-106,119,-225,-10
"20300",NA,48341,"Moore County, TX","County or equivalent",2006,19975,148,264,396,132,-106,119,-225,-10
"20340",NA,NA,"Duncan, OK","Micropolitan Statistical Area",2006,42764,204,-4,541,545,228,3,225,-20
"20340",NA,40137,"Stephens County, OK","County or equivalent",2006,42764,204,-4,541,545,228,3,225,-20
"20380",NA,NA,"Dunn, NC","Micropolitan Statistical Area",2006,105301,2519,769,1521,752,1806,296,1510,-56
"20380",NA,37085,"Harnett County, NC","County or equivalent",2006,105301,2519,769,1521,752,1806,296,1510,-56
"20420",NA,NA,"Durango, CO","Micropolitan Statistical Area",2006,48781,979,264,566,302,741,30,711,-26
"20420",NA,8067,"La Plata County, CO","County or equivalent",2006,48781,979,264,566,302,741,30,711,-26
"20460",NA,NA,"Durant, OK","Micropolitan Statistical Area",2006,38780,1133,102,556,454,1051,38,1013,-20
"20460",NA,40013,"Bryan County, OK","County or equivalent",2006,38780,1133,102,556,454,1051,38,1013,-20
"20540",NA,NA,"Dyersburg, TN","Micropolitan Statistical Area",2006,37631,77,99,513,414,-5,26,-31,-17
"20540",NA,47045,"Dyer County, TN","County or equivalent",2006,37631,77,99,513,414,-5,26,-31,-17
"20580",NA,NA,"Eagle Pass, TX","Micropolitan Statistical Area",2006,50863,788,785,1102,317,30,255,-225,-27
"20580",NA,48323,"Maverick County, TX","County or equivalent",2006,50863,788,785,1102,317,30,255,-225,-27
"20620",NA,NA,"East Liverpool-Salem, OH","Micropolitan Statistical Area",2006,109191,-338,71,1207,1136,-360,19,-379,-49
"20620",NA,39029,"Columbiana County, OH","County or equivalent",2006,109191,-338,71,1207,1136,-360,19,-379,-49
"20660",NA,NA,"Easton, MD","Micropolitan Statistical Area",2006,36035,432,-63,379,442,513,31,482,-18
"20660",NA,24041,"Talbot County, MD","County or equivalent",2006,36035,432,-63,379,442,513,31,482,-18
"20700",NA,NA,"East Stroudsburg, PA","Micropolitan Statistical Area",2006,162716,2684,439,1618,1179,2328,124,2204,-83
"20700",NA,42089,"Monroe County, PA","County or equivalent",2006,162716,2684,439,1618,1179,2328,124,2204,-83
"20780",NA,NA,"Edwards, CO","Micropolitan Statistical Area",2006,57034,1535,841,966,125,726,582,144,-32
"20780",NA,8037,"Eagle County, CO","County or equivalent",2006,49400,1507,756,853,97,779,497,282,-28
"20780",NA,8065,"Lake County, CO","County or equivalent",2006,7634,28,85,113,28,-53,85,-138,-4
"20820",NA,NA,"Effingham, IL","Micropolitan Statistical Area",2006,34279,-126,191,477,286,-302,12,-314,-15
"20820",NA,17049,"Effingham County, IL","County or equivalent",2006,34279,-126,191,477,286,-302,12,-314,-15
"20900",NA,NA,"El Campo, TX","Micropolitan Statistical Area",2006,40881,11,232,634,402,-200,101,-301,-21
"20900",NA,48481,"Wharton County, TX","County or equivalent",2006,40881,11,232,634,402,-200,101,-301,-21
"20980",NA,NA,"El Dorado, AR","Micropolitan Statistical Area",2006,43502,-112,34,582,548,-126,28,-154,-20
"20980",NA,5139,"Union County, AR","County or equivalent",2006,43502,-112,34,582,548,-126,28,-154,-20
"21020",NA,NA,"Elizabeth City, NC","Micropolitan Statistical Area",2006,60765,1864,225,777,552,1673,45,1628,-34
"21020",NA,37029,"Camden County, NC","County or equivalent",2006,9188,292,26,101,75,271,2,269,-5
"21020",NA,37139,"Pasquotank County, NC","County or equivalent",2006,39471,1265,225,561,336,1062,41,1021,-22
"21020",NA,37143,"Perquimans County, NC","County or equivalent",2006,12106,307,-26,115,141,340,2,338,-7
"21120",NA,NA,"Elk City, OK","Micropolitan Statistical Area",2006,19311,686,35,300,265,663,7,656,-12
"21120",NA,40009,"Beckham County, OK","County or equivalent",2006,19311,686,35,300,265,663,7,656,-12
"21220",NA,NA,"Elko, NV","Micropolitan Statistical Area",2006,47104,1324,377,624,247,974,129,845,-27
"21220",NA,32007,"Elko County, NV","County or equivalent",2006,45639,1236,369,608,239,893,124,769,-26
"21220",NA,32011,"Eureka County, NV","County or equivalent",2006,1465,88,8,16,8,81,5,76,-1
"21260",NA,NA,"Ellensburg, WA","Micropolitan Statistical Area",2006,37844,889,105,352,247,802,60,742,-18
"21260",NA,53037,"Kittitas County, WA","County or equivalent",2006,37844,889,105,352,247,802,60,742,-18
"21380",NA,NA,"Emporia, KS","Micropolitan Statistical Area",2006,38580,-178,256,601,345,-417,156,-573,-17
"21380",NA,20017,"Chase County, KS","County or equivalent",2006,2965,-20,-2,34,36,-16,2,-18,-2
"21380",NA,20111,"Lyon County, KS","County or equivalent",2006,35615,-158,258,567,309,-401,154,-555,-15
"21420",NA,NA,"Enid, OK","Micropolitan Statistical Area",2006,57199,238,234,935,701,32,78,-46,-28
"21420",NA,40047,"Garfield County, OK","County or equivalent",2006,57199,238,234,935,701,32,78,-46,-28
"21460",NA,NA,"Enterprise-Ozark, AL","Micropolitan Statistical Area",2006,93581,213,369,1340,971,-113,186,-299,-43
"21460",NA,1031,"Coffee County, AL","County or equivalent",2006,45588,455,106,582,476,371,78,293,-22
"21460",NA,1045,"Dale County, AL","County or equivalent",2006,47993,-242,263,758,495,-484,108,-592,-21
"21540",NA,NA,"Escanaba, MI","Micropolitan Statistical Area",2006,37694,-139,-7,421,428,-115,7,-122,-17
"21540",NA,26041,"Delta County, MI","County or equivalent",2006,37694,-139,-7,421,428,-115,7,-122,-17
"21580",NA,NA,"Espanola, NM","Micropolitan Statistical Area",2006,40652,198,349,720,371,-132,66,-198,-19
"21580",NA,35039,"Rio Arriba County, NM","County or equivalent",2006,40652,198,349,720,371,-132,66,-198,-19
"21640",NA,NA,"Eufaula, AL-GA","Micropolitan Statistical Area",2006,32059,95,57,399,342,-148,35,-183,186
"21640",NA,1005,"Barbour County, AL","County or equivalent",2006,29420,48,55,363,308,-194,35,-229,187
"21640",NA,13239,"Quitman County, GA","County or equivalent",2006,2639,47,2,36,34,46,0,46,-1
"21700",NA,NA,"Eureka-Arcata-Fortuna, CA","Micropolitan Statistical Area",2006,129077,114,431,1603,1172,-258,120,-378,-59
"21700",NA,6023,"Humboldt County, CA","County or equivalent",2006,129077,114,431,1603,1172,-258,120,-378,-59
"21740",NA,NA,"Evanston, WY","Micropolitan Statistical Area",2006,19688,259,184,310,126,86,11,75,-11
"21740",NA,56041,"Uinta County, WY","County or equivalent",2006,19688,259,184,310,126,86,11,75,-11
"21860",NA,NA,"Fairmont, MN","Micropolitan Statistical Area",2006,20497,-213,-19,235,254,-186,5,-191,-8
"21860",NA,27091,"Martin County, MN","County or equivalent",2006,20497,-213,-19,235,254,-186,5,-191,-8
"21900",NA,NA,"Fairmont, WV","Micropolitan Statistical Area",2006,56424,67,-74,606,680,168,10,158,-27
"21900",NA,54049,"Marion County, WV","County or equivalent",2006,56424,67,-74,606,680,168,10,158,-27
"21980",NA,NA,"Fallon, NV","Micropolitan Statistical Area",2006,24618,185,95,355,260,104,52,52,-14
"21980",NA,32001,"Churchill County, NV","County or equivalent",2006,24618,185,95,355,260,104,52,52,-14
"22060",NA,NA,"Faribault-Northfield, MN","Micropolitan Statistical Area",2006,61303,808,419,822,403,420,133,287,-31
"22060",NA,27131,"Rice County, MN","County or equivalent",2006,61303,808,419,822,403,420,133,287,-31
"22100",NA,NA,"Farmington, MO","Micropolitan Statistical Area",2006,62076,454,106,800,694,380,17,363,-32
"22100",NA,29187,"St. Francois County, MO","County or equivalent",2006,62076,454,106,800,694,380,17,363,-32
"22260",NA,NA,"Fergus Falls, MN","Micropolitan Statistical Area",2006,57123,101,-18,613,631,145,58,87,-26
"22260",NA,27111,"Otter Tail County, MN","County or equivalent",2006,57123,101,-18,613,631,145,58,87,-26
"22280",NA,NA,"Fernley, NV","Micropolitan Statistical Area",2006,50284,3693,202,650,448,3527,45,3482,-36
"22280",NA,32019,"Lyon County, NV","County or equivalent",2006,50284,3693,202,650,448,3527,45,3482,-36
"22300",NA,NA,"Findlay, OH","Micropolitan Statistical Area",2006,73717,457,309,952,643,184,72,112,-36
"22300",NA,39063,"Hancock County, OH","County or equivalent",2006,73717,457,309,952,643,184,72,112,-36
"22340",NA,NA,"Fitzgerald, GA","Micropolitan Statistical Area",2006,27671,371,162,441,279,225,42,183,-16
"22340",NA,13017,"Ben Hill County, GA","County or equivalent",2006,17461,271,145,332,187,136,27,109,-10
"22340",NA,13155,"Irwin County, GA","County or equivalent",2006,10210,100,17,109,92,89,15,74,-6
"22580",NA,NA,"Forest City, NC","Micropolitan Statistical Area",2006,62909,107,-96,719,815,234,23,211,-31
"22580",NA,37161,"Rutherford County, NC","County or equivalent",2006,62909,107,-96,719,815,234,23,211,-31
"22620",NA,NA,"Forrest City, AR","Micropolitan Statistical Area",2006,27135,-322,140,426,286,-452,0,-452,-10
"22620",NA,5123,"St. Francis County, AR","County or equivalent",2006,27135,-322,140,426,286,-452,0,-452,-10
"22700",NA,NA,"Fort Dodge, IA","Micropolitan Statistical Area",2006,38635,56,-37,478,515,111,25,86,-18
"22700",NA,19187,"Webster County, IA","County or equivalent",2006,38635,56,-37,478,515,111,25,86,-18
"22780",NA,NA,"Fort Leonard Wood, MO","Micropolitan Statistical Area",2006,43742,-123,461,706,245,-565,301,-866,-19
"22780",NA,29169,"Pulaski County, MO","County or equivalent",2006,43742,-123,461,706,245,-565,301,-866,-19
"22800",NA,NA,"Fort Madison-Keokuk, IA-MO","Micropolitan Statistical Area",2006,43061,-277,10,509,499,-267,18,-285,-20
"22800",NA,19111,"Lee County, IA","County or equivalent",2006,35877,-248,2,416,414,-233,18,-251,-17
"22800",NA,29045,"Clark County, MO","County or equivalent",2006,7184,-29,8,93,85,-34,0,-34,-3
"22820",NA,NA,"Fort Morgan, CO","Micropolitan Statistical Area",2006,27778,105,168,415,247,-51,154,-205,-12
"22820",NA,8087,"Morgan County, CO","County or equivalent",2006,27778,105,168,415,247,-51,154,-205,-12
"22840",NA,NA,"Fort Payne, AL","Micropolitan Statistical Area",2006,67111,454,224,978,754,263,149,114,-33
"22840",NA,1049,"DeKalb County, AL","County or equivalent",2006,67111,454,224,978,754,263,149,114,-33
"22860",NA,NA,"Fort Polk South, LA","Micropolitan Statistical Area",2006,48453,-1777,552,906,354,-2319,259,-2578,-10
"22860",NA,22115,"Vernon Parish, LA","County or equivalent",2006,48453,-1777,552,906,354,-2319,259,-2578,-10
"22980",NA,NA,"Fort Valley, GA","Micropolitan Statistical Area",2006,25104,626,148,365,217,492,57,435,-14
"22980",NA,13225,"Peach County, GA","County or equivalent",2006,25104,626,148,365,217,492,57,435,-14
"23140",NA,NA,"Frankfort, IN","Micropolitan Statistical Area",2006,33820,128,185,532,347,-41,141,-182,-16
"23140",NA,18023,"Clinton County, IN","County or equivalent",2006,33820,128,185,532,347,-41,141,-182,-16
"23180",NA,NA,"Frankfort, KY","Micropolitan Statistical Area",2006,69127,538,252,922,670,320,63,257,-34
"23180",NA,21005,"Anderson County, KY","County or equivalent",2006,20742,533,91,276,185,453,6,447,-11
"23180",NA,21073,"Franklin County, KY","County or equivalent",2006,48385,5,161,646,485,-133,57,-190,-23
"23240",NA,NA,"Fredericksburg, TX","Micropolitan Statistical Area",2006,23144,476,-52,254,306,542,29,513,-14
"23240",NA,48171,"Gillespie County, TX","County or equivalent",2006,23144,476,-52,254,306,542,29,513,-14
"23300",NA,NA,"Freeport, IL","Micropolitan Statistical Area",2006,46926,-404,84,572,488,-467,55,-522,-21
"23300",NA,17177,"Stephenson County, IL","County or equivalent",2006,46926,-404,84,572,488,-467,55,-522,-21
"23340",NA,NA,"Fremont, NE","Micropolitan Statistical Area",2006,35856,22,121,498,377,-83,28,-111,-16
"23340",NA,31053,"Dodge County, NE","County or equivalent",2006,35856,22,121,498,377,-83,28,-111,-16
"23380",NA,NA,"Fremont, OH","Micropolitan Statistical Area",2006,61110,-123,144,785,641,-238,16,-254,-29
"23380",NA,39143,"Sandusky County, OH","County or equivalent",2006,61110,-123,144,785,641,-238,16,-254,-29
"23500",NA,NA,"Gaffney, SC","Micropolitan Statistical Area",2006,53752,256,96,668,572,185,25,160,-25
"23500",NA,45021,"Cherokee County, SC","County or equivalent",2006,53752,256,96,668,572,185,25,160,-25
"23620",NA,NA,"Gainesville, TX","Micropolitan Statistical Area",2006,38298,49,208,575,367,-141,107,-248,-18
"23620",NA,48097,"Cooke County, TX","County or equivalent",2006,38298,49,208,575,367,-141,107,-248,-18
"23660",NA,NA,"Galesburg, IL","Micropolitan Statistical Area",2006,69956,-501,-124,729,853,-347,17,-364,-30
"23660",NA,17095,"Knox County, IL","County or equivalent",2006,52299,-453,-142,509,651,-289,13,-302,-22
"23660",NA,17187,"Warren County, IL","County or equivalent",2006,17657,-48,18,220,202,-58,4,-62,-8
"23700",NA,NA,"Gallup, NM","Micropolitan Statistical Area",2006,70457,-84,891,1401,510,-944,38,-982,-31
"23700",NA,35031,"McKinley County, NM","County or equivalent",2006,70457,-84,891,1401,510,-944,38,-982,-31
"23780",NA,NA,"Garden City, KS","Micropolitan Statistical Area",2006,40676,174,571,743,172,-757,349,-1106,360
"23780",NA,20055,"Finney County, KS","County or equivalent",2006,40676,174,571,743,172,-757,349,-1106,360
"23820",NA,NA,"Gardnerville Ranchos, NV","Micropolitan Statistical Area",2006,45479,-200,-1,369,370,-174,40,-214,-25
"23820",NA,32005,"Douglas County, NV","County or equivalent",2006,45479,-200,-1,369,370,-174,40,-214,-25
"23860",NA,NA,"Georgetown, SC","Micropolitan Statistical Area",2006,59912,448,132,697,565,350,49,301,-34
"23860",NA,45043,"Georgetown County, SC","County or equivalent",2006,59912,448,132,697,565,350,49,301,-34
"23900",NA,NA,"Gettysburg, PA","Micropolitan Statistical Area",2006,99858,1080,214,1083,869,914,118,796,-48
"23900",NA,42001,"Adams County, PA","County or equivalent",2006,99858,1080,214,1083,869,914,118,796,-48
"23940",NA,NA,"Gillette, WY","Micropolitan Statistical Area",2006,38456,1435,462,658,196,994,15,979,-21
"23940",NA,56005,"Campbell County, WY","County or equivalent",2006,38456,1435,462,658,196,994,15,979,-21
"23980",NA,NA,"Glasgow, KY","Micropolitan Statistical Area",2006,50652,571,155,678,523,445,21,424,-29
"23980",NA,21009,"Barren County, KY","County or equivalent",2006,40526,527,141,554,413,409,21,388,-23
"23980",NA,21169,"Metcalfe County, KY","County or equivalent",2006,10126,44,14,124,110,36,0,36,-6
"24100",NA,NA,"Gloversville, NY","Micropolitan Statistical Area",2006,54885,-73,-9,549,558,-39,29,-68,-25
"24100",NA,36035,"Fulton County, NY","County or equivalent",2006,54885,-73,-9,549,558,-39,29,-68,-25
"24180",NA,NA,"Granbury, TX","Micropolitan Statistical Area",2006,55623,1403,90,682,592,1343,55,1288,-30
"24180",NA,48221,"Hood County, TX","County or equivalent",2006,48015,1213,78,589,511,1160,46,1114,-25
"24180",NA,48425,"Somervell County, TX","County or equivalent",2006,7608,190,12,93,81,183,9,174,-5
"24260",NA,NA,"Grand Island, NE","Micropolitan Statistical Area",2006,69119,493,450,1106,656,79,212,-133,-36
"24260",NA,31079,"Hall County, NE","County or equivalent",2006,54845,568,451,965,514,146,210,-64,-29
"24260",NA,31093,"Howard County, NE","County or equivalent",2006,6518,-9,-7,70,77,2,0,2,-4
"24260",NA,31121,"Merrick County, NE","County or equivalent",2006,7756,-66,6,71,65,-69,2,-71,-3
"24380",NA,NA,"Grants, NM","Micropolitan Statistical Area",2006,26976,-181,195,417,222,-364,11,-375,-12
"24380",NA,35006,"Cibola County, NM","County or equivalent",2006,26976,-181,195,417,222,-364,11,-375,-12
"24420",NA,NA,"Grants Pass, OR","Micropolitan Statistical Area",2006,80713,836,-254,795,1049,1133,20,1113,-43
"24420",NA,41033,"Josephine County, OR","County or equivalent",2006,80713,836,-254,795,1049,1133,20,1113,-43
"24460",NA,NA,"Great Bend, KS","Micropolitan Statistical Area",2006,27769,-96,82,365,283,-178,65,-243,0
"24460",NA,20009,"Barton County, KS","County or equivalent",2006,27769,-96,82,365,283,-178,65,-243,0
"24620",NA,NA,"Greeneville, TN","Micropolitan Statistical Area",2006,65363,568,-49,722,771,647,43,604,-30
"24620",NA,47059,"Greene County, TN","County or equivalent",2006,65363,568,-49,722,771,647,43,604,-30
"24700",NA,NA,"Greensburg, IN","Micropolitan Statistical Area",2006,24967,-64,124,359,235,-175,30,-205,-13
"24700",NA,18031,"Decatur County, IN","County or equivalent",2006,24967,-64,124,359,235,-175,30,-205,-13
"24740",NA,NA,"Greenville, MS","Micropolitan Statistical Area",2006,56469,-1105,321,943,622,-1408,24,-1432,-18
"24740",NA,28151,"Washington County, MS","County or equivalent",2006,56469,-1105,321,943,622,-1408,24,-1432,-18
"24820",NA,NA,"Greenville, OH","Micropolitan Statistical Area",2006,52301,-338,184,680,496,-501,3,-504,-21
"24820",NA,39037,"Darke County, OH","County or equivalent",2006,52301,-338,184,680,496,-501,3,-504,-21
"24900",NA,NA,"Greenwood, MS","Micropolitan Statistical Area",2006,45381,-175,234,711,477,-390,17,-407,-19
"24900",NA,28015,"Carroll County, MS","County or equivalent",2006,10191,-62,-1,112,113,-57,3,-60,-4
"24900",NA,28083,"Leflore County, MS","County or equivalent",2006,35190,-113,235,599,364,-333,14,-347,-15
"24940",NA,NA,"Greenwood, SC","Micropolitan Statistical Area",2006,67881,286,234,925,691,85,135,-50,-33
"24940",NA,45047,"Greenwood County, SC","County or equivalent",2006,67881,286,234,925,691,85,135,-50,-33
"24980",NA,NA,"Grenada, MS","Micropolitan Statistical Area",2006,22968,245,73,338,265,184,14,170,-12
"24980",NA,28043,"Grenada County, MS","County or equivalent",2006,22968,245,73,338,265,184,14,170,-12
"25100",NA,NA,"Guymon, OK","Micropolitan Statistical Area",2006,19850,21,214,344,130,-184,194,-378,-9
"25100",NA,40139,"Texas County, OK","County or equivalent",2006,19850,21,214,344,130,-184,194,-378,-9
"25220",NA,NA,"Hammond, LA","Micropolitan Statistical Area",2006,113041,6859,568,1688,1120,6379,28,6351,-88
"25220",NA,22105,"Tangipahoa Parish, LA","County or equivalent",2006,113041,6859,568,1688,1120,6379,28,6351,-88
"25300",NA,NA,"Hannibal, MO","Micropolitan Statistical Area",2006,38005,181,70,495,425,129,5,124,-18
"25300",NA,29127,"Marion County, MO","County or equivalent",2006,28217,91,39,385,346,66,4,62,-14
"25300",NA,29173,"Ralls County, MO","County or equivalent",2006,9788,90,31,110,79,63,1,62,-4
"25340",NA,NA,"Harriman, TN","Micropolitan Statistical Area",2006,53040,471,-10,545,555,505,21,484,-24
"25340",NA,47145,"Roane County, TN","County or equivalent",2006,53040,471,-10,545,555,505,21,484,-24
"25380",NA,NA,"Harrisburg, IL","Micropolitan Statistical Area",2006,25973,4,-88,298,386,104,6,98,-12
"25380",NA,17165,"Saline County, IL","County or equivalent",2006,25973,4,-88,298,386,104,6,98,-12
"25460",NA,NA,"Harrison, AR","Micropolitan Statistical Area",2006,44287,523,13,524,511,533,8,525,-23
"25460",NA,5009,"Boone County, AR","County or equivalent",2006,35922,537,29,447,418,527,8,519,-19
"25460",NA,5101,"Newton County, AR","County or equivalent",2006,8365,-14,-16,77,93,6,0,6,-4
"25580",NA,NA,"Hastings, NE","Micropolitan Statistical Area",2006,39271,-166,133,512,379,-297,90,-387,-2
"25580",NA,31001,"Adams County, NE","County or equivalent",2006,32872,-76,129,436,307,-206,87,-293,1
"25580",NA,31035,"Clay County, NE","County or equivalent",2006,6399,-90,4,76,72,-91,3,-94,-3
"25660",NA,NA,"Havre, MT","Micropolitan Statistical Area",2006,16431,220,142,294,152,87,0,87,-9
"25660",NA,30041,"Hill County, MT","County or equivalent",2006,16431,220,142,294,152,87,0,87,-9
"25700",NA,NA,"Hays, KS","Micropolitan Statistical Area",2006,27314,209,120,350,230,104,27,77,-15
"25700",NA,20051,"Ellis County, KS","County or equivalent",2006,27314,209,120,350,230,104,27,77,-15
"25720",NA,NA,"Heber, UT","Micropolitan Statistical Area",2006,19861,1114,261,360,99,867,32,835,-14
"25720",NA,49051,"Wasatch County, UT","County or equivalent",2006,19861,1114,261,360,99,867,32,835,-14
"25740",NA,NA,"Helena, MT","Micropolitan Statistical Area",2006,69755,881,207,790,583,709,28,681,-35
"25740",NA,30043,"Jefferson County, MT","County or equivalent",2006,10857,78,24,106,82,59,2,57,-5
"25740",NA,30049,"Lewis and Clark County, MT","County or equivalent",2006,58898,803,183,684,501,650,26,624,-30
"25760",NA,NA,"Helena-West Helena, AR","Micropolitan Statistical Area",2006,22550,-720,61,397,336,-775,6,-781,-6
"25760",NA,5107,"Phillips County, AR","County or equivalent",2006,22550,-720,61,397,336,-775,6,-781,-6
"25780",NA,NA,"Henderson, NC","Micropolitan Statistical Area",2006,42980,120,222,659,437,-83,95,-178,-19
"25780",NA,37181,"Vance County, NC","County or equivalent",2006,42980,120,222,659,437,-83,95,-178,-19
"25820",NA,NA,"Hereford, TX","Micropolitan Statistical Area",2006,18295,5,240,381,141,-227,50,-277,-8
"25820",NA,48117,"Deaf Smith County, TX","County or equivalent",2006,18295,5,240,381,141,-227,50,-277,-8
"25900",NA,NA,"Hilo, HI","Micropolitan Statistical Area",2006,169061,4599,1047,2275,1228,3642,366,3276,-90
"25900",NA,15001,"Hawaii County, HI","County or equivalent",2006,169061,4599,1047,2275,1228,3642,366,3276,-90
"25940",NA,NA,"Hilton Head Island-Beaufort, SC","Micropolitan Statistical Area",2006,164581,4490,1425,2652,1227,3164,764,2400,-99
"25940",NA,45013,"Beaufort County, SC","County or equivalent",2006,143091,4122,1210,2252,1042,2999,683,2316,-87
"25940",NA,45053,"Jasper County, SC","County or equivalent",2006,21490,368,215,400,185,165,81,84,-12
"26020",NA,NA,"Hobbs, NM","Micropolitan Statistical Area",2006,56793,803,577,1078,501,254,75,179,-28
"26020",NA,35025,"Lea County, NM","County or equivalent",2006,56793,803,577,1078,501,254,75,179,-28
"26140",NA,NA,"Homosassa Springs, FL","Micropolitan Statistical Area",2006,136855,3966,-1167,1108,2275,5208,62,5146,-75
"26140",NA,12017,"Citrus County, FL","County or equivalent",2006,136855,3966,-1167,1108,2275,5208,62,5146,-75
"26220",NA,NA,"Hood River, OR","Micropolitan Statistical Area",2006,21120,136,145,299,154,1,92,-91,-10
"26220",NA,41027,"Hood River County, OR","County or equivalent",2006,21120,136,145,299,154,1,92,-91,-10
"26260",NA,NA,"Hope, AR","Micropolitan Statistical Area",2006,32485,-38,153,482,329,-176,105,-281,-15
"26260",NA,5057,"Hempstead County, AR","County or equivalent",2006,23062,63,129,347,218,-55,95,-150,-11
"26260",NA,5099,"Nevada County, AR","County or equivalent",2006,9423,-101,24,135,111,-121,10,-131,-4
"26340",NA,NA,"Houghton, MI","Micropolitan Statistical Area",2006,37203,-438,35,450,415,-461,49,-510,-12
"26340",NA,26061,"Houghton County, MI","County or equivalent",2006,35050,-455,22,414,392,-465,49,-514,-12
"26340",NA,26083,"Keweenaw County, MI","County or equivalent",2006,2153,17,13,36,23,4,0,4,0
"26460",NA,NA,"Hudson, NY","Micropolitan Statistical Area",2006,62469,-411,-6,596,602,-378,60,-438,-27
"26460",NA,36021,"Columbia County, NY","County or equivalent",2006,62469,-411,-6,596,602,-378,60,-438,-27
"26480",NA,NA,"Humboldt, TN","Micropolitan Statistical Area",2006,48038,187,-92,594,686,301,17,284,-22
"26480",NA,47053,"Gibson County, TN","County or equivalent",2006,48038,187,-92,594,686,301,17,284,-22
"26500",NA,NA,"Huntingdon, PA","Micropolitan Statistical Area",2006,45440,-115,9,456,447,-105,1,-106,-19
"26500",NA,42061,"Huntingdon County, PA","County or equivalent",2006,45440,-115,9,456,447,-105,1,-106,-19
"26540",NA,NA,"Huntington, IN","Micropolitan Statistical Area",2006,37859,-120,77,472,395,-180,10,-190,-17
"26540",NA,18069,"Huntington County, IN","County or equivalent",2006,37859,-120,77,472,395,-180,10,-190,-17
"26660",NA,NA,"Huntsville, TX","Micropolitan Statistical Area",2006,63923,-412,187,608,421,-572,89,-661,-27
"26660",NA,48471,"Walker County, TX","County or equivalent",2006,63923,-412,187,608,421,-572,89,-661,-27
"26700",NA,NA,"Huron, SD","Micropolitan Statistical Area",2006,15452,-291,-23,181,204,-263,6,-269,-5
"26700",NA,46005,"Beadle County, SD","County or equivalent",2006,15452,-291,-23,181,204,-263,6,-269,-5
"26740",NA,NA,"Hutchinson, KS","Micropolitan Statistical Area",2006,63284,23,98,835,737,-45,39,-84,-30
"26740",NA,20155,"Reno County, KS","County or equivalent",2006,63284,23,98,835,737,-45,39,-84,-30
"26780",NA,NA,"Hutchinson, MN","Micropolitan Statistical Area",2006,36824,516,215,512,297,319,24,295,-18
"26780",NA,27085,"McLeod County, MN","County or equivalent",2006,36824,516,215,512,297,319,24,295,-18
"26860",NA,NA,"Indiana, PA","Micropolitan Statistical Area",2006,87792,-174,-34,864,898,-100,41,-141,-40
"26860",NA,42063,"Indiana County, PA","County or equivalent",2006,87792,-174,-34,864,898,-100,41,-141,-40
"26940",NA,NA,"Indianola, MS","Micropolitan Statistical Area",2006,31069,-324,172,522,350,-485,15,-500,-11
"26940",NA,28133,"Sunflower County, MS","County or equivalent",2006,31069,-324,172,522,350,-485,15,-500,-11
"27020",NA,NA,"Iron Mountain, MI-WI","Micropolitan Statistical Area",2006,31854,-225,-78,294,372,-133,4,-137,-14
"27020",NA,26043,"Dickinson County, MI","County or equivalent",2006,27014,-203,-64,259,323,-128,4,-132,-11
"27020",NA,55037,"Florence County, WI","County or equivalent",2006,4840,-22,-14,35,49,-5,0,-5,-3
"27220",NA,NA,"Jackson, WY-ID","Micropolitan Statistical Area",2006,27346,686,315,436,121,386,111,275,-15
"27220",NA,16081,"Teton County, ID","County or equivalent",2006,7758,362,97,136,39,270,35,235,-5
"27220",NA,56039,"Teton County, WY","County or equivalent",2006,19588,324,218,300,82,116,76,40,-10
"27300",NA,NA,"Jacksonville, IL","Micropolitan Statistical Area",2006,40697,-323,-27,440,467,-279,12,-291,-17
"27300",NA,17137,"Morgan County, IL","County or equivalent",2006,35447,-237,-35,372,407,-188,12,-200,-14
"27300",NA,17171,"Scott County, IL","County or equivalent",2006,5250,-86,8,68,60,-91,0,-91,-3
"27380",NA,NA,"Jacksonville, TX","Micropolitan Statistical Area",2006,47769,167,304,745,441,-113,162,-275,-24
"27380",NA,48073,"Cherokee County, TX","County or equivalent",2006,47769,167,304,745,441,-113,162,-275,-24
"27420",NA,NA,"Jamestown, ND","Micropolitan Statistical Area",2006,20736,-43,6,237,231,-39,6,-45,-10
"27420",NA,38093,"Stutsman County, ND","County or equivalent",2006,20736,-43,6,237,231,-39,6,-45,-10
"27460",NA,NA,"Jamestown-Dunkirk-Fredonia, NY","Micropolitan Statistical Area",2006,134336,-756,133,1478,1345,-830,110,-940,-59
"27460",NA,36013,"Chautauqua County, NY","County or equivalent",2006,134336,-756,133,1478,1345,-830,110,-940,-59
"27540",NA,NA,"Jasper, IN","Micropolitan Statistical Area",2006,53584,336,179,688,509,187,46,141,-30
"27540",NA,18037,"Dubois County, IN","County or equivalent",2006,40965,255,150,524,374,127,45,82,-22
"27540",NA,18125,"Pike County, IN","County or equivalent",2006,12619,81,29,164,135,60,1,59,-8
"27660",NA,NA,"Jennings, LA","Micropolitan Statistical Area",2006,31204,303,96,457,361,223,5,218,-16
"27660",NA,22053,"Jefferson Davis Parish, LA","County or equivalent",2006,31204,303,96,457,361,223,5,218,-16
"27700",NA,NA,"Jesup, GA","Micropolitan Statistical Area",2006,28532,259,172,441,269,100,21,79,-13
"27700",NA,13305,"Wayne County, GA","County or equivalent",2006,28532,259,172,441,269,100,21,79,-13
"27940",NA,NA,"Juneau, AK","Micropolitan Statistical Area",2006,30677,-166,255,395,140,-408,43,-451,-13
"27940",NA,2110,"Juneau City and Borough, AK","County or equivalent",2006,30677,-166,255,395,140,-408,43,-451,-13
"27980",NA,NA,"Kahului-Wailuku, HI","Micropolitan Statistical Area",2006,140000,1375,1086,1937,851,359,461,-102,-70
"27980",NA,15009,"Maui County, HI","County or equivalent",2006,140000,1375,1086,1937,851,359,461,-102,-70
"28060",NA,NA,"Kalispell, MT","Micropolitan Statistical Area",2006,84549,2019,414,1111,697,1648,32,1616,-43
"28060",NA,30029,"Flathead County, MT","County or equivalent",2006,84549,2019,414,1111,697,1648,32,1616,-43
"28180",NA,NA,"Kapaa, HI","Micropolitan Statistical Area",2006,61950,361,337,800,463,52,118,-66,-28
"28180",NA,15007,"Kauai County, HI","County or equivalent",2006,61950,361,337,800,463,52,118,-66,-28
"28260",NA,NA,"Kearney, NE","Micropolitan Statistical Area",2006,51060,378,314,715,401,90,33,57,-26
"28260",NA,31019,"Buffalo County, NE","County or equivalent",2006,44514,485,323,647,324,187,33,154,-25
"28260",NA,31099,"Kearney County, NE","County or equivalent",2006,6546,-107,-9,68,77,-97,0,-97,-1
"28300",NA,NA,"Keene, NH","Micropolitan Statistical Area",2006,77260,434,164,817,653,306,31,275,-36
"28300",NA,33005,"Cheshire County, NH","County or equivalent",2006,77260,434,164,817,653,306,31,275,-36
"28340",NA,NA,"Kendallville, IN","Micropolitan Statistical Area",2006,47408,197,334,698,364,-116,130,-246,-21
"28340",NA,18113,"Noble County, IN","County or equivalent",2006,47408,197,334,698,364,-116,130,-246,-21
"28380",NA,NA,"Kennett, MO","Micropolitan Statistical Area",2006,31786,-252,8,492,484,-247,18,-265,-13
"28380",NA,29069,"Dunklin County, MO","County or equivalent",2006,31786,-252,8,492,484,-247,18,-265,-13
"28500",NA,NA,"Kerrville, TX","Micropolitan Statistical Area",2006,47046,903,-1,607,608,933,71,862,-29
"28500",NA,48265,"Kerr County, TX","County or equivalent",2006,47046,903,-1,607,608,933,71,862,-29
"28540",NA,NA,"Ketchikan, AK","Micropolitan Statistical Area",2006,13315,142,108,191,83,40,20,20,-6
"28540",NA,2130,"Ketchikan Gateway Borough, AK","County or equivalent",2006,13315,142,108,191,83,40,20,20,-6
"28580",NA,NA,"Key West, FL","Micropolitan Statistical Area",2006,74081,-1669,-6,721,727,-1632,383,-2015,-31
"28580",NA,12087,"Monroe County, FL","County or equivalent",2006,74081,-1669,-6,721,727,-1632,383,-2015,-31
"28620",NA,NA,"Kill Devil Hills, NC","Micropolitan Statistical Area",2006,33754,91,189,446,257,-77,34,-111,-21
"28620",NA,37055,"Dare County, NC","County or equivalent",2006,33754,91,189,446,257,-77,34,-111,-21
"28780",NA,NA,"Kingsville, TX","Micropolitan Statistical Area",2006,30903,-216,292,520,228,-494,69,-563,-14
"28780",NA,48261,"Kenedy County, TX","County or equivalent",2006,405,-28,-6,2,8,-22,0,-22,0
"28780",NA,48273,"Kleberg County, TX","County or equivalent",2006,30498,-188,298,518,220,-472,69,-541,-14
"28820",NA,NA,"Kinston, NC","Micropolitan Statistical Area",2006,57009,-321,163,841,678,-461,70,-531,-23
"28820",NA,37107,"Lenoir County, NC","County or equivalent",2006,57009,-321,163,841,678,-461,70,-531,-23
"28860",NA,NA,"Kirksville, MO","Micropolitan Statistical Area",2006,28688,36,42,313,271,7,23,-16,-13
"28860",NA,29001,"Adair County, MO","County or equivalent",2006,24620,72,49,269,220,34,22,12,-11
"28860",NA,29197,"Schuyler County, MO","County or equivalent",2006,4068,-36,-7,44,51,-27,1,-28,-2
"28900",NA,NA,"Klamath Falls, OR","Micropolitan Statistical Area",2006,65896,531,79,785,706,483,64,419,-31
"28900",NA,41035,"Klamath County, OR","County or equivalent",2006,65896,531,79,785,706,483,64,419,-31
"28980",NA,NA,"Kodiak, AK","Micropolitan Statistical Area",2006,12992,28,149,214,65,-115,94,-209,-6
"28980",NA,2150,"Kodiak Island Borough, AK","County or equivalent",2006,12992,28,149,214,65,-115,94,-209,-6
"29060",NA,NA,"Laconia, NH","Micropolitan Statistical Area",2006,60962,-13,22,603,581,-8,43,-51,-27
"29060",NA,33001,"Belknap County, NH","County or equivalent",2006,60962,-13,22,603,581,-8,43,-51,-27
"29220",NA,NA,"La Follette, TN","Micropolitan Statistical Area",2006,40544,138,39,484,445,117,26,91,-18
"29220",NA,47013,"Campbell County, TN","County or equivalent",2006,40544,138,39,484,445,117,26,91,-18
"29260",NA,NA,"La Grande, OR","Micropolitan Statistical Area",2006,24436,-13,89,324,235,-91,28,-119,-11
"29260",NA,41061,"Union County, OR","County or equivalent",2006,24436,-13,89,324,235,-91,28,-119,-11
"29300",NA,NA,"LaGrange, GA","Micropolitan Statistical Area",2006,62641,438,337,961,624,131,67,64,-30
"29300",NA,13285,"Troup County, GA","County or equivalent",2006,62641,438,337,961,624,131,67,64,-30
"29380",NA,NA,"Lake City, FL","Micropolitan Statistical Area",2006,66746,2858,220,864,644,2681,36,2645,-43
"29380",NA,12023,"Columbia County, FL","County or equivalent",2006,66746,2858,220,864,644,2681,36,2645,-43
"29500",NA,NA,"Lamesa, TX","Micropolitan Statistical Area",2006,13942,-91,74,215,141,-158,21,-179,-7
"29500",NA,48115,"Dawson County, TX","County or equivalent",2006,13942,-91,74,215,141,-158,21,-179,-7
"29580",NA,NA,"Lancaster, SC","Micropolitan Statistical Area",2006,71723,1957,296,865,569,168,53,115,1493
"29580",NA,45057,"Lancaster County, SC","County or equivalent",2006,71723,1957,296,865,569,168,53,115,1493
"29660",NA,NA,"Laramie, WY","Micropolitan Statistical Area",2006,32613,106,242,413,171,-121,59,-180,-15
"29660",NA,56001,"Albany County, WY","County or equivalent",2006,32613,106,242,413,171,-121,59,-180,-15
"29780",NA,NA,"Las Vegas, NM","Micropolitan Statistical Area",2006,28783,-270,113,369,256,-371,8,-379,-12
"29780",NA,35047,"San Miguel County, NM","County or equivalent",2006,28783,-270,113,369,256,-371,8,-379,-12
"29860",NA,NA,"Laurel, MS","Micropolitan Statistical Area",2006,84067,525,417,1337,920,148,129,19,-40
"29860",NA,28061,"Jasper County, MS","County or equivalent",2006,17960,129,53,247,194,85,4,81,-9
"29860",NA,28067,"Jones County, MS","County or equivalent",2006,66107,396,364,1090,726,63,125,-62,-31
"29900",NA,NA,"Laurinburg, NC","Micropolitan Statistical Area",2006,36253,-159,128,501,373,-272,24,-296,-15
"29900",NA,37165,"Scotland County, NC","County or equivalent",2006,36253,-159,128,501,373,-272,24,-296,-15
"29980",NA,NA,"Lawrenceburg, TN","Micropolitan Statistical Area",2006,40593,-62,64,550,486,-109,13,-122,-17
"29980",NA,47099,"Lawrence County, TN","County or equivalent",2006,40593,-62,64,550,486,-109,13,-122,-17
"30060",NA,NA,"Lebanon, MO","Micropolitan Statistical Area",2006,34887,675,180,526,346,512,7,505,-17
"30060",NA,29105,"Laclede County, MO","County or equivalent",2006,34887,675,180,526,346,512,7,505,-17
"30100",NA,NA,"Lebanon, NH-VT","Micropolitan Statistical Area",2006,171230,304,188,1618,1430,198,122,76,-82
"30100",NA,33009,"Grafton County, NH","County or equivalent",2006,85186,515,165,809,644,392,88,304,-42
"30100",NA,50017,"Orange County, VT","County or equivalent",2006,29056,101,52,282,230,62,2,60,-13
"30100",NA,50027,"Windsor County, VT","County or equivalent",2006,56988,-312,-29,527,556,-256,32,-288,-27
"30220",NA,NA,"Levelland, TX","Micropolitan Statistical Area",2006,22340,-268,130,348,218,-389,20,-409,-9
"30220",NA,48219,"Hockley County, TX","County or equivalent",2006,22340,-268,130,348,218,-389,20,-409,-9
"30260",NA,NA,"Lewisburg, PA","Micropolitan Statistical Area",2006,43510,748,52,417,365,719,18,701,-23
"30260",NA,42119,"Union County, PA","County or equivalent",2006,43510,748,52,417,365,719,18,701,-23
"30280",NA,NA,"Lewisburg, TN","Micropolitan Statistical Area",2006,28570,548,128,395,267,436,31,405,-16
"30280",NA,47117,"Marshall County, TN","County or equivalent",2006,28570,548,128,395,267,436,31,405,-16
"30380",NA,NA,"Lewistown, PA","Micropolitan Statistical Area",2006,45974,4,91,596,505,-66,3,-69,-21
"30380",NA,42087,"Mifflin County, PA","County or equivalent",2006,45974,4,91,596,505,-66,3,-69,-21
"30420",NA,NA,"Lexington, NE","Micropolitan Statistical Area",2006,26511,213,146,391,245,81,165,-84,-14
"30420",NA,31047,"Dawson County, NE","County or equivalent",2006,24556,262,146,374,228,129,165,-36,-13
"30420",NA,31073,"Gosper County, NE","County or equivalent",2006,1955,-49,0,17,17,-48,0,-48,-1
"30500",NA,NA,"Lexington Park, MD","Micropolitan Statistical Area",2006,98510,1625,739,1406,667,937,123,814,-51
"30500",NA,24037,"St. Mary's County, MD","County or equivalent",2006,98510,1625,739,1406,667,937,123,814,-51
"30580",NA,NA,"Liberal, KS","Micropolitan Statistical Area",2006,22612,51,353,495,142,-293,288,-581,-9
"30580",NA,20175,"Seward County, KS","County or equivalent",2006,22612,51,353,495,142,-293,288,-581,-9
"30660",NA,NA,"Lincoln, IL","Micropolitan Statistical Area",2006,29915,-298,-27,322,349,-257,7,-264,-14
"30660",NA,17107,"Logan County, IL","County or equivalent",2006,29915,-298,-27,322,349,-257,7,-264,-14
"30740",NA,NA,"Lincolnton, NC","Micropolitan Statistical Area",2006,70964,1965,317,918,601,1686,229,1457,-38
"30740",NA,37109,"Lincoln County, NC","County or equivalent",2006,70964,1965,317,918,601,1686,229,1457,-38
"30820",NA,NA,"Lock Haven, PA","Micropolitan Statistical Area",2006,37261,75,52,453,401,41,13,28,-18
"30820",NA,42035,"Clinton County, PA","County or equivalent",2006,37261,75,52,453,401,41,13,28,-18
"30900",NA,NA,"Logansport, IN","Micropolitan Statistical Area",2006,39296,-347,182,585,403,-512,76,-588,-17
"30900",NA,18017,"Cass County, IN","County or equivalent",2006,39296,-347,182,585,403,-512,76,-588,-17
"30940",NA,NA,"London, KY","Micropolitan Statistical Area",2006,56730,705,280,793,513,452,26,426,-27
"30940",NA,21125,"Laurel County, KY","County or equivalent",2006,56730,705,280,793,513,452,26,426,-27
"31060",NA,NA,"Los Alamos, NM","Micropolitan Statistical Area",2006,18673,130,94,198,104,46,55,-9,-10
"31060",NA,35028,"Los Alamos County, NM","County or equivalent",2006,18673,130,94,198,104,46,55,-9,-10
"31260",NA,NA,"Lufkin, TX","Micropolitan Statistical Area",2006,82107,1042,606,1386,780,478,142,336,-42
"31260",NA,48005,"Angelina County, TX","County or equivalent",2006,82107,1042,606,1386,780,478,142,336,-42
"31300",NA,NA,"Lumberton, NC","Micropolitan Statistical Area",2006,126698,714,877,2069,1192,-102,395,-497,-61
"31300",NA,37155,"Robeson County, NC","County or equivalent",2006,126698,714,877,2069,1192,-102,395,-497,-61
"31380",NA,NA,"Macomb, IL","Micropolitan Statistical Area",2006,32939,42,-4,292,296,61,60,1,-15
"31380",NA,17109,"McDonough County, IL","County or equivalent",2006,32939,42,-4,292,296,61,60,1,-15
"31500",NA,NA,"Madison, IN","Micropolitan Statistical Area",2006,32552,277,59,348,289,234,8,226,-16
"31500",NA,18077,"Jefferson County, IN","County or equivalent",2006,32552,277,59,348,289,234,8,226,-16
"31580",NA,NA,"Madisonville, KY","Micropolitan Statistical Area",2006,46280,67,22,616,594,67,12,55,-22
"31580",NA,21107,"Hopkins County, KY","County or equivalent",2006,46280,67,22,616,594,67,12,55,-22
"31620",NA,NA,"Magnolia, AR","Micropolitan Statistical Area",2006,24595,14,16,299,283,10,11,-1,-12
"31620",NA,5027,"Columbia County, AR","County or equivalent",2006,24595,14,16,299,283,10,11,-1,-12
"31660",NA,NA,"Malone, NY","Micropolitan Statistical Area",2006,50350,20,117,528,411,-74,8,-82,-23
"31660",NA,36033,"Franklin County, NY","County or equivalent",2006,50350,20,117,528,411,-74,8,-82,-23
"31740",NA,NA,"Manhattan, KS","Micropolitan Statistical Area",2006,116946,2536,1172,1838,666,759,513,246,605
"31740",NA,20061,"Geary County, KS","County or equivalent",2006,29011,744,345,542,197,-215,141,-356,614
"31740",NA,20149,"Pottawatomie County, KS","County or equivalent",2006,18887,92,112,284,172,-11,2,-13,-9
"31740",NA,20161,"Riley County, KS","County or equivalent",2006,69048,1700,715,1012,297,985,370,615,0
"31820",NA,NA,"Manitowoc, WI","Micropolitan Statistical Area",2006,80849,-171,97,827,730,-230,75,-305,-38
"31820",NA,55071,"Manitowoc County, WI","County or equivalent",2006,80849,-171,97,827,730,-230,75,-305,-38
"31860",NA,NA,"Mankato-North Mankato, MN","Micropolitan Statistical Area",2006,90764,1443,529,1139,610,961,96,865,-47
"31860",NA,27013,"Blue Earth County, MN","County or equivalent",2006,59328,920,350,760,410,599,66,533,-29
"31860",NA,27103,"Nicollet County, MN","County or equivalent",2006,31436,523,179,379,200,362,30,332,-18
"31940",NA,NA,"Marinette, WI-MI","Micropolitan Statistical Area",2006,66919,-639,-151,639,790,-461,19,-480,-27
"31940",NA,26109,"Menominee County, MI","County or equivalent",2006,24336,-256,-39,223,262,-207,6,-213,-10
"31940",NA,55075,"Marinette County, WI","County or equivalent",2006,42583,-383,-112,416,528,-254,13,-267,-17
"31980",NA,NA,"Marion, IN","Micropolitan Statistical Area",2006,69441,-529,100,865,765,-598,13,-611,-31
"31980",NA,18053,"Grant County, IN","County or equivalent",2006,69441,-529,100,865,765,-598,13,-611,-31
"32020",NA,NA,"Marion, OH","Micropolitan Statistical Area",2006,65520,-196,102,780,678,-270,15,-285,-28
"32020",NA,39101,"Marion County, OH","County or equivalent",2006,65520,-196,102,780,678,-270,15,-285,-28
"32060",NA,NA,"Marion-Herrin, IL","Micropolitan Statistical Area",2006,63512,-6,32,740,708,-4,16,-20,-34
"32060",NA,17199,"Williamson County, IL","County or equivalent",2006,63512,-6,32,740,708,-4,16,-20,-34
"32100",NA,NA,"Marquette, MI","Micropolitan Statistical Area",2006,65240,175,9,625,616,198,20,178,-32
"32100",NA,26103,"Marquette County, MI","County or equivalent",2006,65240,175,9,625,616,198,20,178,-32
"32140",NA,NA,"Marshall, MN","Micropolitan Statistical Area",2006,24705,87,115,321,206,-16,44,-60,-12
"32140",NA,27083,"Lyon County, MN","County or equivalent",2006,24705,87,115,321,206,-16,44,-60,-12
"32180",NA,NA,"Marshall, MO","Micropolitan Statistical Area",2006,22695,-152,25,299,274,-167,39,-206,-10
"32180",NA,29195,"Saline County, MO","County or equivalent",2006,22695,-152,25,299,274,-167,39,-206,-10
"32220",NA,NA,"Marshall, TX","Micropolitan Statistical Area",2006,63204,803,248,849,601,587,80,507,-32
"32220",NA,48203,"Harrison County, TX","County or equivalent",2006,63204,803,248,849,601,587,80,507,-32
"32260",NA,NA,"Marshalltown, IA","Micropolitan Statistical Area",2006,38934,-132,140,619,479,-254,118,-372,-18
"32260",NA,19127,"Marshall County, IA","County or equivalent",2006,38934,-132,140,619,479,-254,118,-372,-18
"32270",NA,NA,"Marshfield-Wisconsin Rapids, WI","Micropolitan Statistical Area",2006,73989,-456,146,856,710,-570,53,-623,-32
"32270",NA,55141,"Wood County, WI","County or equivalent",2006,73989,-456,146,856,710,-570,53,-623,-32
"32280",NA,NA,"Martin, TN","Micropolitan Statistical Area",2006,33267,-238,-38,358,396,-187,41,-228,-13
"32280",NA,47183,"Weakley County, TN","County or equivalent",2006,33267,-238,-38,358,396,-187,41,-228,-13
"32300",NA,NA,"Martinsville, VA","Micropolitan Statistical Area",2006,70270,-190,-106,786,892,-50,166,-216,-34
"32300",NA,51089,"Henry County, VA","County or equivalent",2006,55583,-134,18,666,648,-126,128,-254,-26
"32300",NA,51690,"Martinsville city, VA","County or equivalent",2006,14687,-56,-124,120,244,76,38,38,-8
"32340",NA,NA,"Maryville, MO","Micropolitan Statistical Area",2006,22000,-31,52,258,206,-73,15,-88,-10
"32340",NA,29147,"Nodaway County, MO","County or equivalent",2006,22000,-31,52,258,206,-73,15,-88,-10
"32380",NA,NA,"Mason City, IA","Micropolitan Statistical Area",2006,51781,-281,-19,592,611,-237,20,-257,-25
"32380",NA,19033,"Cerro Gordo County, IA","County or equivalent",2006,44128,-213,-3,515,518,-189,19,-208,-21
"32380",NA,19195,"Worth County, IA","County or equivalent",2006,7653,-68,-16,77,93,-48,1,-49,-4
"32460",NA,NA,"Mayfield, KY","Micropolitan Statistical Area",2006,37252,24,24,443,419,19,55,-36,-19
"32460",NA,21083,"Graves County, KY","County or equivalent",2006,37252,24,24,443,419,19,55,-36,-19
"32500",NA,NA,"Maysville, KY","Micropolitan Statistical Area",2006,30965,317,87,412,325,244,13,231,-14
"32500",NA,21135,"Lewis County, KY","County or equivalent",2006,13848,84,56,180,124,34,1,33,-6
"32500",NA,21161,"Mason County, KY","County or equivalent",2006,17117,233,31,232,201,210,12,198,-8
"32540",NA,NA,"McAlester, OK","Micropolitan Statistical Area",2006,44328,388,-51,566,617,462,16,446,-23
"32540",NA,40121,"Pittsburg County, OK","County or equivalent",2006,44328,388,-51,566,617,462,16,446,-23
"32620",NA,NA,"McComb, MS","Micropolitan Statistical Area",2006,53379,1376,184,821,637,1223,4,1219,-31
"32620",NA,28005,"Amite County, MS","County or equivalent",2006,13459,110,18,157,139,99,1,98,-7
"32620",NA,28113,"Pike County, MS","County or equivalent",2006,39920,1266,166,664,498,1124,3,1121,-24
"32660",NA,NA,"McMinnville, TN","Micropolitan Statistical Area",2006,39399,203,93,555,462,129,101,28,-19
"32660",NA,47177,"Warren County, TN","County or equivalent",2006,39399,203,93,555,462,129,101,28,-19
"32700",NA,NA,"McPherson, KS","Micropolitan Statistical Area",2006,29032,-216,-22,347,369,-180,6,-186,-14
"32700",NA,20113,"McPherson County, KS","County or equivalent",2006,29032,-216,-22,347,369,-180,6,-186,-14
"32740",NA,NA,"Meadville, PA","Micropolitan Statistical Area",2006,88836,-199,129,1033,904,-289,8,-297,-39
"32740",NA,42039,"Crawford County, PA","County or equivalent",2006,88836,-199,129,1033,904,-289,8,-297,-39
"32860",NA,NA,"Menomonie, WI","Micropolitan Statistical Area",2006,42259,694,254,522,268,460,28,432,-20
"32860",NA,55033,"Dunn County, WI","County or equivalent",2006,42259,694,254,522,268,460,28,432,-20
"32940",NA,NA,"Meridian, MS","Micropolitan Statistical Area",2006,104419,-237,351,1540,1189,-539,58,-597,-49
"32940",NA,28023,"Clarke County, MS","County or equivalent",2006,17459,119,50,239,189,77,2,75,-8
"32940",NA,28069,"Kemper County, MS","County or equivalent",2006,10124,-80,41,131,90,-116,1,-117,-5
"32940",NA,28075,"Lauderdale County, MS","County or equivalent",2006,76836,-276,260,1170,910,-500,55,-555,-36
"32980",NA,NA,"Merrill, WI","Micropolitan Statistical Area",2006,29704,-177,-2,312,314,-162,15,-177,-13
"32980",NA,55069,"Lincoln County, WI","County or equivalent",2006,29704,-177,-2,312,314,-162,15,-177,-13
"33020",NA,NA,"Mexico, MO","Micropolitan Statistical Area",2006,25988,177,109,398,289,81,0,81,-13
"33020",NA,29007,"Audrain County, MO","County or equivalent",2006,25988,177,109,398,289,81,0,81,-13
"33060",NA,NA,"Miami, OK","Micropolitan Statistical Area",2006,32797,317,32,489,457,301,21,280,-16
"33060",NA,40115,"Ottawa County, OK","County or equivalent",2006,32797,317,32,489,457,301,21,280,-16
"33180",NA,NA,"Middlesborough, KY","Micropolitan Statistical Area",2006,29107,-118,-9,358,367,-96,13,-109,-13
"33180",NA,21013,"Bell County, KY","County or equivalent",2006,29107,-118,-9,358,367,-96,13,-109,-13
"33220",NA,NA,"Midland, MI","Micropolitan Statistical Area",2006,82836,-329,256,887,631,-549,117,-666,-36
"33220",NA,26111,"Midland County, MI","County or equivalent",2006,82836,-329,256,887,631,-549,117,-666,-36
"33300",NA,NA,"Milledgeville, GA","Micropolitan Statistical Area",2006,55014,35,151,654,503,-88,22,-110,-28
"33300",NA,13009,"Baldwin County, GA","County or equivalent",2006,45591,59,139,537,398,-58,22,-80,-22
"33300",NA,13141,"Hancock County, GA","County or equivalent",2006,9423,-24,12,117,105,-30,0,-30,-6
"33380",NA,NA,"Minden, LA","Micropolitan Statistical Area",2006,40922,79,-53,492,545,151,9,142,-19
"33380",NA,22119,"Webster Parish, LA","County or equivalent",2006,40922,79,-53,492,545,151,9,142,-19
"33420",NA,NA,"Mineral Wells, TX","Micropolitan Statistical Area",2006,27510,274,112,428,316,176,38,138,-14
"33420",NA,48363,"Palo Pinto County, TX","County or equivalent",2006,27510,274,112,428,316,176,38,138,-14
"33500",NA,NA,"Minot, ND","Micropolitan Statistical Area",2006,63763,-576,422,1022,600,-970,154,-1124,-28
"33500",NA,38049,"McHenry County, ND","County or equivalent",2006,5363,-78,-32,44,76,-42,1,-43,-4
"33500",NA,38075,"Renville County, ND","County or equivalent",2006,2372,-30,0,20,20,-29,1,-30,-1
"33500",NA,38101,"Ward County, ND","County or equivalent",2006,56028,-468,454,958,504,-899,152,-1051,-23
"33580",NA,NA,"Mitchell, SD","Micropolitan Statistical Area",2006,22610,96,143,335,192,-37,11,-48,-10
"33580",NA,46035,"Davison County, SD","County or equivalent",2006,19039,178,110,281,171,77,10,67,-9
"33580",NA,46061,"Hanson County, SD","County or equivalent",2006,3571,-82,33,54,21,-114,1,-115,-1
"33620",NA,NA,"Moberly, MO","Micropolitan Statistical Area",2006,25494,63,49,332,283,25,19,6,-11
"33620",NA,29175,"Randolph County, MO","County or equivalent",2006,25494,63,49,332,283,25,19,6,-11
"33820",NA,NA,"Monroe, WI","Micropolitan Statistical Area",2006,35340,543,114,429,315,449,10,439,-20
"33820",NA,55045,"Green County, WI","County or equivalent",2006,35340,543,114,429,315,449,10,439,-20
"33940",NA,NA,"Montrose, CO","Micropolitan Statistical Area",2006,38051,972,141,507,366,854,42,812,-23
"33940",NA,8085,"Montrose County, CO","County or equivalent",2006,38051,972,141,507,366,854,42,812,-23
"33980",NA,NA,"Morehead City, NC","Micropolitan Statistical Area",2006,63202,797,-13,669,682,813,51,762,-3
"33980",NA,37031,"Carteret County, NC","County or equivalent",2006,63202,797,-13,669,682,813,51,762,-3
"34020",NA,NA,"Morgan City, LA","Micropolitan Statistical Area",2006,51614,759,185,742,557,601,30,571,-27
"34020",NA,22101,"St. Mary Parish, LA","County or equivalent",2006,51614,759,185,742,557,601,30,571,-27
"34140",NA,NA,"Moscow, ID","Micropolitan Statistical Area",2006,36077,127,261,436,175,-117,64,-181,-17
"34140",NA,16057,"Latah County, ID","County or equivalent",2006,36077,127,261,436,175,-117,64,-181,-17
"34180",NA,NA,"Moses Lake, WA","Micropolitan Statistical Area",2006,80845,1314,967,1536,569,389,569,-180,-42
"34180",NA,53025,"Grant County, WA","County or equivalent",2006,80845,1314,967,1536,569,389,569,-180,-42
"34220",NA,NA,"Moultrie, GA","Micropolitan Statistical Area",2006,44078,755,265,747,482,513,198,315,-23
"34220",NA,13071,"Colquitt County, GA","County or equivalent",2006,44078,755,265,747,482,513,198,315,-23
"34260",NA,NA,"Mountain Home, AR","Micropolitan Statistical Area",2006,41099,851,-227,411,638,1103,1,1102,-25
"34260",NA,5005,"Baxter County, AR","County or equivalent",2006,41099,851,-227,411,638,1103,1,1102,-25
"34300",NA,NA,"Mountain Home, ID","Micropolitan Statistical Area",2006,28320,-270,385,542,157,-645,154,-799,-10
"34300",NA,16039,"Elmore County, ID","County or equivalent",2006,28320,-270,385,542,157,-645,154,-799,-10
"34340",NA,NA,"Mount Airy, NC","Micropolitan Statistical Area",2006,71979,67,54,869,815,46,180,-134,-33
"34340",NA,37171,"Surry County, NC","County or equivalent",2006,71979,67,54,869,815,46,180,-134,-33
"34380",NA,NA,"Mount Pleasant, MI","Micropolitan Statistical Area",2006,66697,590,350,778,428,273,75,198,-33
"34380",NA,26073,"Isabella County, MI","County or equivalent",2006,66697,590,350,778,428,273,75,198,-33
"34420",NA,NA,"Mount Pleasant, TX","Micropolitan Statistical Area",2006,28625,598,332,584,252,283,187,96,-17
"34420",NA,48449,"Titus County, TX","County or equivalent",2006,28625,598,332,584,252,283,187,96,-17
"34460",NA,NA,"Mount Sterling, KY","Micropolitan Statistical Area",2006,43166,643,158,571,413,507,4,503,-22
"34460",NA,21011,"Bath County, KY","County or equivalent",2006,11635,70,26,158,132,51,1,50,-7
"34460",NA,21165,"Menifee County, KY","County or equivalent",2006,6749,6,12,76,64,-3,0,-3,-3
"34460",NA,21173,"Montgomery County, KY","County or equivalent",2006,24782,567,120,337,217,459,3,456,-12
"34500",NA,NA,"Mount Vernon, IL","Micropolitan Statistical Area",2006,48427,23,42,585,543,4,10,-6,-23
"34500",NA,17065,"Hamilton County, IL","County or equivalent",2006,8298,17,-22,85,107,44,0,44,-5
"34500",NA,17081,"Jefferson County, IL","County or equivalent",2006,40129,6,64,500,436,-40,10,-50,-18
"34540",NA,NA,"Mount Vernon, OH","Micropolitan Statistical Area",2006,58368,359,179,728,549,208,11,197,-28
"34540",NA,39083,"Knox County, OH","County or equivalent",2006,58368,359,179,728,549,208,11,197,-28
"34660",NA,NA,"Murray, KY","Micropolitan Statistical Area",2006,35949,501,24,365,341,495,59,436,-18
"34660",NA,21035,"Calloway County, KY","County or equivalent",2006,35949,501,24,365,341,495,59,436,-18
"34700",NA,NA,"Muscatine, IA","Micropolitan Statistical Area",2006,53956,213,292,731,439,-51,91,-142,-28
"34700",NA,19115,"Louisa County, IA","County or equivalent",2006,11766,-9,40,143,103,-43,24,-67,-6
"34700",NA,19139,"Muscatine County, IA","County or equivalent",2006,42190,222,252,588,336,-8,67,-75,-22
"34780",NA,NA,"Muskogee, OK","Micropolitan Statistical Area",2006,70611,400,175,991,816,262,63,199,-37
"34780",NA,40101,"Muskogee County, OK","County or equivalent",2006,70611,400,175,991,816,262,63,199,-37
"34860",NA,NA,"Nacogdoches, TX","Micropolitan Statistical Area",2006,61624,477,382,935,553,125,168,-43,-30
"34860",NA,48347,"Nacogdoches County, TX","County or equivalent",2006,61624,477,382,935,553,125,168,-43,-30
"35020",NA,NA,"Natchez, MS-LA","Micropolitan Statistical Area",2006,51355,685,76,751,675,638,10,628,-29
"35020",NA,22029,"Concordia Parish, LA","County or equivalent",2006,19193,266,34,291,257,241,2,239,-9
"35020",NA,28001,"Adams County, MS","County or equivalent",2006,32162,419,42,460,418,397,8,389,-20
"35060",NA,NA,"Natchitoches, LA","Micropolitan Statistical Area",2006,39412,634,222,605,383,433,27,406,-21
"35060",NA,22069,"Natchitoches Parish, LA","County or equivalent",2006,39412,634,222,605,383,433,27,406,-21
"35100",NA,NA,"New Bern, NC","Micropolitan Statistical Area",2006,118648,1029,672,1809,1137,369,311,58,-12
"35100",NA,37049,"Craven County, NC","County or equivalent",2006,96107,1154,689,1592,903,465,296,169,0
"35100",NA,37103,"Jones County, NC","County or equivalent",2006,10012,-65,9,106,97,-68,9,-77,-6
"35100",NA,37137,"Pamlico County, NC","County or equivalent",2006,12529,-60,-26,111,137,-28,6,-34,-6
"35140",NA,NA,"Newberry, SC","Micropolitan Statistical Area",2006,37298,389,132,519,387,275,105,170,-18
"35140",NA,45071,"Newberry County, SC","County or equivalent",2006,37298,389,132,519,387,275,105,170,-18
"35220",NA,NA,"New Castle, IN","Micropolitan Statistical Area",2006,47430,147,-36,541,577,205,4,201,-22
"35220",NA,18065,"Henry County, IN","County or equivalent",2006,47430,147,-36,541,577,205,4,201,-22
"35260",NA,NA,"New Castle, PA","Micropolitan Statistical Area",2006,91246,-702,-154,925,1079,-507,16,-523,-41
"35260",NA,42073,"Lawrence County, PA","County or equivalent",2006,91246,-702,-154,925,1079,-507,16,-523,-41
"35340",NA,NA,"New Iberia, LA","Micropolitan Statistical Area",2006,74615,1017,422,1116,694,637,34,603,-42
"35340",NA,22045,"Iberia Parish, LA","County or equivalent",2006,74615,1017,422,1116,694,637,34,603,-42
"35420",NA,NA,"New Philadelphia-Dover, OH","Micropolitan Statistical Area",2006,91085,-224,253,1155,902,-436,25,-461,-41
"35420",NA,39157,"Tuscarawas County, OH","County or equivalent",2006,91085,-224,253,1155,902,-436,25,-461,-41
"35460",NA,NA,"Newport, TN","Micropolitan Statistical Area",2006,35003,291,-17,420,437,326,7,319,-18
"35460",NA,47029,"Cocke County, TN","County or equivalent",2006,35003,291,-17,420,437,326,7,319,-18
"35500",NA,NA,"Newton, IA","Micropolitan Statistical Area",2006,36816,-212,66,450,384,-262,21,-283,-16
"35500",NA,19099,"Jasper County, IA","County or equivalent",2006,36816,-212,66,450,384,-262,21,-283,-16
"35580",NA,NA,"New Ulm, MN","Micropolitan Statistical Area",2006,26069,-20,33,307,274,-40,6,-46,-13
"35580",NA,27015,"Brown County, MN","County or equivalent",2006,26069,-20,33,307,274,-40,6,-46,-13
"35700",NA,NA,"Nogales, AZ","Micropolitan Statistical Area",2006,41838,841,533,794,261,331,223,108,-23
"35700",NA,4023,"Santa Cruz County, AZ","County or equivalent",2006,41838,841,533,794,261,331,223,108,-23
"35740",NA,NA,"Norfolk, NE","Micropolitan Statistical Area",2006,48987,-312,254,715,461,-543,71,-614,-23
"35740",NA,31119,"Madison County, NE","County or equivalent",2006,35168,-224,198,542,344,-406,64,-470,-16
"35740",NA,31139,"Pierce County, NE","County or equivalent",2006,7366,-98,24,97,73,-118,1,-119,-4
"35740",NA,31167,"Stanton County, NE","County or equivalent",2006,6453,10,32,76,44,-19,6,-25,-3
"35820",NA,NA,"North Platte, NE","Micropolitan Statistical Area",2006,36673,275,182,532,350,112,18,94,-19
"35820",NA,31111,"Lincoln County, NE","County or equivalent",2006,35443,279,173,512,339,125,18,107,-19
"35820",NA,31113,"Logan County, NE","County or equivalent",2006,747,8,7,14,7,1,0,1,0
"35820",NA,31117,"McPherson County, NE","County or equivalent",2006,483,-12,2,6,4,-14,0,-14,0
"35860",NA,NA,"North Vernon, IN","Micropolitan Statistical Area",2006,27931,-129,141,361,220,-258,7,-265,-12
"35860",NA,18079,"Jennings County, IN","County or equivalent",2006,27931,-129,141,361,220,-258,7,-265,-12
"35900",NA,NA,"North Wilkesboro, NC","Micropolitan Statistical Area",2006,66470,26,117,793,676,-59,139,-198,-32
"35900",NA,37193,"Wilkes County, NC","County or equivalent",2006,66470,26,117,793,676,-59,139,-198,-32
"35940",NA,NA,"Norwalk, OH","Micropolitan Statistical Area",2006,59787,-110,243,834,591,-327,48,-375,-26
"35940",NA,39077,"Huron County, OH","County or equivalent",2006,59787,-110,243,834,591,-327,48,-375,-26
"36020",NA,NA,"Oak Harbor, WA","Micropolitan Statistical Area",2006,80747,1144,367,963,596,834,218,616,-57
"36020",NA,53029,"Island County, WA","County or equivalent",2006,80747,1144,367,963,596,834,218,616,-57
"36060",NA,NA,"Oak Hill, WV","Micropolitan Statistical Area",2006,46297,-9,-13,581,594,25,15,10,-21
"36060",NA,54019,"Fayette County, WV","County or equivalent",2006,46297,-9,-13,581,594,25,15,10,-21
"36180",NA,NA,"Ocean Pines, MD","Micropolitan Statistical Area",2006,49069,284,-83,438,521,391,52,339,-24
"36180",NA,24047,"Worcester County, MD","County or equivalent",2006,49069,284,-83,438,521,391,52,339,-24
"36300",NA,NA,"Ogdensburg-Massena, NY","Micropolitan Statistical Area",2006,109906,-170,238,1258,1020,-359,74,-433,-49
"36300",NA,36089,"St. Lawrence County, NY","County or equivalent",2006,109906,-170,238,1258,1020,-359,74,-433,-49
"36340",NA,NA,"Oil City, PA","Micropolitan Statistical Area",2006,55143,-373,22,624,602,-370,12,-382,-25
"36340",NA,42121,"Venango County, PA","County or equivalent",2006,55143,-373,22,624,602,-370,12,-382,-25
"36380",NA,NA,"Okeechobee, FL","Micropolitan Statistical Area",2006,39843,604,194,598,404,431,165,266,-21
"36380",NA,12093,"Okeechobee County, FL","County or equivalent",2006,39843,604,194,598,404,431,165,266,-21
"36460",NA,NA,"Olean, NY","Micropolitan Statistical Area",2006,80662,-765,169,944,775,-899,12,-911,-35
"36460",NA,36009,"Cattaraugus County, NY","County or equivalent",2006,80662,-765,169,944,775,-899,12,-911,-35
"36580",NA,NA,"Oneonta, NY","Micropolitan Statistical Area",2006,62345,-154,-80,507,587,-45,15,-60,-29
"36580",NA,36077,"Otsego County, NY","County or equivalent",2006,62345,-154,-80,507,587,-45,15,-60,-29
"36620",NA,NA,"Ontario, OR-ID","Micropolitan Statistical Area",2006,52969,326,342,765,423,11,106,-95,-27
"36620",NA,16075,"Payette County, ID","County or equivalent",2006,22091,416,152,320,168,277,16,261,-13
"36620",NA,41045,"Malheur County, OR","County or equivalent",2006,30878,-90,190,445,255,-266,90,-356,-14
"36660",NA,NA,"Opelousas-Eunice, LA","Micropolitan Statistical Area",2006,90739,2104,492,1428,936,1666,14,1652,-54
"36660",NA,22097,"St. Landry Parish, LA","County or equivalent",2006,90739,2104,492,1428,936,1666,14,1652,-54
"36700",NA,NA,"Orangeburg, SC","Micropolitan Statistical Area",2006,89726,-978,360,1358,998,-1304,26,-1330,-34
"36700",NA,45075,"Orangeburg County, SC","County or equivalent",2006,89726,-978,360,1358,998,-1304,26,-1330,-34
"36820",NA,NA,"Oskaloosa, IA","Micropolitan Statistical Area",2006,22153,-80,90,309,219,-160,17,-177,-10
"36820",NA,19123,"Mahaska County, IA","County or equivalent",2006,22153,-80,90,309,219,-160,17,-177,-10
"36860",NA,NA,"Ottawa-Streator, IL","Micropolitan Statistical Area",2006,152476,510,3,1800,1797,579,104,475,-72
"36860",NA,17011,"Bureau County, IL","County or equivalent",2006,34932,143,33,406,373,126,15,111,-16
"36860",NA,17099,"LaSalle County, IL","County or equivalent",2006,111625,428,-39,1330,1369,520,87,433,-53
"36860",NA,17155,"Putnam County, IL","County or equivalent",2006,5919,-61,9,64,55,-67,2,-69,-3
"36900",NA,NA,"Ottumwa, IA","Micropolitan Statistical Area",2006,35718,-67,70,489,419,-120,33,-153,-17
"36900",NA,19179,"Wapello County, IA","County or equivalent",2006,35718,-67,70,489,419,-120,33,-153,-17
"36940",NA,NA,"Owatonna, MN","Micropolitan Statistical Area",2006,35942,460,328,551,223,151,75,76,-19
"36940",NA,27147,"Steele County, MN","County or equivalent",2006,35942,460,328,551,223,151,75,76,-19
"37020",NA,NA,"Owosso, MI","Micropolitan Statistical Area",2006,72144,-117,252,854,602,-337,7,-344,-32
"37020",NA,26155,"Shiawassee County, MI","County or equivalent",2006,72144,-117,252,854,602,-337,7,-344,-32
"37060",NA,NA,"Oxford, MS","Micropolitan Statistical Area",2006,42716,1441,181,516,335,1284,54,1230,-24
"37060",NA,28071,"Lafayette County, MS","County or equivalent",2006,42716,1441,181,516,335,1284,54,1230,-24
"37140",NA,NA,"Paducah, KY-IL","Micropolitan Statistical Area",2006,97413,-144,-9,1185,1194,-88,14,-102,-47
"37140",NA,17127,"Massac County, IL","County or equivalent",2006,15088,-132,-14,188,202,-111,0,-111,-7
"37140",NA,21007,"Ballard County, KY","County or equivalent",2006,8208,-37,-56,79,135,23,1,22,-4
"37140",NA,21139,"Livingston County, KY","County or equivalent",2006,9646,-46,-2,99,101,-39,0,-39,-5
"37140",NA,21145,"McCracken County, KY","County or equivalent",2006,64471,71,63,819,756,39,13,26,-31
"37220",NA,NA,"Pahrump, NV","Micropolitan Statistical Area",2006,42269,2208,-135,441,576,2370,41,2329,-27
"37220",NA,32023,"Nye County, NV","County or equivalent",2006,42269,2208,-135,441,576,2370,41,2329,-27
"37260",NA,NA,"Palatka, FL","Micropolitan Statistical Area",2006,73314,698,127,1024,897,608,74,534,-37
"37260",NA,12107,"Putnam County, FL","County or equivalent",2006,73314,698,127,1024,897,608,74,534,-37
"37300",NA,NA,"Palestine, TX","Micropolitan Statistical Area",2006,56354,334,57,659,602,303,50,253,-26
"37300",NA,48001,"Anderson County, TX","County or equivalent",2006,56354,334,57,659,602,303,50,253,-26
"37420",NA,NA,"Pampa, TX","Micropolitan Statistical Area",2006,22510,330,54,361,307,287,41,246,-11
"37420",NA,48179,"Gray County, TX","County or equivalent",2006,21705,347,50,347,297,307,41,266,-10
"37420",NA,48393,"Roberts County, TX","County or equivalent",2006,805,-17,4,14,10,-20,0,-20,-1
"37500",NA,NA,"Paragould, AR","Micropolitan Statistical Area",2006,39892,763,173,555,382,610,10,600,-20
"37500",NA,5055,"Greene County, AR","County or equivalent",2006,39892,763,173,555,382,610,10,600,-20
"37540",NA,NA,"Paris, TN","Micropolitan Statistical Area",2006,31486,186,-67,395,462,268,12,256,-15
"37540",NA,47079,"Henry County, TN","County or equivalent",2006,31486,186,-67,395,462,268,12,256,-15
"37580",NA,NA,"Paris, TX","Micropolitan Statistical Area",2006,49054,-40,74,648,574,-92,61,-153,-22
"37580",NA,48277,"Lamar County, TX","County or equivalent",2006,49054,-40,74,648,574,-92,61,-153,-22
"37660",NA,NA,"Parsons, KS","Micropolitan Statistical Area",2006,21957,18,7,279,272,22,3,19,-11
"37660",NA,20099,"Labette County, KS","County or equivalent",2006,21957,18,7,279,272,22,3,19,-11
"37740",NA,NA,"Payson, AZ","Micropolitan Statistical Area",2006,51435,541,-25,653,678,591,38,553,-25
"37740",NA,4007,"Gila County, AZ","County or equivalent",2006,51435,541,-25,653,678,591,38,553,-25
"37780",NA,NA,"Pecos, TX","Micropolitan Statistical Area",2006,11120,-124,59,168,109,-178,21,-199,-5
"37780",NA,48389,"Reeves County, TX","County or equivalent",2006,11120,-124,59,168,109,-178,21,-199,-5
"37800",NA,NA,"Pella, IA","Micropolitan Statistical Area",2006,32728,407,131,434,303,293,7,286,-17
"37800",NA,19125,"Marion County, IA","County or equivalent",2006,32728,407,131,434,303,293,7,286,-17
"37820",NA,NA,"Pendleton-Hermiston, OR","Micropolitan Statistical Area",2006,84305,99,674,1249,575,-535,204,-739,-40
"37820",NA,41049,"Morrow County, OR","County or equivalent",2006,11311,23,90,151,61,-60,44,-104,-7
"37820",NA,41059,"Umatilla County, OR","County or equivalent",2006,72994,76,584,1098,514,-475,160,-635,-33
"37940",NA,NA,"Peru, IN","Micropolitan Statistical Area",2006,36932,152,153,472,319,18,5,13,-19
"37940",NA,18103,"Miami County, IN","County or equivalent",2006,36932,152,153,472,319,18,5,13,-19
"38020",NA,NA,"Phoenix Lake-Cedar Ridge, CA","Micropolitan Statistical Area",2006,56104,-151,-121,458,579,-3,17,-20,-27
"38020",NA,6109,"Tuolumne County, CA","County or equivalent",2006,56104,-151,-121,458,579,-3,17,-20,-27
"38100",NA,NA,"Picayune, MS","Micropolitan Statistical Area",2006,56237,4464,216,732,516,4297,12,4285,-49
"38100",NA,28109,"Pearl River County, MS","County or equivalent",2006,56237,4464,216,732,516,4297,12,4285,-49
"38180",NA,NA,"Pierre, SD","Micropolitan Statistical Area",2006,19503,23,73,255,182,-39,12,-51,-11
"38180",NA,46065,"Hughes County, SD","County or equivalent",2006,16753,29,58,216,158,-20,12,-32,-9
"38180",NA,46117,"Stanley County, SD","County or equivalent",2006,2750,-6,15,39,24,-19,0,-19,-2
"38200",NA,NA,"Pierre Part, LA","Micropolitan Statistical Area",2006,23015,179,56,250,194,135,6,129,-12
"38200",NA,22007,"Assumption Parish, LA","County or equivalent",2006,23015,179,56,250,194,135,6,129,-12
"38260",NA,NA,"Pittsburg, KS","Micropolitan Statistical Area",2006,38627,121,103,521,418,36,74,-38,-18
"38260",NA,20037,"Crawford County, KS","County or equivalent",2006,38627,121,103,521,418,36,74,-38,-18
"38380",NA,NA,"Plainview, TX","Micropolitan Statistical Area",2006,35722,25,278,603,325,-237,72,-309,-16
"38380",NA,48189,"Hale County, TX","County or equivalent",2006,35722,25,278,603,325,-237,72,-309,-16
"38420",NA,NA,"Platteville, WI","Micropolitan Statistical Area",2006,48733,-405,95,573,478,-480,10,-490,-20
"38420",NA,55043,"Grant County, WI","County or equivalent",2006,48733,-405,95,573,478,-480,10,-490,-20
"38460",NA,NA,"Plattsburgh, NY","Micropolitan Statistical Area",2006,81962,264,129,770,641,173,45,128,-38
"38460",NA,36019,"Clinton County, NY","County or equivalent",2006,81962,264,129,770,641,173,45,128,-38
"38500",NA,NA,"Plymouth, IN","Micropolitan Statistical Area",2006,46573,256,305,726,421,-27,119,-146,-22
"38500",NA,18099,"Marshall County, IN","County or equivalent",2006,46573,256,305,726,421,-27,119,-146,-22
"38580",NA,NA,"Point Pleasant, WV-OH","Micropolitan Statistical Area",2006,56385,-98,93,735,642,-165,4,-169,-26
"38580",NA,39053,"Gallia County, OH","County or equivalent",2006,30843,-79,103,424,321,-168,4,-172,-14
"38580",NA,54053,"Mason County, WV","County or equivalent",2006,25542,-19,-10,311,321,3,0,3,-12
"38620",NA,NA,"Ponca City, OK","Micropolitan Statistical Area",2006,45616,-426,178,705,527,-584,42,-626,-20
"38620",NA,40071,"Kay County, OK","County or equivalent",2006,45616,-426,178,705,527,-584,42,-626,-20
"38700",NA,NA,"Pontiac, IL","Micropolitan Statistical Area",2006,37924,-331,92,484,392,-405,14,-419,-18
"38700",NA,17105,"Livingston County, IL","County or equivalent",2006,37924,-331,92,484,392,-405,14,-419,-18
"38740",NA,NA,"Poplar Bluff, MO","Micropolitan Statistical Area",2006,41393,138,37,580,543,120,15,105,-19
"38740",NA,29023,"Butler County, MO","County or equivalent",2006,41393,138,37,580,543,120,15,105,-19
"38780",NA,NA,"Portales, NM","Micropolitan Statistical Area",2006,18878,104,132,307,175,-18,22,-40,-10
"38780",NA,35041,"Roosevelt County, NM","County or equivalent",2006,18878,104,132,307,175,-18,22,-40,-10
"38820",NA,NA,"Port Angeles, WA","Micropolitan Statistical Area",2006,69579,878,-202,650,852,1117,62,1055,-37
"38820",NA,53009,"Clallam County, WA","County or equivalent",2006,69579,878,-202,650,852,1117,62,1055,-37
"39020",NA,NA,"Portsmouth, OH","Micropolitan Statistical Area",2006,76177,-17,118,983,865,-99,14,-113,-36
"39020",NA,39145,"Scioto County, OH","County or equivalent",2006,76177,-17,118,983,865,-99,14,-113,-36
"39060",NA,NA,"Pottsville, PA","Micropolitan Statistical Area",2006,146951,839,-442,1544,1986,1350,21,1329,-69
"39060",NA,42107,"Schuylkill County, PA","County or equivalent",2006,146951,839,-442,1544,1986,1350,21,1329,-69
"39220",NA,NA,"Price, UT","Micropolitan Statistical Area",2006,19188,3,102,269,167,-90,10,-100,-9
"39220",NA,49007,"Carbon County, UT","County or equivalent",2006,19188,3,102,269,167,-90,10,-100,-9
"39260",NA,NA,"Prineville, OR","Micropolitan Statistical Area",2006,22499,814,33,241,208,794,24,770,-13
"39260",NA,41013,"Crook County, OR","County or equivalent",2006,22499,814,33,241,208,794,24,770,-13
"39420",NA,NA,"Pullman, WA","Micropolitan Statistical Area",2006,41219,-314,205,423,218,-502,191,-693,-17
"39420",NA,53075,"Whitman County, WA","County or equivalent",2006,41219,-314,205,423,218,-502,191,-693,-17
"39500",NA,NA,"Quincy, IL-MO","Micropolitan Statistical Area",2006,77003,161,-4,931,935,203,16,187,-38
"39500",NA,17001,"Adams County, IL","County or equivalent",2006,66924,139,17,817,800,154,16,138,-32
"39500",NA,29111,"Lewis County, MO","County or equivalent",2006,10079,22,-21,114,135,49,0,49,-6
"39700",NA,NA,"Raymondville, TX","Micropolitan Statistical Area",2006,20418,130,226,353,127,-85,43,-128,-11
"39700",NA,48489,"Willacy County, TX","County or equivalent",2006,20418,130,226,353,127,-85,43,-128,-11
"39780",NA,NA,"Red Bluff, CA","Micropolitan Statistical Area",2006,60408,773,238,843,605,567,80,487,-32
"39780",NA,6103,"Tehama County, CA","County or equivalent",2006,60408,773,238,843,605,567,80,487,-32
"39860",NA,NA,"Red Wing, MN","Micropolitan Statistical Area",2006,45426,169,195,581,386,-5,15,-20,-21
"39860",NA,27049,"Goodhue County, MN","County or equivalent",2006,45426,169,195,581,386,-5,15,-20,-21
"39940",NA,NA,"Rexburg, ID","Micropolitan Statistical Area",2006,48878,1502,975,1186,211,132,67,65,395
"39940",NA,16043,"Fremont County, ID","County or equivalent",2006,12382,112,130,223,93,-11,37,-48,-7
"39940",NA,16065,"Madison County, ID","County or equivalent",2006,36496,1390,845,963,118,143,30,113,402
"39980",NA,NA,"Richmond, IN","Micropolitan Statistical Area",2006,68515,-304,172,941,769,-447,39,-486,-29
"39980",NA,18177,"Wayne County, IN","County or equivalent",2006,68515,-304,172,941,769,-447,39,-486,-29
"40080",NA,NA,"Richmond-Berea, KY","Micropolitan Statistical Area",2006,96768,1560,580,1293,713,1030,47,983,-50
"40080",NA,21151,"Madison County, KY","County or equivalent",2006,80186,1535,565,1099,534,1012,46,966,-42
"40080",NA,21203,"Rockcastle County, KY","County or equivalent",2006,16582,25,15,194,179,18,1,17,-8
"40100",NA,NA,"Rio Grande City-Roma, TX","Micropolitan Statistical Area",2006,60437,979,1281,1557,276,-270,402,-672,-32
"40100",NA,48427,"Starr County, TX","County or equivalent",2006,60437,979,1281,1557,276,-270,402,-672,-32
"40180",NA,NA,"Riverton, WY","Micropolitan Statistical Area",2006,36770,497,233,594,361,283,6,277,-19
"40180",NA,56013,"Fremont County, WY","County or equivalent",2006,36770,497,233,594,361,283,6,277,-19
"40260",NA,NA,"Roanoke Rapids, NC","Micropolitan Statistical Area",2006,75997,-505,-30,917,947,-441,30,-471,-34
"40260",NA,37083,"Halifax County, NC","County or equivalent",2006,55169,-294,24,672,648,-293,25,-318,-25
"40260",NA,37131,"Northampton County, NC","County or equivalent",2006,20828,-211,-54,245,299,-148,5,-153,-9
"40300",NA,NA,"Rochelle, IL","Micropolitan Statistical Area",2006,54552,626,113,606,493,414,93,321,99
"40300",NA,17141,"Ogle County, IL","County or equivalent",2006,54552,626,113,606,493,414,93,321,99
"40460",NA,NA,"Rockingham, NC","Micropolitan Statistical Area",2006,45814,-170,114,654,540,-264,70,-334,-20
"40460",NA,37153,"Richmond County, NC","County or equivalent",2006,45814,-170,114,654,540,-264,70,-334,-20
"40500",NA,NA,"Rockland, ME","Micropolitan Statistical Area",2006,40805,-157,-13,390,403,-124,13,-137,-20
"40500",NA,23013,"Knox County, ME","County or equivalent",2006,40805,-157,-13,390,403,-124,13,-137,-20
"40540",NA,NA,"Rock Springs, WY","Micropolitan Statistical Area",2006,38001,693,411,661,250,301,15,286,-19
"40540",NA,56037,"Sweetwater County, WY","County or equivalent",2006,38001,693,411,661,250,301,15,286,-19
"40620",NA,NA,"Rolla, MO","Micropolitan Statistical Area",2006,42400,436,233,613,380,224,97,127,-21
"40620",NA,29161,"Phelps County, MO","County or equivalent",2006,42400,436,233,613,380,224,97,127,-21
"40700",NA,NA,"Roseburg, OR","Micropolitan Statistical Area",2006,103777,899,-74,1145,1219,1027,37,990,-54
"40700",NA,41019,"Douglas County, OR","County or equivalent",2006,103777,899,-74,1145,1219,1027,37,990,-54
"40740",NA,NA,"Roswell, NM","Micropolitan Statistical Area",2006,61498,309,338,978,640,1,130,-129,-30
"40740",NA,35005,"Chaves County, NM","County or equivalent",2006,61498,309,338,978,640,1,130,-129,-30
"40760",NA,NA,"Ruidoso, NM","Micropolitan Statistical Area",2006,20802,164,38,195,157,137,27,110,-11
"40760",NA,35027,"Lincoln County, NM","County or equivalent",2006,20802,164,38,195,157,137,27,110,-11
"40780",NA,NA,"Russellville, AR","Micropolitan Statistical Area",2006,79960,1582,345,1127,782,1216,134,1082,21
"40780",NA,5115,"Pope County, AR","County or equivalent",2006,58379,1147,234,766,532,881,27,854,32
"40780",NA,5149,"Yell County, AR","County or equivalent",2006,21581,435,111,361,250,335,107,228,-11
"40820",NA,NA,"Ruston, LA","Micropolitan Statistical Area",2006,57813,87,270,793,523,-158,44,-202,-25
"40820",NA,22049,"Jackson Parish, LA","County or equivalent",2006,15239,181,6,200,194,182,0,182,-7
"40820",NA,22061,"Lincoln Parish, LA","County or equivalent",2006,42574,-94,264,593,329,-340,44,-384,-18
"40860",NA,NA,"Rutland, VT","Micropolitan Statistical Area",2006,63534,56,-36,580,616,121,7,114,-29
"40860",NA,50021,"Rutland County, VT","County or equivalent",2006,63534,56,-36,580,616,121,7,114,-29
"40940",NA,NA,"Safford, AZ","Micropolitan Statistical Area",2006,40820,912,267,603,336,667,21,646,-22
"40940",NA,4009,"Graham County, AZ","County or equivalent",2006,33372,755,212,492,280,561,15,546,-18
"40940",NA,4011,"Greenlee County, AZ","County or equivalent",2006,7448,157,55,111,56,106,6,100,-4
"41220",NA,NA,"St. Marys, GA","Micropolitan Statistical Area",2006,45379,-383,510,729,219,-875,163,-1038,-18
"41220",NA,13039,"Camden County, GA","County or equivalent",2006,45379,-383,510,729,219,-875,163,-1038,-18
"41260",NA,NA,"St. Marys, PA","Micropolitan Statistical Area",2006,32834,-403,-70,300,370,-318,4,-322,-15
"41260",NA,42047,"Elk County, PA","County or equivalent",2006,32834,-403,-70,300,370,-318,4,-322,-15
"41460",NA,NA,"Salina, KS","Micropolitan Statistical Area",2006,60091,155,268,857,589,-84,81,-165,-29
"41460",NA,20143,"Ottawa County, KS","County or equivalent",2006,5978,-26,-13,53,66,-11,0,-11,-2
"41460",NA,20169,"Saline County, KS","County or equivalent",2006,54113,181,281,804,523,-73,81,-154,-27
"41580",NA,NA,"Salisbury, NC","Micropolitan Statistical Area",2006,135181,1510,392,1690,1298,1185,312,873,-67
"41580",NA,37159,"Rowan County, NC","County or equivalent",2006,135181,1510,392,1690,1298,1185,312,873,-67
"41820",NA,NA,"Sanford, NC","Micropolitan Statistical Area",2006,56729,1259,478,937,459,781,277,504,0
"41820",NA,37105,"Lee County, NC","County or equivalent",2006,56729,1259,478,937,459,781,277,504,0
"42300",NA,NA,"Sault Ste. Marie, MI","Micropolitan Statistical Area",2006,38629,17,101,406,305,-67,17,-84,-17
"42300",NA,26033,"Chippewa County, MI","County or equivalent",2006,38629,17,101,406,305,-67,17,-84,-17
"42380",NA,NA,"Sayre, PA","Micropolitan Statistical Area",2006,61513,-254,19,690,671,-248,6,-254,-25
"42380",NA,42015,"Bradford County, PA","County or equivalent",2006,61513,-254,19,690,671,-248,6,-254,-25
"42420",NA,NA,"Scottsbluff, NE","Micropolitan Statistical Area",2006,36895,-71,121,528,407,-176,48,-224,-16
"42420",NA,31007,"Banner County, NE","County or equivalent",2006,742,13,0,4,4,14,0,14,-1
"42420",NA,31157,"Scotts Bluff County, NE","County or equivalent",2006,36153,-84,121,524,403,-190,48,-238,-15
"42460",NA,NA,"Scottsboro, AL","Micropolitan Statistical Area",2006,53003,69,-2,594,596,96,10,86,-25
"42460",NA,1071,"Jackson County, AL","County or equivalent",2006,53003,69,-2,594,596,96,10,86,-25
"42500",NA,NA,"Scottsburg, IN","Micropolitan Statistical Area",2006,23631,28,95,341,246,-56,0,-56,-11
"42500",NA,18143,"Scott County, IN","County or equivalent",2006,23631,28,95,341,246,-56,0,-56,-11
"42580",NA,NA,"Seaford, DE","Micropolitan Statistical Area",2006,179652,4163,403,2324,1921,3859,294,3565,-99
"42580",NA,10005,"Sussex County, DE","County or equivalent",2006,179652,4163,403,2324,1921,3859,294,3565,-99
"42620",NA,NA,"Searcy, AR","Micropolitan Statistical Area",2006,72550,1219,348,1033,685,911,46,865,-40
"42620",NA,5145,"White County, AR","County or equivalent",2006,72550,1219,348,1033,685,911,46,865,-40
"42700",NA,NA,"Sebring, FL","Micropolitan Statistical Area",2006,97287,2279,-440,992,1432,2778,359,2419,-59
"42700",NA,12055,"Highlands County, FL","County or equivalent",2006,97287,2279,-440,992,1432,2778,359,2419,-59
"42740",NA,NA,"Sedalia, MO","Micropolitan Statistical Area",2006,40474,465,249,642,393,235,73,162,-19
"42740",NA,29159,"Pettis County, MO","County or equivalent",2006,40474,465,249,642,393,235,73,162,-19
"42780",NA,NA,"Selinsgrove, PA","Micropolitan Statistical Area",2006,38049,274,192,503,311,101,4,97,-19
"42780",NA,42109,"Snyder County, PA","County or equivalent",2006,38049,274,192,503,311,101,4,97,-19
"42820",NA,NA,"Selma, AL","Micropolitan Statistical Area",2006,43210,-169,90,660,570,-240,3,-243,-19
"42820",NA,1047,"Dallas County, AL","County or equivalent",2006,43210,-169,90,660,570,-240,3,-243,-19
"42860",NA,NA,"Seneca, SC","Micropolitan Statistical Area",2006,69877,652,27,793,766,659,64,595,-34
"42860",NA,45073,"Oconee County, SC","County or equivalent",2006,69877,652,27,793,766,659,64,595,-34
"42900",NA,NA,"Seneca Falls, NY","Micropolitan Statistical Area",2006,34180,-155,41,357,316,-179,23,-202,-17
"42900",NA,36099,"Seneca County, NY","County or equivalent",2006,34180,-155,41,357,316,-179,23,-202,-17
"42940",NA,NA,"Sevierville, TN","Micropolitan Statistical Area",2006,81627,2108,362,1039,677,1790,44,1746,-44
"42940",NA,47155,"Sevier County, TN","County or equivalent",2006,81627,2108,362,1039,677,1790,44,1746,-44
"42980",NA,NA,"Seymour, IN","Micropolitan Statistical Area",2006,41915,71,214,601,387,-123,78,-201,-20
"42980",NA,18071,"Jackson County, IN","County or equivalent",2006,41915,71,214,601,387,-123,78,-201,-20
"43060",NA,NA,"Shawnee, OK","Micropolitan Statistical Area",2006,68163,440,189,941,752,285,24,261,-34
"43060",NA,40125,"Pottawatomie County, OK","County or equivalent",2006,68163,440,189,941,752,285,24,261,-34
"43140",NA,NA,"Shelby, NC","Micropolitan Statistical Area",2006,97535,137,110,1120,1010,72,61,11,-45
"43140",NA,37045,"Cleveland County, NC","County or equivalent",2006,97535,137,110,1120,1010,72,61,11,-45
"43180",NA,NA,"Shelbyville, TN","Micropolitan Statistical Area",2006,42903,1077,271,673,402,829,192,637,-23
"43180",NA,47003,"Bedford County, TN","County or equivalent",2006,42903,1077,271,673,402,829,192,637,-23
"43220",NA,NA,"Shelton, WA","Micropolitan Statistical Area",2006,55268,1446,79,651,572,1397,50,1347,-30
"43220",NA,53045,"Mason County, WA","County or equivalent",2006,55268,1446,79,651,572,1397,50,1347,-30
"43260",NA,NA,"Sheridan, WY","Micropolitan Statistical Area",2006,27477,337,11,308,297,340,9,331,-14
"43260",NA,56033,"Sheridan County, WY","County or equivalent",2006,27477,337,11,308,297,340,9,331,-14
"43320",NA,NA,"Show Low, AZ","Micropolitan Statistical Area",2006,108939,1973,1029,1878,849,1001,56,945,-57
"43320",NA,4017,"Navajo County, AZ","County or equivalent",2006,108939,1973,1029,1878,849,1001,56,945,-57
"43380",NA,NA,"Sidney, OH","Micropolitan Statistical Area",2006,48551,89,323,720,397,-213,45,-258,-21
"43380",NA,39149,"Shelby County, OH","County or equivalent",2006,48551,89,323,720,397,-213,45,-258,-21
"43420",NA,NA,"Sierra Vista-Douglas, AZ","Micropolitan Statistical Area",2006,126708,1210,577,1773,1196,698,421,277,-65
"43420",NA,4003,"Cochise County, AZ","County or equivalent",2006,126708,1210,577,1773,1196,698,421,277,-65
"43460",NA,NA,"Sikeston, MO","Micropolitan Statistical Area",2006,40605,-28,206,588,382,-216,13,-229,-18
"43460",NA,29201,"Scott County, MO","County or equivalent",2006,40605,-28,206,588,382,-216,13,-229,-18
"43500",NA,NA,"Silver City, NM","Micropolitan Statistical Area",2006,29363,99,87,375,288,25,8,17,-13
"43500",NA,35017,"Grant County, NM","County or equivalent",2006,29363,99,87,375,288,25,8,17,-13
"43540",NA,NA,"Silverthorne, CO","Micropolitan Statistical Area",2006,25852,508,318,369,51,205,213,-8,-15
"43540",NA,8117,"Summit County, CO","County or equivalent",2006,25852,508,318,369,51,205,213,-8,-15
"43660",NA,NA,"Snyder, TX","Micropolitan Statistical Area",2006,15875,106,90,241,151,25,10,15,-9
"43660",NA,48415,"Scurry County, TX","County or equivalent",2006,15875,106,90,241,151,25,10,15,-9
"43700",NA,NA,"Somerset, KY","Micropolitan Statistical Area",2006,59459,541,115,737,622,457,16,441,-31
"43700",NA,21199,"Pulaski County, KY","County or equivalent",2006,59459,541,115,737,622,457,16,441,-31
"43740",NA,NA,"Somerset, PA","Micropolitan Statistical Area",2006,78168,-286,-275,700,975,24,13,11,-35
"43740",NA,42111,"Somerset County, PA","County or equivalent",2006,78168,-286,-275,700,975,24,13,11,-35
"43860",NA,NA,"Southern Pines-Pinehurst, NC","Micropolitan Statistical Area",2006,82358,1512,29,961,932,1525,163,1362,-42
"43860",NA,37125,"Moore County, NC","County or equivalent",2006,82358,1512,29,961,932,1525,163,1362,-42
"43940",NA,NA,"Spearfish, SD","Micropolitan Statistical Area",2006,22971,266,47,250,203,233,2,231,-14
"43940",NA,46081,"Lawrence County, SD","County or equivalent",2006,22971,266,47,250,203,233,2,231,-14
"43980",NA,NA,"Spencer, IA","Micropolitan Statistical Area",2006,16733,-44,45,205,160,-82,13,-95,-7
"43980",NA,19041,"Clay County, IA","County or equivalent",2006,16733,-44,45,205,160,-82,13,-95,-7
"44020",NA,NA,"Spirit Lake, IA","Micropolitan Statistical Area",2006,16668,58,-8,153,161,73,0,73,-7
"44020",NA,19059,"Dickinson County, IA","County or equivalent",2006,16668,58,-8,153,161,73,0,73,-7
"44260",NA,NA,"Starkville, MS","Micropolitan Statistical Area",2006,43215,830,335,594,259,518,104,414,-23
"44260",NA,28105,"Oktibbeha County, MS","County or equivalent",2006,43215,830,335,594,259,518,104,414,-23
"44340",NA,NA,"Statesboro, GA","Micropolitan Statistical Area",2006,64666,1177,363,821,458,849,80,769,-35
"44340",NA,13031,"Bulloch County, GA","County or equivalent",2006,64666,1177,363,821,458,849,80,769,-35
"44380",NA,NA,"Statesville-Mooresville, NC","Micropolitan Statistical Area",2006,145890,5868,777,2053,1276,5177,278,4899,-86
"44380",NA,37097,"Iredell County, NC","County or equivalent",2006,145890,5868,777,2053,1276,5177,278,4899,-86
"44420",NA,NA,"Staunton-Waynesboro, VA","Micropolitan Statistical Area",2006,114789,1327,173,1310,1137,1213,53,1160,-59
"44420",NA,51015,"Augusta County, VA","County or equivalent",2006,70069,1111,150,762,612,996,28,968,-35
"44420",NA,51790,"Staunton city, VA","County or equivalent",2006,23318,-85,-25,271,296,-48,4,-52,-12
"44420",NA,51820,"Waynesboro city, VA","County or equivalent",2006,21402,301,48,277,229,265,21,244,-12
"44500",NA,NA,"Stephenville, TX","Micropolitan Statistical Area",2006,35291,830,185,507,322,663,75,588,-18
"44500",NA,48143,"Erath County, TX","County or equivalent",2006,35291,830,185,507,322,663,75,588,-18
"44540",NA,NA,"Sterling, CO","Micropolitan Statistical Area",2006,20927,64,29,231,202,45,39,6,-10
"44540",NA,8075,"Logan County, CO","County or equivalent",2006,20927,64,29,231,202,45,39,6,-10
"44580",NA,NA,"Sterling, IL","Micropolitan Statistical Area",2006,59171,-46,67,706,639,-88,43,-131,-25
"44580",NA,17195,"Whiteside County, IL","County or equivalent",2006,59171,-46,67,706,639,-88,43,-131,-25
"44620",NA,NA,"Stevens Point, WI","Micropolitan Statistical Area",2006,67829,252,273,729,456,12,43,-31,-33
"44620",NA,55097,"Portage County, WI","County or equivalent",2006,67829,252,273,729,456,12,43,-31,-33
"44660",NA,NA,"Stillwater, OK","Micropolitan Statistical Area",2006,77281,2239,392,902,510,283,230,53,1564
"44660",NA,40119,"Payne County, OK","County or equivalent",2006,77281,2239,392,902,510,283,230,53,1564
"44740",NA,NA,"Storm Lake, IA","Micropolitan Statistical Area",2006,19655,-65,107,282,175,-164,118,-282,-8
"44740",NA,19021,"Buena Vista County, IA","County or equivalent",2006,19655,-65,107,282,175,-164,118,-282,-8
"44780",NA,NA,"Sturgis, MI","Micropolitan Statistical Area",2006,62300,-70,401,970,569,-443,110,-553,-28
"44780",NA,26149,"St. Joseph County, MI","County or equivalent",2006,62300,-70,401,970,569,-443,110,-553,-28
"44860",NA,NA,"Sulphur Springs, TX","Micropolitan Statistical Area",2006,33295,220,168,475,307,70,55,15,-18
"44860",NA,48223,"Hopkins County, TX","County or equivalent",2006,33295,220,168,475,307,70,55,15,-18
"44900",NA,NA,"Summerville, GA","Micropolitan Statistical Area",2006,26094,190,39,311,272,164,23,141,-13
"44900",NA,13055,"Chattooga County, GA","County or equivalent",2006,26094,190,39,311,272,164,23,141,-13
"44980",NA,NA,"Sunbury, PA","Micropolitan Statistical Area",2006,91026,-508,-95,1036,1131,-373,25,-398,-40
"44980",NA,42097,"Northumberland County, PA","County or equivalent",2006,91026,-508,-95,1036,1131,-373,25,-398,-40
"45000",NA,NA,"Susanville, CA","Micropolitan Statistical Area",2006,34083,22,61,280,219,-23,6,-29,-16
"45000",NA,6035,"Lassen County, CA","County or equivalent",2006,34083,22,61,280,219,-23,6,-29,-16
"45020",NA,NA,"Sweetwater, TX","Micropolitan Statistical Area",2006,14549,-32,68,240,172,-92,7,-99,-8
"45020",NA,48353,"Nolan County, TX","County or equivalent",2006,14549,-32,68,240,172,-92,7,-99,-8
"45140",NA,NA,"Tahlequah, OK","Micropolitan Statistical Area",2006,44982,567,209,660,451,380,77,303,-22
"45140",NA,40021,"Cherokee County, OK","County or equivalent",2006,44982,567,209,660,451,380,77,303,-22
"45180",NA,NA,"Talladega-Sylacauga, AL","Micropolitan Statistical Area",2006,80072,203,113,993,880,127,17,110,-37
"45180",NA,1121,"Talladega County, AL","County or equivalent",2006,80072,203,113,993,880,127,17,110,-37
"45260",NA,NA,"Tallulah, LA","Micropolitan Statistical Area",2006,11936,-157,40,207,167,-192,0,-192,-5
"45260",NA,22065,"Madison Parish, LA","County or equivalent",2006,11936,-157,40,207,167,-192,0,-192,-5
"45340",NA,NA,"Taos, NM","Micropolitan Statistical Area",2006,31295,153,74,350,276,94,49,45,-15
"45340",NA,35055,"Taos County, NM","County or equivalent",2006,31295,153,74,350,276,94,49,45,-15
"45380",NA,NA,"Taylorville, IL","Micropolitan Statistical Area",2006,34646,-151,-17,395,412,-121,12,-133,-13
"45380",NA,17021,"Christian County, IL","County or equivalent",2006,34646,-151,-17,395,412,-121,12,-133,-13
"45540",NA,NA,"The Villages, FL","Micropolitan Statistical Area",2006,68030,4648,-364,514,878,5061,48,5013,-49
"45540",NA,12119,"Sumter County, FL","County or equivalent",2006,68030,4648,-364,514,878,5061,48,5013,-49
"45580",NA,NA,"Thomaston, GA","Micropolitan Statistical Area",2006,27479,33,30,387,357,15,34,-19,-12
"45580",NA,13293,"Upson County, GA","County or equivalent",2006,27479,33,30,387,357,15,34,-19,-12
"45620",NA,NA,"Thomasville, GA","Micropolitan Statistical Area",2006,44656,450,227,669,442,246,20,226,-23
"45620",NA,13275,"Thomas County, GA","County or equivalent",2006,44656,450,227,669,442,246,20,226,-23
"45640",NA,NA,"Thomasville-Lexington, NC","Micropolitan Statistical Area",2006,154494,1378,406,1915,1509,1046,336,710,-74
"45640",NA,37057,"Davidson County, NC","County or equivalent",2006,154494,1378,406,1915,1509,1046,336,710,-74
"45660",NA,NA,"Tiffin, OH","Micropolitan Statistical Area",2006,56860,-386,108,675,567,-470,17,-487,-24
"45660",NA,39147,"Seneca County, OH","County or equivalent",2006,56860,-386,108,675,567,-470,17,-487,-24
"45700",NA,NA,"Tifton, GA","Micropolitan Statistical Area",2006,41343,973,371,722,351,624,138,486,-22
"45700",NA,13277,"Tift County, GA","County or equivalent",2006,41343,973,371,722,351,624,138,486,-22
"45740",NA,NA,"Toccoa, GA","Micropolitan Statistical Area",2006,25167,111,16,334,318,108,6,102,-13
"45740",NA,13257,"Stephens County, GA","County or equivalent",2006,25167,111,16,334,318,108,6,102,-13
"45860",NA,NA,"Torrington, CT","Micropolitan Statistical Area",2006,188081,433,169,1864,1695,350,170,180,-86
"45860",NA,9005,"Litchfield County, CT","County or equivalent",2006,188081,433,169,1864,1695,350,170,180,-86
"45900",NA,NA,"Traverse City, MI","Micropolitan Statistical Area",2006,141048,1141,360,1575,1215,851,64,787,-70
"45900",NA,26019,"Benzie County, MI","County or equivalent",2006,17601,135,61,232,171,83,4,79,-9
"45900",NA,26055,"Grand Traverse County, MI","County or equivalent",2006,84408,926,244,951,707,724,49,675,-42
"45900",NA,26079,"Kalkaska County, MI","County or equivalent",2006,17210,99,51,206,155,57,1,56,-9
"45900",NA,26089,"Leelanau County, MI","County or equivalent",2006,21829,-19,4,186,182,-13,10,-23,-10
"45980",NA,NA,"Troy, AL","Micropolitan Statistical Area",2006,29957,285,32,381,349,268,28,240,-15
"45980",NA,1109,"Pike County, AL","County or equivalent",2006,29957,285,32,381,349,268,28,240,-15
"46020",NA,NA,"Truckee-Grass Valley, CA","Micropolitan Statistical Area",2006,96714,141,-44,834,878,229,75,154,-44
"46020",NA,6057,"Nevada County, CA","County or equivalent",2006,96714,141,-44,834,878,229,75,154,-44
"46100",NA,NA,"Tullahoma, TN","Micropolitan Statistical Area",2006,98052,909,256,1255,999,702,73,629,-49
"46100",NA,47031,"Coffee County, TN","County or equivalent",2006,51320,683,213,746,533,496,55,441,-26
"46100",NA,47051,"Franklin County, TN","County or equivalent",2006,40734,211,28,447,419,203,17,186,-20
"46100",NA,47127,"Moore County, TN","County or equivalent",2006,5998,15,15,62,47,3,1,2,-3
"46180",NA,NA,"Tupelo, MS","Micropolitan Statistical Area",2006,130920,1555,608,1902,1294,1014,55,959,-67
"46180",NA,28057,"Itawamba County, MS","County or equivalent",2006,22986,-29,-1,275,276,-18,4,-22,-10
"46180",NA,28081,"Lee County, MS","County or equivalent",2006,79322,1114,427,1226,799,729,35,694,-42
"46180",NA,28115,"Pontotoc County, MS","County or equivalent",2006,28612,470,182,401,219,303,16,287,-15
"46260",NA,NA,"Tuskegee, AL","Micropolitan Statistical Area",2006,22547,-192,-14,268,282,-169,16,-185,-9
"46260",NA,1087,"Macon County, AL","County or equivalent",2006,22547,-192,-14,268,282,-169,16,-185,-9
"46300",NA,NA,"Twin Falls, ID","Micropolitan Statistical Area",2006,90656,2305,735,1552,817,1623,229,1394,-53
"46300",NA,16053,"Jerome County, ID","County or equivalent",2006,19603,403,236,395,159,177,65,112,-10
"46300",NA,16083,"Twin Falls County, ID","County or equivalent",2006,71053,1902,499,1157,658,1446,164,1282,-43
"46380",NA,NA,"Ukiah, CA","Micropolitan Statistical Area",2006,86370,-616,291,1113,822,-873,277,-1150,-34
"46380",NA,6045,"Mendocino County, CA","County or equivalent",2006,86370,-616,291,1113,822,-873,277,-1150,-34
"46420",NA,NA,"Union, SC","Micropolitan Statistical Area",2006,28064,-181,-11,337,348,-157,6,-163,-13
"46420",NA,45087,"Union County, SC","County or equivalent",2006,28064,-181,-11,337,348,-157,6,-163,-13
"46460",NA,NA,"Union City, TN-KY","Micropolitan Statistical Area",2006,38425,-477,-91,442,533,-371,22,-393,-15
"46460",NA,21075,"Fulton County, KY","County or equivalent",2006,6856,-237,-23,84,107,-212,0,-212,-2
"46460",NA,47131,"Obion County, TN","County or equivalent",2006,31569,-240,-68,358,426,-159,22,-181,-13
"46500",NA,NA,"Urbana, OH","Micropolitan Statistical Area",2006,39435,242,158,527,369,103,1,102,-19
"46500",NA,39021,"Champaign County, OH","County or equivalent",2006,39435,242,158,527,369,103,1,102,-19
"46620",NA,NA,"Uvalde, TX","Micropolitan Statistical Area",2006,26520,-32,212,448,236,-232,43,-275,-12
"46620",NA,48463,"Uvalde County, TX","County or equivalent",2006,26520,-32,212,448,236,-232,43,-275,-12
"46740",NA,NA,"Valley, AL","Micropolitan Statistical Area",2006,34767,-369,-92,395,487,-263,19,-282,-14
"46740",NA,1017,"Chambers County, AL","County or equivalent",2006,34767,-369,-92,395,487,-263,19,-282,-14
"46780",NA,NA,"Van Wert, OH","Micropolitan Statistical Area",2006,29061,30,81,385,304,-39,5,-44,-12
"46780",NA,39161,"Van Wert County, OH","County or equivalent",2006,29061,30,81,385,304,-39,5,-44,-12
"46820",NA,NA,"Vermillion, SD","Micropolitan Statistical Area",2006,13312,33,72,152,80,-34,15,-49,-5
"46820",NA,46027,"Clay County, SD","County or equivalent",2006,13312,33,72,152,80,-34,15,-49,-5
"46860",NA,NA,"Vernal, UT","Micropolitan Statistical Area",2006,27818,843,425,594,169,434,9,425,-16
"46860",NA,49047,"Uintah County, UT","County or equivalent",2006,27818,843,425,594,169,434,9,425,-16
"46900",NA,NA,"Vernon, TX","Micropolitan Statistical Area",2006,13951,22,48,222,174,-18,12,-30,-8
"46900",NA,48487,"Wilbarger County, TX","County or equivalent",2006,13951,22,48,222,174,-18,12,-30,-8
"46980",NA,NA,"Vicksburg, MS","Micropolitan Statistical Area",2006,49062,484,248,747,499,259,18,241,-23
"46980",NA,28149,"Warren County, MS","County or equivalent",2006,49062,484,248,747,499,259,18,241,-23
"47080",NA,NA,"Vidalia, GA","Micropolitan Statistical Area",2006,36218,502,210,584,374,311,99,212,-19
"47080",NA,13209,"Montgomery County, GA","County or equivalent",2006,9002,144,14,100,86,135,12,123,-5
"47080",NA,13279,"Toombs County, GA","County or equivalent",2006,27216,358,196,484,288,176,87,89,-14
"47180",NA,NA,"Vincennes, IN","Micropolitan Statistical Area",2006,38038,-121,55,507,452,-159,34,-193,-17
"47180",NA,18083,"Knox County, IN","County or equivalent",2006,38038,-121,55,507,452,-159,34,-193,-17
"47340",NA,NA,"Wabash, IN","Micropolitan Statistical Area",2006,33234,-252,15,402,387,-254,0,-254,-13
"47340",NA,18169,"Wabash County, IN","County or equivalent",2006,33234,-252,15,402,387,-254,0,-254,-13
"47420",NA,NA,"Wahpeton, ND-MN","Micropolitan Statistical Area",2006,23229,-574,65,285,220,-631,8,-639,-8
"47420",NA,27167,"Wilkin County, MN","County or equivalent",2006,6473,-167,1,71,70,-165,2,-167,-3
"47420",NA,38077,"Richland County, ND","County or equivalent",2006,16756,-407,64,214,150,-466,6,-472,-5
"47460",NA,NA,"Walla Walla, WA","Micropolitan Statistical Area",2006,56923,-10,178,717,539,-163,144,-307,-25
"47460",NA,53071,"Walla Walla County, WA","County or equivalent",2006,56923,-10,178,717,539,-163,144,-307,-25
"47500",NA,NA,"Walterboro, SC","Micropolitan Statistical Area",2006,38844,-82,152,557,405,-216,22,-238,-18
"47500",NA,45029,"Colleton County, SC","County or equivalent",2006,38844,-82,152,557,405,-216,22,-238,-18
"47540",NA,NA,"Wapakoneta, OH","Micropolitan Statistical Area",2006,46392,-228,137,576,439,-345,19,-364,-20
"47540",NA,39011,"Auglaize County, OH","County or equivalent",2006,46392,-228,137,576,439,-345,19,-364,-20
"47620",NA,NA,"Warren, PA","Micropolitan Statistical Area",2006,41135,-434,-106,371,477,-312,2,-314,-16
"47620",NA,42123,"Warren County, PA","County or equivalent",2006,41135,-434,-106,371,477,-312,2,-314,-16
"47660",NA,NA,"Warrensburg, MO","Micropolitan Statistical Area",2006,51599,193,390,735,345,-173,172,-345,-24
"47660",NA,29101,"Johnson County, MO","County or equivalent",2006,51599,193,390,735,345,-173,172,-345,-24
"47700",NA,NA,"Warsaw, IN","Micropolitan Statistical Area",2006,75730,340,467,1098,631,-89,104,-193,-38
"47700",NA,18085,"Kosciusko County, IN","County or equivalent",2006,75730,340,467,1098,631,-89,104,-193,-38
"47780",NA,NA,"Washington, IN","Micropolitan Statistical Area",2006,29825,-147,214,518,304,-348,41,-389,-13
"47780",NA,18027,"Daviess County, IN","County or equivalent",2006,29825,-147,214,518,304,-348,41,-389,-13
"47820",NA,NA,"Washington, NC","Micropolitan Statistical Area",2006,45712,344,43,595,552,323,56,267,-22
"47820",NA,37013,"Beaufort County, NC","County or equivalent",2006,45712,344,43,595,552,323,56,267,-22
"47920",NA,NA,"Washington Court House, OH","Micropolitan Statistical Area",2006,28213,-4,69,406,337,-60,9,-69,-13
"47920",NA,39047,"Fayette County, OH","County or equivalent",2006,28213,-4,69,406,337,-60,9,-69,-13
"47980",NA,NA,"Watertown, SD","Micropolitan Statistical Area",2006,31663,240,156,474,318,101,14,87,-17
"47980",NA,46029,"Codington County, SD","County or equivalent",2006,26138,275,133,378,245,155,14,141,-13
"47980",NA,46057,"Hamlin County, SD","County or equivalent",2006,5525,-35,23,96,73,-54,0,-54,-4
"48020",NA,NA,"Watertown-Fort Atkinson, WI","Micropolitan Statistical Area",2006,79326,680,469,1049,580,249,87,162,-38
"48020",NA,55055,"Jefferson County, WI","County or equivalent",2006,79326,680,469,1049,580,249,87,162,-38
"48060",NA,NA,"Watertown-Fort Drum, NY","Micropolitan Statistical Area",2006,117162,141,965,1744,779,-1928,317,-2245,1104
"48060",NA,36045,"Jefferson County, NY","County or equivalent",2006,117162,141,965,1744,779,-1928,317,-2245,1104
"48100",NA,NA,"Wauchula, FL","Micropolitan Statistical Area",2006,28097,345,279,494,215,82,204,-122,-16
"48100",NA,12049,"Hardee County, FL","County or equivalent",2006,28097,345,279,494,215,82,204,-122,-16
"48180",NA,NA,"Waycross, GA","Micropolitan Statistical Area",2006,52854,798,218,826,608,608,72,536,-28
"48180",NA,13229,"Pierce County, GA","County or equivalent",2006,17394,250,104,282,178,155,18,137,-9
"48180",NA,13299,"Ware County, GA","County or equivalent",2006,35460,548,114,544,430,453,54,399,-19
"48460",NA,NA,"West Plains, MO","Micropolitan Statistical Area",2006,38315,240,47,513,466,212,21,191,-19
"48460",NA,29091,"Howell County, MO","County or equivalent",2006,38315,240,47,513,466,212,21,191,-19
"48500",NA,NA,"West Point, MS","Micropolitan Statistical Area",2006,21045,-64,100,304,204,-155,7,-162,-9
"48500",NA,28025,"Clay County, MS","County or equivalent",2006,21045,-64,100,304,204,-155,7,-162,-9
"48580",NA,NA,"Whitewater, WI","Micropolitan Statistical Area",2006,100002,1048,371,1193,822,727,161,566,-50
"48580",NA,55127,"Walworth County, WI","County or equivalent",2006,100002,1048,371,1193,822,727,161,566,-50
"48740",NA,NA,"Willimantic, CT","Micropolitan Statistical Area",2006,116260,1163,383,1326,943,838,253,585,-58
"48740",NA,9015,"Windham County, CT","County or equivalent",2006,116260,1163,383,1326,943,838,253,585,-58
"48780",NA,NA,"Williston, ND","Micropolitan Statistical Area",2006,19244,119,62,246,184,66,4,62,-9
"48780",NA,38105,"Williams County, ND","County or equivalent",2006,19244,119,62,246,184,66,4,62,-9
"48820",NA,NA,"Willmar, MN","Micropolitan Statistical Area",2006,40739,-147,234,581,347,-362,49,-411,-19
"48820",NA,27067,"Kandiyohi County, MN","County or equivalent",2006,40739,-147,234,581,347,-362,49,-411,-19
"48940",NA,NA,"Wilmington, OH","Micropolitan Statistical Area",2006,42828,754,239,588,349,537,37,500,-22
"48940",NA,39027,"Clinton County, OH","County or equivalent",2006,42828,754,239,588,349,537,37,500,-22
"48980",NA,NA,"Wilson, NC","Micropolitan Statistical Area",2006,75659,254,295,1073,778,-5,217,-222,-36
"48980",NA,37195,"Wilson County, NC","County or equivalent",2006,75659,254,295,1073,778,-5,217,-222,-36
"49060",NA,NA,"Winfield, KS","Micropolitan Statistical Area",2006,34160,-324,11,448,437,-319,22,-341,-16
"49060",NA,20035,"Cowley County, KS","County or equivalent",2006,34160,-324,11,448,437,-319,22,-341,-16
"49100",NA,NA,"Winona, MN","Micropolitan Statistical Area",2006,49622,61,116,543,427,-31,48,-79,-24
"49100",NA,27169,"Winona County, MN","County or equivalent",2006,49622,61,116,543,427,-31,48,-79,-24
"49260",NA,NA,"Woodward, OK","Micropolitan Statistical Area",2006,19079,215,70,291,221,154,8,146,-9
"49260",NA,40153,"Woodward County, OK","County or equivalent",2006,19079,215,70,291,221,154,8,146,-9
"49300",NA,NA,"Wooster, OH","Micropolitan Statistical Area",2006,113540,385,649,1613,964,-211,77,-288,-53
"49300",NA,39169,"Wayne County, OH","County or equivalent",2006,113540,385,649,1613,964,-211,77,-288,-53
"49380",NA,NA,"Worthington, MN","Micropolitan Statistical Area",2006,20062,-140,155,341,186,-288,59,-347,-7
"49380",NA,27105,"Nobles County, MN","County or equivalent",2006,20062,-140,155,341,186,-288,59,-347,-7
"49460",NA,NA,"Yankton, SD","Micropolitan Statistical Area",2006,21639,22,67,252,185,-34,8,-42,-11
"49460",NA,46135,"Yankton County, SD","County or equivalent",2006,21639,22,67,252,185,-34,8,-42,-11
"49540",NA,NA,"Yazoo City, MS","Micropolitan Statistical Area",2006,28753,932,149,445,296,800,10,790,-17
"49540",NA,28163,"Yazoo County, MS","County or equivalent",2006,28753,932,149,445,296,800,10,790,-17
"49780",NA,NA,"Zanesville, OH","Micropolitan Statistical Area",2006,85378,240,187,1062,875,95,12,83,-42
"49780",NA,39119,"Muskingum County, OH","County or equivalent",2006,85378,240,187,1062,875,95,12,83,-42
"10180",NA,48059,"Callahan County, TX","County or equivalent",2007,13446,158,-3,156,159,156,3,153,5
"10180",NA,48253,"Jones County, TX","County or equivalent",2007,19257,-240,3,177,174,-216,2,-218,-27
"10180",NA,48441,"Taylor County, TX","County or equivalent",2007,126453,504,922,2096,1174,-443,40,-483,25
"10420",NA,NA,"Akron, OH","Metropolitan Statistical Area",2007,699082,-173,2102,8518,6416,-2218,483,-2701,-57
"10420",NA,39133,"Portage County, OH","County or equivalent",2007,155348,767,515,1683,1168,299,85,214,-47
"10420",NA,39153,"Summit County, OH","County or equivalent",2007,543734,-940,1587,6835,5248,-2517,398,-2915,-10
"10500",NA,NA,"Albany, GA","Metropolitan Statistical Area",2007,163941,967,1098,2454,1356,-114,70,-184,-17
"10500",NA,13007,"Baker County, GA","County or equivalent",2007,3774,-155,19,33,14,-164,2,-166,-10
"10500",NA,13095,"Dougherty County, GA","County or equivalent",2007,95655,615,798,1688,890,-162,49,-211,-21
"10500",NA,13177,"Lee County, GA","County or equivalent",2007,32979,859,202,352,150,651,14,637,6
"10500",NA,13273,"Terrell County, GA","County or equivalent",2007,10275,-162,34,148,114,-203,1,-204,7
"10500",NA,13321,"Worth County, GA","County or equivalent",2007,21258,-190,45,233,188,-236,4,-240,1
"10580",NA,NA,"Albany-Schenectady-Troy, NY","Metropolitan Statistical Area",2007,851564,1273,2030,9481,7451,-863,1023,-1886,106
"10580",NA,36001,"Albany County, NY","County or equivalent",2007,298579,-604,460,3141,2681,-1144,524,-1668,80
"10580",NA,36083,"Rensselaer County, NY","County or equivalent",2007,154955,354,302,1746,1444,49,205,-156,3
"10580",NA,36091,"Saratoga County, NY","County or equivalent",2007,215631,1079,873,2393,1520,192,95,97,14
"10580",NA,36093,"Schenectady County, NY","County or equivalent",2007,150473,418,390,1896,1506,3,199,-196,25
"10580",NA,36095,"Schoharie County, NY","County or equivalent",2007,31926,26,5,305,300,37,0,37,-16
"10740",NA,NA,"Albuquerque, NM","Metropolitan Statistical Area",2007,833044,17065,6232,12489,6257,10969,1501,9468,-136
"10740",NA,35001,"Bernalillo County, NM","County or equivalent",2007,627785,9737,4963,9766,4803,4975,1335,3640,-201
"10740",NA,35043,"Sandoval County, NM","County or equivalent",2007,117583,5728,772,1531,759,4923,59,4864,33
"10740",NA,35057,"Torrance County, NM","County or equivalent",2007,16529,-149,48,187,139,-200,8,-208,3
"10740",NA,35061,"Valencia County, NM","County or equivalent",2007,71147,1749,449,1005,556,1271,99,1172,29
"10780",NA,NA,"Alexandria, LA","Metropolitan Statistical Area",2007,152656,511,718,2292,1574,-565,45,-610,358
"10780",NA,22043,"Grant Parish, LA","County or equivalent",2007,19765,43,59,257,198,-17,0,-17,1
"10780",NA,22079,"Rapides Parish, LA","County or equivalent",2007,132891,468,659,2035,1376,-548,45,-593,357
"10900",NA,NA,"Allentown-Bethlehem-Easton, PA-NJ","Metropolitan Statistical Area",2007,802496,8064,2185,9548,7363,5725,1397,4328,154
"10900",NA,34041,"Warren County, NJ","County or equivalent",2007,109492,227,403,1266,863,-192,163,-355,16
"10900",NA,42025,"Carbon County, PA","County or equivalent",2007,63154,1054,-108,655,763,1123,12,1111,39
"10900",NA,42077,"Lehigh County, PA","County or equivalent",2007,336797,3369,1143,4268,3125,2208,772,1436,18
"10900",NA,42095,"Northampton County, PA","County or equivalent",2007,293053,3414,747,3359,2612,2586,450,2136,81
"11020",NA,NA,"Altoona, PA","Metropolitan Statistical Area",2007,125342,-187,-139,1448,1587,-82,19,-101,34
"11020",NA,42013,"Blair County, PA","County or equivalent",2007,125342,-187,-139,1448,1587,-82,19,-101,34
"11100",NA,NA,"Amarillo, TX","Metropolitan Statistical Area",2007,242124,2320,1922,3954,2032,481,404,77,-83
"11100",NA,48011,"Armstrong County, TX","County or equivalent",2007,2076,-18,9,26,17,-28,1,-29,1
"11100",NA,48065,"Carson County, TX","County or equivalent",2007,6317,-30,13,73,60,-44,1,-45,1
"11100",NA,48375,"Potter County, TX","County or equivalent",2007,120390,15,1113,2310,1197,-1106,313,-1419,8
"11100",NA,48381,"Randall County, TX","County or equivalent",2007,113341,2353,787,1545,758,1659,89,1570,-93
"11180",NA,NA,"Ames, IA","Metropolitan Statistical Area",2007,85306,1801,542,1027,485,1245,397,848,14
"11180",NA,19169,"Story County, IA","County or equivalent",2007,85306,1801,542,1027,485,1245,397,848,14
"11260",NA,NA,"Anchorage, AK","Metropolitan Statistical Area",2007,360089,1277,4279,5903,1624,-3026,323,-3349,24
"11260",NA,2020,"Anchorage Municipality, AK","County or equivalent",2007,277542,-1820,3407,4626,1219,-5260,296,-5556,33
"11260",NA,2170,"Matanuska-Susitna Borough, AK","County or equivalent",2007,82547,3097,872,1277,405,2234,27,2207,-9
"11300",NA,NA,"Anderson, IN","Metropolitan Statistical Area",2007,131157,145,177,1627,1450,-62,63,-125,30
"11300",NA,18095,"Madison County, IN","County or equivalent",2007,131157,145,177,1627,1450,-62,63,-125,30
"11340",NA,NA,"Anderson, SC","Metropolitan Statistical Area",2007,179964,3006,609,2475,1866,2393,98,2295,4
"11340",NA,45007,"Anderson County, SC","County or equivalent",2007,179964,3006,609,2475,1866,2393,98,2295,4
"11460",NA,NA,"Ann Arbor, MI","Metropolitan Statistical Area",2007,347969,1784,2404,4245,1841,-645,1582,-2227,25
"11460",NA,26161,"Washtenaw County, MI","County or equivalent",2007,347969,1784,2404,4245,1841,-645,1582,-2227,25
"11500",NA,NA,"Anniston-Oxford, AL","Metropolitan Statistical Area",2007,112856,275,209,1505,1296,47,44,3,19
"11500",NA,1015,"Calhoun County, AL","County or equivalent",2007,112856,275,209,1505,1296,47,44,3,19
"11540",NA,NA,"Appleton, WI","Metropolitan Statistical Area",2007,217840,1715,1591,3028,1437,130,170,-40,-6
"11540",NA,55015,"Calumet County, WI","County or equivalent",2007,44232,33,431,705,274,-389,28,-417,-9
"11540",NA,55087,"Outagamie County, WI","County or equivalent",2007,173608,1682,1160,2323,1163,519,142,377,3
"11700",NA,NA,"Asheville, NC","Metropolitan Statistical Area",2007,403528,6543,609,4970,4361,5881,628,5253,53
"11700",NA,37021,"Buncombe County, NC","County or equivalent",2007,226400,3872,675,2881,2206,3137,358,2779,60
"11700",NA,37087,"Haywood County, NC","County or equivalent",2007,56405,312,-88,592,680,418,21,397,-18
"11700",NA,37089,"Henderson County, NC","County or equivalent",2007,100445,2166,53,1292,1239,2110,241,1869,3
"11700",NA,37115,"Madison County, NC","County or equivalent",2007,20278,193,-31,205,236,216,8,208,8
"12020",NA,NA,"Athens-Clarke County, GA","Metropolitan Statistical Area",2007,186318,3616,1319,2546,1227,2333,595,1738,-36
"12020",NA,13059,"Clarke County, GA","County or equivalent",2007,113241,2001,1000,1682,682,1034,544,490,-33
"12020",NA,13195,"Madison County, GA","County or equivalent",2007,27941,410,115,354,239,299,18,281,-4
"12020",NA,13219,"Oconee County, GA","County or equivalent",2007,31225,959,169,351,182,785,29,756,5
"12020",NA,13221,"Oglethorpe County, GA","County or equivalent",2007,13911,246,35,159,124,215,4,211,-4
"12060",NA,NA,"Atlanta-Sandy Springs-Marietta, GA","Metropolitan Statistical Area",2007,5261296,147372,52698,82946,30248,95158,20060,75098,-484
"12060",NA,13013,"Barrow County, GA","County or equivalent",2007,66928,3884,764,1234,470,3136,44,3092,-16
"12060",NA,13015,"Bartow County, GA","County or equivalent",2007,92561,2373,801,1534,733,1596,96,1500,-24
"12060",NA,13035,"Butts County, GA","County or equivalent",2007,23658,578,130,343,213,444,3,441,4
"12060",NA,13045,"Carroll County, GA","County or equivalent",2007,111845,3815,947,1828,881,2890,150,2740,-22
"12060",NA,13057,"Cherokee County, GA","County or equivalent",2007,203670,9994,2345,3381,1036,7645,385,7260,4
"12060",NA,13063,"Clayton County, GA","County or equivalent",2007,271144,2711,3323,4736,1413,-414,1113,-1527,-198
"12060",NA,13067,"Cobb County, GA","County or equivalent",2007,688896,10651,7651,11122,3471,3147,3277,-130,-147
"12060",NA,13077,"Coweta County, GA","County or equivalent",2007,118452,4589,1019,1816,797,3638,181,3457,-68
"12060",NA,13085,"Dawson County, GA","County or equivalent",2007,21468,942,132,303,171,804,10,794,6
"12060",NA,13089,"DeKalb County, GA","County or equivalent",2007,733358,6219,7029,11166,4137,-810,5376,-6186,0
"12060",NA,13097,"Douglas County, GA","County or equivalent",2007,124221,5604,1231,2034,803,4336,137,4199,37
"12060",NA,13113,"Fayette County, GA","County or equivalent",2007,105810,1230,391,991,600,876,159,717,-37
"12060",NA,13117,"Forsyth County, GA","County or equivalent",2007,158111,10256,1737,2486,749,8511,283,8228,8
"12060",NA,13121,"Fulton County, GA","County or equivalent",2007,992472,28191,8294,14448,6154,19918,4034,15884,-21
"12060",NA,13135,"Gwinnett County, GA","County or equivalent",2007,771466,25297,10472,13599,3127,14836,4205,10631,-11
"12060",NA,13143,"Haralson County, GA","County or equivalent",2007,28735,479,110,399,289,356,8,348,13
"12060",NA,13149,"Heard County, GA","County or equivalent",2007,11365,34,32,133,101,3,0,3,-1
"12060",NA,13151,"Henry County, GA","County or equivalent",2007,185367,8251,2022,3026,1004,6223,75,6148,6
"12060",NA,13159,"Jasper County, GA","County or equivalent",2007,13634,237,79,185,106,157,10,147,1
"12060",NA,13171,"Lamar County, GA","County or equivalent",2007,16909,316,59,221,162,264,4,260,-7
"12060",NA,13199,"Meriwether County, GA","County or equivalent",2007,22741,-222,58,308,250,-294,1,-295,14
"12060",NA,13217,"Newton County, GA","County or equivalent",2007,95723,5146,904,1590,686,4234,51,4183,8
"12060",NA,13223,"Paulding County, GA","County or equivalent",2007,127594,7930,1458,2064,606,6461,45,6416,11
"12060",NA,13227,"Pickens County, GA","County or equivalent",2007,30453,1236,60,362,302,1185,12,1173,-9
"12060",NA,13231,"Pike County, GA","County or equivalent",2007,17155,612,77,214,137,524,1,523,11
"12060",NA,13247,"Rockdale County, GA","County or equivalent",2007,81650,2201,669,1228,559,1515,292,1223,17
"12060",NA,13255,"Spalding County, GA","County or equivalent",2007,62960,848,344,988,644,513,75,438,-9
"12060",NA,13297,"Walton County, GA","County or equivalent",2007,82950,3970,560,1207,647,3464,33,3431,-54
"12100",NA,NA,"Atlantic City-Hammonton, NJ","Metropolitan Statistical Area",2007,269970,641,1174,3620,2446,-624,1073,-1697,91
"12100",NA,34001,"Atlantic County, NJ","County or equivalent",2007,269970,641,1174,3620,2446,-624,1073,-1697,91
"12220",NA,NA,"Auburn-Opelika, AL","Metropolitan Statistical Area",2007,130521,2596,795,1638,843,1818,143,1675,-17
"12220",NA,1081,"Lee County, AL","County or equivalent",2007,130521,2596,795,1638,843,1818,143,1675,-17
"12260",NA,NA,"Augusta-Richmond County, GA-SC","Metropolitan Statistical Area",2007,528312,6240,3160,7920,4760,3157,228,2929,-77
"12260",NA,13033,"Burke County, GA","County or equivalent",2007,22714,77,78,347,269,-2,3,-5,1
"12260",NA,13073,"Columbia County, GA","County or equivalent",2007,108760,3320,938,1563,625,2380,67,2313,2
"12260",NA,13189,"McDuffie County, GA","County or equivalent",2007,21504,-30,89,333,244,-120,2,-122,1
"12260",NA,13245,"Richmond County, GA","County or equivalent",2007,197643,440,1463,3370,1907,-1003,17,-1020,-20
"12260",NA,45003,"Aiken County, SC","County or equivalent",2007,152333,2208,546,2059,1513,1727,130,1597,-65
"12260",NA,45037,"Edgefield County, SC","County or equivalent",2007,25358,225,46,248,202,175,9,166,4
"12420",NA,NA,"Austin-Round Rock, TX","Metropolitan Statistical Area",2007,1592590,65550,18349,25749,7400,47085,6524,40561,116
"12420",NA,48021,"Bastrop County, TX","County or equivalent",2007,72127,1834,469,951,482,1365,119,1246,0
"12420",NA,48055,"Caldwell County, TX","County or equivalent",2007,36600,394,246,519,273,160,32,128,-12
"12420",NA,48209,"Hays County, TX","County or equivalent",2007,141950,9063,1331,1987,656,7654,131,7523,78
"12420",NA,48453,"Travis County, TX","County or equivalent",2007,969892,32351,11943,16265,4322,20262,5685,14577,146
"12420",NA,48491,"Williamson County, TX","County or equivalent",2007,372021,21908,4360,6027,1667,17644,557,17087,-96
"12540",NA,NA,"Bakersfield, CA","Metropolitan Statistical Area",2007,787179,16958,9893,15296,5403,6963,2236,4727,102
"12540",NA,6029,"Kern County, CA","County or equivalent",2007,787179,16958,9893,15296,5403,6963,2236,4727,102
"12580",NA,NA,"Baltimore-Towson, MD","Metropolitan Statistical Area",2007,2663805,5783,11856,35397,23541,-7636,3522,-11158,1563
"12580",NA,24003,"Anne Arundel County, MD","County or equivalent",2007,510507,1470,3183,6954,3771,-1809,294,-2103,96
"12580",NA,24005,"Baltimore County, MD","County or equivalent",2007,785830,630,2029,9825,7796,-1480,1401,-2881,81
"12580",NA,24013,"Carroll County, MD","County or equivalent",2007,168786,606,665,1960,1295,-1,53,-54,-58
"12580",NA,24025,"Harford County, MD","County or equivalent",2007,239406,213,1262,2973,1711,-1088,115,-1203,39
"12580",NA,24027,"Howard County, MD","County or equivalent",2007,272611,2980,2005,3366,1361,963,809,154,12
"12580",NA,24035,"Queen Anne's County, MD","County or equivalent",2007,46515,695,157,513,356,522,28,494,16
"12580",NA,24510,"Baltimore city, MD","County or equivalent",2007,640150,-811,2555,9806,7251,-4743,822,-5565,1377
"12620",NA,NA,"Bangor, ME","Metropolitan Statistical Area",2007,148527,688,366,1655,1289,336,84,252,-14
"12620",NA,23019,"Penobscot County, ME","County or equivalent",2007,148527,688,366,1655,1289,336,84,252,-14
"12700",NA,NA,"Barnstable Town, MA","Metropolitan Statistical Area",2007,221990,-1325,-754,1980,2734,-596,270,-866,25
"12700",NA,25001,"Barnstable County, MA","County or equivalent",2007,221990,-1325,-754,1980,2734,-596,270,-866,25
"12940",NA,NA,"Baton Rouge, LA","Metropolitan Statistical Area",2007,769397,5809,5280,11504,6224,670,689,-19,-141
"12940",NA,22005,"Ascension Parish, LA","County or equivalent",2007,99089,3571,1032,1678,646,2504,65,2439,35
"12940",NA,22033,"East Baton Rouge Parish, LA","County or equivalent",2007,429914,-700,2816,6346,3530,-3347,600,-3947,-169
"12940",NA,22037,"East Feliciana Parish, LA","County or equivalent",2007,20827,-183,32,267,235,-216,1,-217,1
"12940",NA,22047,"Iberville Parish, LA","County or equivalent",2007,32467,-333,156,484,328,-486,3,-489,-3
"12940",NA,22063,"Livingston Parish, LA","County or equivalent",2007,116469,3283,957,1820,863,2277,17,2260,49
"12940",NA,22077,"Pointe Coupee Parish, LA","County or equivalent",2007,22359,-11,89,317,228,-87,-1,-86,-13
"12940",NA,22091,"St. Helena Parish, LA","County or equivalent",2007,10590,-77,16,111,95,-86,0,-86,-7
"12940",NA,22121,"West Baton Rouge Parish, LA","County or equivalent",2007,22620,436,157,357,200,293,2,291,-14
"12940",NA,22125,"West Feliciana Parish, LA","County or equivalent",2007,15062,-177,25,124,99,-182,2,-184,-20
"12980",NA,NA,"Battle Creek, MI","Metropolitan Statistical Area",2007,136334,-858,485,1881,1396,-1371,136,-1507,28
"12980",NA,26025,"Calhoun County, MI","County or equivalent",2007,136334,-858,485,1881,1396,-1371,136,-1507,28
"13020",NA,NA,"Bay City, MI","Metropolitan Statistical Area",2007,107366,-561,167,1273,1106,-741,18,-759,13
"13020",NA,26017,"Bay County, MI","County or equivalent",2007,107366,-561,167,1273,1106,-741,18,-759,13
"13140",NA,NA,"Beaumont-Port Arthur, TX","Metropolitan Statistical Area",2007,376448,2601,1570,5363,3793,1146,433,713,-115
"13140",NA,48199,"Hardin County, TX","County or equivalent",2007,51530,809,222,701,479,590,8,582,-3
"13140",NA,48245,"Jefferson County, TX","County or equivalent",2007,242372,1408,1130,3595,2465,317,386,-69,-39
"13140",NA,48361,"Orange County, TX","County or equivalent",2007,82546,384,218,1067,849,239,39,200,-73
"13380",NA,NA,"Bellingham, WA","Metropolitan Statistical Area",2007,192353,4064,905,2266,1361,3204,468,2736,-45
"13380",NA,53073,"Whatcom County, WA","County or equivalent",2007,192353,4064,905,2266,1361,3204,468,2736,-45
"13460",NA,NA,"Bend, OR","Metropolitan Statistical Area",2007,153799,4972,1061,2121,1060,3984,66,3918,-73
"13460",NA,41017,"Deschutes County, OR","County or equivalent",2007,153799,4972,1061,2121,1060,3984,66,3918,-73
"13740",NA,NA,"Billings, MT","Metropolitan Statistical Area",2007,149475,1817,809,2090,1281,1018,26,992,-10
"13740",NA,30009,"Carbon County, MT","County or equivalent",2007,9709,22,5,91,86,20,4,16,-3
"13740",NA,30111,"Yellowstone County, MT","County or equivalent",2007,139766,1795,804,1999,1195,998,22,976,-7
"13780",NA,NA,"Binghamton, NY","Metropolitan Statistical Area",2007,245850,-590,242,2788,2546,-822,302,-1124,-10
"13780",NA,36007,"Broome County, NY","County or equivalent",2007,195477,-465,76,2177,2101,-573,286,-859,32
"13780",NA,36107,"Tioga County, NY","County or equivalent",2007,50373,-125,166,611,445,-249,16,-265,-42
"13820",NA,NA,"Birmingham-Hoover, AL","Metropolitan Statistical Area",2007,1108672,8386,4583,15602,11019,3536,971,2565,267
"13820",NA,1007,"Bibb County, AL","County or equivalent",2007,21483,176,35,252,217,138,5,133,3
"13820",NA,1009,"Blount County, AL","County or equivalent",2007,56502,794,190,724,534,583,74,509,21
"13820",NA,1021,"Chilton County, AL","County or equivalent",2007,42196,524,120,566,446,401,25,376,3
"13820",NA,1073,"Jefferson County, AL","County or equivalent",2007,658815,-588,2420,9459,7039,-3118,703,-3821,110
"13820",NA,1115,"St. Clair County, AL","County or equivalent",2007,78036,3102,270,1035,765,2819,9,2810,13
"13820",NA,1117,"Shelby County, AL","County or equivalent",2007,182969,4680,1562,2654,1092,2998,133,2865,120
"13820",NA,1127,"Walker County, AL","County or equivalent",2007,68671,-302,-14,912,926,-285,22,-307,-3
"13900",NA,NA,"Bismarck, ND","Metropolitan Statistical Area",2007,103127,1972,652,1411,759,1320,28,1292,0
"13900",NA,38015,"Burleigh County, ND","County or equivalent",2007,77256,1620,503,1037,534,1121,21,1100,-4
"13900",NA,38059,"Morton County, ND","County or equivalent",2007,25871,352,149,374,225,199,7,192,4
"13980",NA,NA,"Blacksburg-Christiansburg-Radford, VA","Metropolitan Statistical Area",2007,157356,1564,367,1633,1266,1188,304,884,9
"13980",NA,51071,"Giles County, VA","County or equivalent",2007,17203,24,-23,193,216,54,0,54,-7
"13980",NA,51121,"Montgomery County, VA","County or equivalent",2007,89023,1173,418,932,514,747,287,460,8
"13980",NA,51155,"Pulaski County, VA","County or equivalent",2007,34998,209,-51,369,420,246,4,242,14
"13980",NA,51750,"Radford city, VA","County or equivalent",2007,16132,158,23,139,116,141,13,128,-6
"14020",NA,NA,"Bloomington, IN","Metropolitan Statistical Area",2007,182620,1077,622,2027,1405,460,361,99,-5
"14020",NA,18055,"Greene County, IN","County or equivalent",2007,32642,-253,30,407,377,-278,2,-280,-5
"14020",NA,18105,"Monroe County, IN","County or equivalent",2007,127625,1277,599,1383,784,683,357,326,-5
"14020",NA,18119,"Owen County, IN","County or equivalent",2007,22353,53,-7,237,244,55,2,53,5
"14060",NA,NA,"Bloomington-Normal, IL","Metropolitan Statistical Area",2007,163692,2062,1192,2251,1059,874,215,659,-4
"14060",NA,17113,"McLean County, IL","County or equivalent",2007,163692,2062,1192,2251,1059,874,215,659,-4
"14260",NA,NA,"Boise City-Nampa, ID","Metropolitan Statistical Area",2007,586600,20214,6059,9761,3702,14436,895,13541,-281
"14260",NA,16001,"Ada County, ID","County or equivalent",2007,373158,12289,3534,5786,2252,8936,556,8380,-181
"14260",NA,16015,"Boise County, ID","County or equivalent",2007,7542,101,31,58,27,81,1,80,-11
"14260",NA,16027,"Canyon County, ID","County or equivalent",2007,178682,7566,2340,3494,1154,5292,288,5004,-66
"14260",NA,16045,"Gem County, ID","County or equivalent",2007,16455,190,62,251,189,143,18,125,-15
"14260",NA,16073,"Owyhee County, ID","County or equivalent",2007,10763,68,92,172,80,-16,32,-48,-8
"14460",NA,NA,"Boston-Cambridge-Quincy, MA-NH","Metropolitan Statistical Area",2007,4492338,25105,20440,55057,34617,-3984,18524,-22508,8649
"14460",14484,NA,"Boston-Quincy, MA","Metropolitan Division",2007,1872712,15988,8752,23234,14482,-1396,8633,-10029,8632
"14460",14484,25021,"Norfolk County, MA","County or equivalent",2007,655358,2378,2347,7739,5392,248,1814,-1566,-217
"14460",14484,25023,"Plymouth County, MA","County or equivalent",2007,489808,1514,1878,5904,4026,-353,630,-983,-11
"14460",14484,25025,"Suffolk County, MA","County or equivalent",2007,727546,12096,4527,9591,5064,-1291,6189,-7480,8860
"14460",15764,NA,"Cambridge-Newton-Framingham, MA","Metropolitan Division",2007,1469798,6144,7099,18127,11028,-828,7311,-8139,-127
"14460",15764,25017,"Middlesex County, MA","County or equivalent",2007,1469798,6144,7099,18127,11028,-828,7311,-8139,-127
"14460",37764,NA,"Peabody, MA","Metropolitan Division",2007,732575,1396,2933,9206,6273,-1695,2303,-3998,158
"14460",37764,25009,"Essex County, MA","County or equivalent",2007,732575,1396,2933,9206,6273,-1695,2303,-3998,158
"14460",40484,NA,"Rockingham County-Strafford County, NH","Metropolitan Division",2007,417253,1577,1656,4490,2834,-65,277,-342,-14
"14460",40484,33015,"Rockingham County, NH","County or equivalent",2007,296042,862,1167,3112,1945,-296,181,-477,-9
"14460",40484,33017,"Strafford County, NH","County or equivalent",2007,121211,715,489,1378,889,231,96,135,-5
"14500",NA,NA,"Boulder, CO /1","Metropolitan Statistical Area",2007,288805,3755,2015,3427,1412,1763,1181,582,-23
"14500",NA,8013,"Boulder County, CO /1","County or equivalent",2007,288805,3755,2015,3427,1412,1763,1181,582,-23
"14540",NA,NA,"Bowling Green, KY","Metropolitan Statistical Area",2007,115698,1815,660,1574,914,1164,274,890,-9
"14540",NA,21061,"Edmonson County, KY","County or equivalent",2007,11953,84,-1,115,116,82,3,79,3
"14540",NA,21227,"Warren County, KY","County or equivalent",2007,103745,1731,661,1459,798,1082,271,811,-12
"14600",NA,NA,"Bradenton-Sarasota-Venice, FL","Metropolitan Statistical Area",2007,685002,6162,-1265,7263,8528,7231,1510,5721,196
"14600",NA,12081,"Manatee County, FL","County or equivalent",2007,314131,2627,567,4028,3461,1983,702,1281,77
"14600",NA,12115,"Sarasota County, FL","County or equivalent",2007,370871,3535,-1832,3235,5067,5248,808,4440,119
"14740",NA,NA,"Bremerton-Silverdale, WA","Metropolitan Statistical Area",2007,238160,-1611,1169,2965,1796,-2852,-16,-2836,72
"14740",NA,53035,"Kitsap County, WA","County or equivalent",2007,238160,-1611,1169,2965,1796,-2852,-16,-2836,72
"14860",NA,NA,"Bridgeport-Stamford-Norwalk, CT","Metropolitan Statistical Area",2007,890595,83,5489,11655,6166,-5115,5144,-10259,-291
"14860",NA,9001,"Fairfield County, CT","County or equivalent",2007,890595,83,5489,11655,6166,-5115,5144,-10259,-291
"15180",NA,NA,"Brownsville-Harlingen, TX","Metropolitan Statistical Area",2007,384905,6724,6575,8766,2191,108,1571,-1463,41
"15180",NA,48061,"Cameron County, TX","County or equivalent",2007,384905,6724,6575,8766,2191,108,1571,-1463,41
"15260",NA,NA,"Brunswick, GA","Metropolitan Statistical Area",2007,101499,1680,346,1378,1032,1313,100,1213,21
"15260",NA,13025,"Brantley County, GA","County or equivalent",2007,15417,14,-50,116,166,61,2,59,3
"15260",NA,13127,"Glynn County, GA","County or equivalent",2007,74666,1375,352,1112,760,998,98,900,25
"15260",NA,13191,"McIntosh County, GA","County or equivalent",2007,11416,291,44,150,106,254,0,254,-7
"15380",NA,NA,"Buffalo-Niagara Falls, NY","Metropolitan Statistical Area",2007,1126513,-5476,647,12515,11868,-6093,1189,-7282,-30
"15380",NA,36029,"Erie County, NY","County or equivalent",2007,912158,-5051,574,10147,9573,-5552,1048,-6600,-73
"15380",NA,36063,"Niagara County, NY","County or equivalent",2007,214355,-425,73,2368,2295,-541,141,-682,43
"15500",NA,NA,"Burlington, NC","Metropolitan Statistical Area",2007,144790,3298,619,1992,1373,2621,497,2124,58
"15500",NA,37001,"Alamance County, NC","County or equivalent",2007,144790,3298,619,1992,1373,2621,497,2124,58
"15540",NA,NA,"Burlington-South Burlington, VT","Metropolitan Statistical Area",2007,207220,965,1065,2347,1282,-137,358,-495,37
"15540",NA,50007,"Chittenden County, VT","County or equivalent",2007,151807,786,755,1646,891,6,341,-335,25
"15540",NA,50011,"Franklin County, VT","County or equivalent",2007,47830,132,288,632,344,-166,17,-183,10
"15540",NA,50013,"Grand Isle County, VT","County or equivalent",2007,7583,47,22,69,47,23,0,23,2
"15940",NA,NA,"Canton-Massillon, OH","Metropolitan Statistical Area",2007,407594,250,864,4964,4100,-674,65,-739,60
"15940",NA,39019,"Carroll County, OH","County or equivalent",2007,28545,-236,68,342,274,-282,3,-285,-22
"15940",NA,39151,"Stark County, OH","County or equivalent",2007,379049,486,796,4622,3826,-392,62,-454,82
"15980",NA,NA,"Cape Coral-Fort Myers, FL","Metropolitan Statistical Area",2007,588129,19842,1492,7684,6192,18126,1489,16637,224
"15980",NA,12071,"Lee County, FL","County or equivalent",2007,588129,19842,1492,7684,6192,18126,1489,16637,224
"16180",NA,NA,"Carson City, NV","Metropolitan Statistical Area",2007,54724,-259,76,747,671,-355,146,-501,20
"16180",NA,32510,"Carson City, NV","County or equivalent",2007,54724,-259,76,747,671,-355,146,-501,20
"16220",NA,NA,"Casper, WY","Metropolitan Statistical Area",2007,71784,1564,502,1100,598,1052,30,1022,10
"16220",NA,56025,"Natrona County, WY","County or equivalent",2007,71784,1564,502,1100,598,1052,30,1022,10
"16300",NA,NA,"Cedar Rapids, IA","Metropolitan Statistical Area",2007,252472,3089,1490,3436,1946,1606,207,1399,-7
"16300",NA,19011,"Benton County, IA","County or equivalent",2007,26501,-63,94,310,216,-138,3,-141,-19
"16300",NA,19105,"Jones County, IA","County or equivalent",2007,20350,19,50,229,179,-8,1,-9,-23
"16300",NA,19113,"Linn County, IA","County or equivalent",2007,205621,3133,1346,2897,1551,1752,203,1549,35
"16580",NA,NA,"Champaign-Urbana, IL","Metropolitan Statistical Area",2007,223586,2344,1253,2792,1539,1112,770,342,-21
"16580",NA,17019,"Champaign County, IL","County or equivalent",2007,193015,2277,1276,2450,1174,1002,765,237,-1
"16580",NA,17053,"Ford County, IL","County or equivalent",2007,14114,107,-37,157,194,155,4,151,-11
"16580",NA,17147,"Piatt County, IL","County or equivalent",2007,16457,-40,14,185,171,-45,1,-46,-9
"16620",NA,NA,"Charleston, WV","Metropolitan Statistical Area",2007,303656,56,55,3673,3618,-15,65,-80,16
"16620",NA,54005,"Boone County, WV","County or equivalent",2007,25186,44,-9,316,325,53,6,47,0
"16620",NA,54015,"Clay County, WV","County or equivalent",2007,10110,53,1,124,123,50,1,49,2
"16620",NA,54039,"Kanawha County, WV","County or equivalent",2007,191180,-572,-120,2288,2408,-459,52,-511,7
"16620",NA,54043,"Lincoln County, WV","County or equivalent",2007,22308,5,39,296,257,-31,1,-32,-3
"16620",NA,54079,"Putnam County, WV","County or equivalent",2007,54872,526,144,649,505,372,5,367,10
"16700",NA,NA,"Charleston-North Charleston-Summerville, SC","Metropolitan Statistical Area",2007,630434,13792,4601,9409,4808,9205,457,8748,-14
"16700",NA,45015,"Berkeley County, SC","County or equivalent",2007,163555,5173,1506,2564,1058,3629,-1,3630,38
"16700",NA,45019,"Charleston County, SC","County or equivalent",2007,343522,2897,2137,5025,2888,873,396,477,-113
"16700",NA,45035,"Dorchester County, SC","County or equivalent",2007,123357,5722,958,1820,862,4703,62,4641,61
"16740",NA,NA,"Charlotte-Gastonia-Concord, NC-SC","Metropolitan Statistical Area",2007,1646431,66361,15503,26283,10780,50265,4716,45549,593
"16740",NA,37007,"Anson County, NC","County or equivalent",2007,25218,-96,27,316,289,-129,6,-135,6
"16740",NA,37025,"Cabarrus County, NC","County or equivalent",2007,162798,7668,1409,2630,1221,6167,316,5851,92
"16740",NA,37071,"Gaston County, NC","County or equivalent",2007,202166,4587,1003,2910,1907,3491,410,3081,93
"16740",NA,37119,"Mecklenburg County, NC","County or equivalent",2007,863801,31723,9976,14767,4791,21476,3403,18073,271
"16740",NA,37179,"Union County, NC","County or equivalent",2007,183884,12124,1742,2751,1009,10264,421,9843,118
"16740",NA,45091,"York County, SC","County or equivalent",2007,208564,10355,1346,2909,1563,8996,160,8836,13
"16820",NA,NA,"Charlottesville, VA","Metropolitan Statistical Area",2007,192154,1963,1018,2390,1372,944,415,529,1
"16820",NA,51003,"Albemarle County, VA","County or equivalent",2007,92639,769,492,1115,623,269,275,-6,8
"16820",NA,51065,"Fluvanna County, VA","County or equivalent",2007,25254,466,175,335,160,298,3,295,-7
"16820",NA,51079,"Greene County, VA","County or equivalent",2007,17832,281,141,269,128,135,3,132,5
"16820",NA,51125,"Nelson County, VA","County or equivalent",2007,15223,223,8,166,158,214,-1,215,1
"16820",NA,51540,"Charlottesville city, VA","County or equivalent",2007,41206,224,202,505,303,28,135,-107,-6
"16860",NA,NA,"Chattanooga, TN-GA","Metropolitan Statistical Area",2007,514209,5013,1510,6644,5134,3394,420,2974,109
"16860",NA,13047,"Catoosa County, GA","County or equivalent",2007,62120,1313,307,806,499,994,20,974,12
"16860",NA,13083,"Dade County, GA","County or equivalent",2007,16113,135,20,175,155,114,8,106,1
"16860",NA,13295,"Walker County, GA","County or equivalent",2007,64421,635,91,830,739,520,23,497,24
"16860",NA,47065,"Hamilton County, TN","County or equivalent",2007,330077,2457,1013,4308,3295,1377,360,1017,67
"16860",NA,47115,"Marion County, TN","County or equivalent",2007,28118,146,20,344,324,118,2,116,8
"16860",NA,47153,"Sequatchie County, TN","County or equivalent",2007,13360,327,59,181,122,271,7,264,-3
"16940",NA,NA,"Cheyenne, WY","Metropolitan Statistical Area",2007,86480,590,616,1334,718,-16,-3,-13,-10
"16940",NA,56021,"Laramie County, WY","County or equivalent",2007,86480,590,616,1334,718,-16,-3,-13,-10
"16980",NA,NA,"Chicago-Naperville-Joliet, IL-IN-WI","Metropolitan Statistical Area",2007,9496853,57048,71940,140173,68233,-12708,42647,-55355,-2184
"16980",16974,NA,"Chicago-Naperville-Joliet, IL","Metropolitan Division",2007,7929840,46189,61682,118445,56763,-13255,39233,-52488,-2238
"16980",16974,17031,"Cook County, IL","County or equivalent",2007,5271405,1259,37597,79196,41599,-34845,31139,-65984,-1493
"16980",16974,17037,"DeKalb County, IL","County or equivalent",2007,105180,2607,754,1396,642,1826,240,1586,27
"16980",16974,17043,"DuPage County, IL","County or equivalent",2007,926228,755,6188,11889,5701,-5582,4089,-9671,149
"16980",16974,17063,"Grundy County, IL","County or equivalent",2007,46987,1475,399,750,351,1064,30,1034,12
"16980",16974,17089,"Kane County, IL","County or equivalent",2007,498142,10863,5952,8649,2697,4966,2260,2706,-55
"16980",16974,17093,"Kendall County, IL","County or equivalent",2007,96566,9113,1432,1808,376,7528,61,7467,153
"16980",16974,17111,"McHenry County, IL","County or equivalent",2007,314669,5644,2484,4315,1831,3330,574,2756,-170
"16980",16974,17197,"Will County, IL","County or equivalent",2007,670663,14473,6876,10442,3566,8458,840,7618,-861
"16980",23844,NA,"Gary, IN","Metropolitan Division",2007,697731,4604,3257,9515,6258,1382,608,774,-35
"16980",23844,18073,"Jasper County, IN","County or equivalent",2007,32222,411,198,478,280,205,11,194,8
"16980",23844,18089,"Lake County, IN","County or equivalent",2007,491238,1969,2358,7001,4643,-316,477,-793,-73
"16980",23844,18111,"Newton County, IN","County or equivalent",2007,14004,16,7,153,146,9,12,-3,0
"16980",23844,18127,"Porter County, IN","County or equivalent",2007,160267,2208,694,1883,1189,1484,108,1376,30
"16980",29404,NA,"Lake County-Kenosha County, IL-WI","Metropolitan Division",2007,869282,6255,7001,12213,5212,-835,2806,-3641,89
"16980",29404,17097,"Lake County, IL","County or equivalent",2007,706386,4632,6012,10011,3999,-1459,2632,-4091,79
"16980",29404,55059,"Kenosha County, WI","County or equivalent",2007,162896,1623,989,2202,1213,624,174,450,10
"17020",NA,NA,"Chico, CA","Metropolitan Statistical Area",2007,218185,1054,486,2668,2182,582,349,233,-14
"17020",NA,6007,"Butte County, CA","County or equivalent",2007,218185,1054,486,2668,2182,582,349,233,-14
"17140",NA,NA,"Cincinnati-Middletown, OH-KY-IN","Metropolitan Statistical Area",2007,2143824,23865,12511,30651,18140,537,1891,-1354,10817
"17140",NA,18029,"Dearborn County, IN","County or equivalent",2007,49579,484,223,621,398,257,8,249,4
"17140",NA,18047,"Franklin County, IN","County or equivalent",2007,23183,165,123,312,189,41,2,39,1
"17140",NA,18115,"Ohio County, IN","County or equivalent",2007,5757,-66,29,68,39,-83,0,-83,-12
"17140",NA,21015,"Boone County, KY","County or equivalent",2007,112089,3122,1066,1744,678,2089,149,1940,-33
"17140",NA,21023,"Bracken County, KY","County or equivalent",2007,8550,-4,42,124,82,-39,1,-40,-7
"17140",NA,21037,"Campbell County, KY","County or equivalent",2007,86810,72,302,1149,847,-241,54,-295,11
"17140",NA,21077,"Gallatin County, KY","County or equivalent",2007,8052,15,63,140,77,-48,0,-48,0
"17140",NA,21081,"Grant County, KY","County or equivalent",2007,25169,379,202,405,203,181,8,173,-4
"17140",NA,21117,"Kenton County, KY","County or equivalent",2007,156593,1574,1116,2439,1323,462,87,375,-4
"17140",NA,21191,"Pendleton County, KY","County or equivalent",2007,15020,7,30,164,134,-16,3,-19,-7
"17140",NA,39015,"Brown County, OH","County or equivalent",2007,43851,136,146,561,415,-9,6,-15,-1
"17140",NA,39017,"Butler County, OH","County or equivalent",2007,357908,4422,2401,5269,2868,2003,263,1740,18
"17140",NA,39025,"Clermont County, OH","County or equivalent",2007,193729,2026,1490,2898,1408,514,83,431,22
"17140",NA,39061,"Hamilton County, OH","County or equivalent",2007,853928,6744,3813,11989,8176,-7921,1111,-9032,10852
"17140",NA,39165,"Warren County, OH","County or equivalent",2007,203606,4789,1465,2768,1303,3347,116,3231,-23
"17300",NA,NA,"Clarksville, TN-KY","Metropolitan Statistical Area",2007,261849,9395,2301,4257,1956,6962,-173,7135,132
"17300",NA,21047,"Christian County, KY","County or equivalent",2007,81044,2585,764,1407,643,1792,-117,1909,29
"17300",NA,21221,"Trigg County, KY","County or equivalent",2007,13375,212,-5,149,154,212,-1,213,5
"17300",NA,47125,"Montgomery County, TN","County or equivalent",2007,154402,6441,1558,2559,1001,4790,-53,4843,93
"17300",NA,47161,"Stewart County, TN","County or equivalent",2007,13028,157,-16,142,158,168,-2,170,5
"17420",NA,NA,"Cleveland, TN","Metropolitan Statistical Area",2007,110910,1585,369,1433,1064,1178,88,1090,38
"17420",NA,47011,"Bradley County, TN","County or equivalent",2007,95275,1679,401,1258,857,1238,87,1151,40
"17420",NA,47139,"Polk County, TN","County or equivalent",2007,15635,-94,-32,175,207,-60,1,-61,-2
"17460",NA,NA,"Cleveland-Elyria-Mentor, OH","Metropolitan Statistical Area",2007,2094885,-8965,4993,25897,20904,-13889,2940,-16829,-69
"17460",NA,39035,"Cuyahoga County, OH","County or equivalent",2007,1295187,-12749,2592,16706,14114,-15231,2292,-17523,-110
"17460",NA,39055,"Geauga County, OH","County or equivalent",2007,94696,119,284,995,711,-187,23,-210,22
"17460",NA,39085,"Lake County, OH","County or equivalent",2007,233013,695,338,2564,2226,326,335,-9,31
"17460",NA,39093,"Lorain County, OH","County or equivalent",2007,302687,1472,978,3672,2694,510,208,302,-16
"17460",NA,39103,"Medina County, OH","County or equivalent",2007,169302,1498,801,1960,1159,693,82,611,4
"17660",NA,NA,"Coeur d'Alene, ID","Metropolitan Statistical Area",2007,134211,3681,752,1766,1014,3019,35,2984,-90
"17660",NA,16055,"Kootenai County, ID","County or equivalent",2007,134211,3681,752,1766,1014,3019,35,2984,-90
"17780",NA,NA,"College Station-Bryan, TX","Metropolitan Statistical Area",2007,203199,3152,1897,3041,1144,1273,883,390,-18
"17780",NA,48041,"Brazos County, TX","County or equivalent",2007,170884,3287,1792,2587,795,1517,858,659,-22
"17780",NA,48051,"Burleson County, TX","County or equivalent",2007,16562,-26,62,224,162,-85,10,-95,-3
"17780",NA,48395,"Robertson County, TX","County or equivalent",2007,15753,-109,43,230,187,-159,15,-174,7
"17820",NA,NA,"Colorado Springs, CO","Metropolitan Statistical Area",2007,607858,6421,6025,9399,3374,369,600,-231,27
"17820",NA,8041,"El Paso County, CO","County or equivalent",2007,586076,6146,5918,9182,3264,196,598,-402,32
"17820",NA,8119,"Teller County, CO","County or equivalent",2007,21782,275,107,217,110,173,2,171,-5
"17860",NA,NA,"Columbia, MO","Metropolitan Statistical Area",2007,161916,2501,1237,2221,984,1268,324,944,-4
"17860",NA,29019,"Boone County, MO","County or equivalent",2007,152049,2536,1231,2105,874,1310,322,988,-5
"17860",NA,29089,"Howard County, MO","County or equivalent",2007,9867,-35,6,116,110,-42,2,-44,1
"17900",NA,NA,"Columbia, SC","Metropolitan Statistical Area",2007,715678,12764,4044,9837,5793,8676,672,8004,44
"17900",NA,45017,"Calhoun County, SC","County or equivalent",2007,14747,-35,24,167,143,-54,1,-55,-5
"17900",NA,45039,"Fairfield County, SC","County or equivalent",2007,23284,-324,-21,275,296,-316,1,-317,13
"17900",NA,45055,"Kershaw County, SC","County or equivalent",2007,58138,1128,279,829,550,828,11,817,21
"17900",NA,45063,"Lexington County, SC","County or equivalent",2007,242797,4840,1453,3369,1916,3418,280,3138,-31
"17900",NA,45079,"Richland County, SC","County or equivalent",2007,358020,7173,2228,4928,2700,4903,290,4613,42
"17900",NA,45081,"Saluda County, SC","County or equivalent",2007,18692,-18,81,269,188,-103,89,-192,4
"17980",NA,NA,"Columbus, GA-AL","Metropolitan Statistical Area",2007,286889,-3078,1850,4593,2743,-5105,87,-5192,177
"17980",NA,1113,"Russell County, AL","County or equivalent",2007,50187,545,140,734,594,397,35,362,8
"17980",NA,13053,"Chattahoochee County, GA","County or equivalent",2007,13901,443,213,230,17,228,-86,314,2
"17980",NA,13145,"Harris County, GA","County or equivalent",2007,29014,738,131,351,220,597,6,591,10
"17980",NA,13197,"Marion County, GA","County or equivalent",2007,6980,-33,48,104,56,-71,16,-87,-10
"17980",NA,13215,"Muscogee County, GA","County or equivalent",2007,186807,-4771,1318,3174,1856,-6256,116,-6372,167
"18020",NA,NA,"Columbus, IN","Metropolitan Statistical Area",2007,74578,689,400,1053,653,297,177,120,-8
"18020",NA,18005,"Bartholomew County, IN","County or equivalent",2007,74578,689,400,1053,653,297,177,120,-8
"18140",NA,NA,"Columbus, OH","Metropolitan Statistical Area",2007,1753010,20532,14040,27157,13117,6562,3340,3222,-70
"18140",NA,39041,"Delaware County, OH","County or equivalent",2007,160358,5043,1587,2401,814,3478,50,3428,-22
"18140",NA,39045,"Fairfield County, OH","County or equivalent",2007,141045,1658,666,1763,1097,990,14,976,2
"18140",NA,39049,"Franklin County, OH","County or equivalent",2007,1116949,9859,10166,18621,8455,-221,3204,-3425,-86
"18140",NA,39089,"Licking County, OH","County or equivalent",2007,156734,1419,750,2116,1366,636,40,596,33
"18140",NA,39097,"Madison County, OH","County or equivalent",2007,41673,414,166,509,343,244,18,226,4
"18140",NA,39117,"Morrow County, OH","County or equivalent",2007,34477,288,156,429,273,151,3,148,-19
"18140",NA,39129,"Pickaway County, OH","County or equivalent",2007,54163,855,145,625,480,690,1,689,20
"18140",NA,39159,"Union County, OH","County or equivalent",2007,47611,996,404,693,289,594,10,584,-2
"18580",NA,NA,"Corpus Christi, TX","Metropolitan Statistical Area",2007,413054,393,3123,6478,3355,-2757,342,-3099,27
"18580",NA,48007,"Aransas County, TX","County or equivalent",2007,24549,153,-40,267,307,189,28,161,4
"18580",NA,48355,"Nueces County, TX","County or equivalent",2007,320120,362,2564,5069,2505,-2209,333,-2542,7
"18580",NA,48409,"San Patricio County, TX","County or equivalent",2007,68385,-122,599,1142,543,-737,-19,-718,16
"18700",NA,NA,"Corvallis, OR","Metropolitan Statistical Area",2007,81151,1041,279,804,525,794,269,525,-32
"18700",NA,41003,"Benton County, OR","County or equivalent",2007,81151,1041,279,804,525,794,269,525,-32
"19060",NA,NA,"Cumberland, MD-WV","Metropolitan Statistical Area",2007,99302,205,-173,985,1158,403,12,391,-25
"19060",NA,24001,"Allegany County, MD","County or equivalent",2007,72603,188,-177,693,870,359,8,351,6
"19060",NA,54057,"Mineral County, WV","County or equivalent",2007,26699,17,4,292,288,44,4,40,-31
"19100",NA,NA,"Dallas-Fort Worth-Arlington, TX","Metropolitan Statistical Area",2007,6153474,157878,69060,103652,34592,84454,32194,52260,4364
"19100",19124,NA,"Dallas-Plano-Irving, TX","Metropolitan Division",2007,4128967,102721,48088,69964,21876,50690,24911,25779,3943
"19100",19124,48085,"Collin County, TX","County or equivalent",2007,730906,33295,8416,11130,2714,24737,2532,22205,142
"19100",19124,48113,"Dallas County, TX","County or equivalent",2007,2383179,27979,28975,42963,13988,-4523,20291,-24814,3527
"19100",19124,48119,"Delta County, TX","County or equivalent",2007,5368,-124,9,62,53,-136,0,-136,3
"19100",19124,48121,"Denton County, TX","County or equivalent",2007,613660,25579,7365,9651,2286,18072,1426,16646,142
"19100",19124,48139,"Ellis County, TX","County or equivalent",2007,142998,5522,1371,2287,916,4160,285,3875,-9
"19100",19124,48231,"Hunt County, TX","County or equivalent",2007,82705,490,432,1176,744,55,155,-100,3
"19100",19124,48257,"Kaufman County, TX","County or equivalent",2007,96458,4604,819,1591,772,3701,147,3554,84
"19100",19124,48397,"Rockwall County, TX","County or equivalent",2007,73693,5376,701,1104,403,4624,75,4549,51
"19100",23104,NA,"Fort Worth-Arlington, TX","Metropolitan Division",2007,2024507,55157,20972,33688,12716,33764,7283,26481,421
"19100",23104,48251,"Johnson County, TX","County or equivalent",2007,149364,3450,962,2091,1129,2474,197,2277,14
"19100",23104,48367,"Parker County, TX","County or equivalent",2007,108433,3890,536,1365,829,3297,61,3236,57
"19100",23104,48439,"Tarrant County, TX","County or equivalent",2007,1709249,47034,19175,29476,10301,27508,6937,20571,351
"19100",23104,48497,"Wise County, TX","County or equivalent",2007,57461,783,299,756,457,485,88,397,-1
"19140",NA,NA,"Dalton, GA","Metropolitan Statistical Area",2007,133167,1258,1471,2478,1007,-180,756,-936,-33
"19140",NA,13213,"Murray County, GA","County or equivalent",2007,40534,-58,309,597,288,-351,48,-399,-16
"19140",NA,13313,"Whitfield County, GA","County or equivalent",2007,92633,1316,1162,1881,719,171,708,-537,-17
"19180",NA,NA,"Danville, IL","Metropolitan Statistical Area",2007,81167,-474,211,1121,910,-705,37,-742,20
"19180",NA,17183,"Vermilion County, IL","County or equivalent",2007,81167,-474,211,1121,910,-705,37,-742,20
"19260",NA,NA,"Danville, VA","Metropolitan Statistical Area",2007,105948,-176,-38,1338,1376,-119,66,-185,-19
"19260",NA,51143,"Pittsylvania County, VA","County or equivalent",2007,60980,124,93,717,624,44,32,12,-13
"19260",NA,51590,"Danville city, VA","County or equivalent",2007,44968,-300,-131,621,752,-163,34,-197,-6
"19340",NA,NA,"Davenport-Moline-Rock Island, IA-IL","Metropolitan Statistical Area",2007,375638,1712,1612,4996,3384,52,420,-368,48
"19340",NA,17073,"Henry County, IL","County or equivalent",2007,49604,56,40,552,512,0,19,-19,16
"19340",NA,17131,"Mercer County, IL","County or equivalent",2007,16453,-70,0,182,182,-73,1,-74,3
"19340",NA,17161,"Rock Island County, IL","County or equivalent",2007,147136,757,444,1888,1444,299,224,75,14
"19340",NA,19163,"Scott County, IA","County or equivalent",2007,162445,969,1128,2374,1246,-174,176,-350,15
"19380",NA,NA,"Dayton, OH","Metropolitan Statistical Area",2007,838828,-2154,2941,10983,8042,-5676,441,-6117,581
"19380",NA,39057,"Greene County, OH","County or equivalent",2007,158594,1033,593,1817,1224,-69,140,-209,509
"19380",NA,39109,"Miami County, OH","County or equivalent",2007,100846,-12,277,1225,948,-303,43,-346,14
"19380",NA,39113,"Montgomery County, OH","County or equivalent",2007,537756,-2962,1981,7435,5454,-5008,249,-5257,65
"19380",NA,39135,"Preble County, OH","County or equivalent",2007,41632,-213,90,506,416,-296,9,-305,-7
"19460",NA,NA,"Decatur, AL","Metropolitan Statistical Area",2007,148995,1209,395,1938,1543,836,150,686,-22
"19460",NA,1079,"Lawrence County, AL","County or equivalent",2007,34206,295,60,409,349,226,8,218,9
"19460",NA,1103,"Morgan County, AL","County or equivalent",2007,114789,914,335,1529,1194,610,142,468,-31
"19500",NA,NA,"Decatur, IL","Metropolitan Statistical Area",2007,108664,-418,232,1428,1196,-682,40,-722,32
"19500",NA,17115,"Macon County, IL","County or equivalent",2007,108664,-418,232,1428,1196,-682,40,-722,32
"19660",NA,NA,"Deltona-Daytona Beach-Ormond Beach, FL","Metropolitan Statistical Area",2007,499734,4713,-812,5351,6163,5238,685,4553,287
"19660",NA,12127,"Volusia County, FL","County or equivalent",2007,499734,4713,-812,5351,6163,5238,685,4553,287
"19740",NA,NA,"Denver-Aurora, CO /1","Metropolitan Statistical Area",2007,2453393,50280,24515,38314,13799,26015,10243,15772,-250
"19740",NA,8001,"Adams County, CO /1","County or equivalent",2007,420833,10379,5769,7968,2199,4664,1963,2701,-54
"19740",NA,8005,"Arapahoe County, CO /1","County or equivalent",2007,543307,10904,5314,8393,3079,5671,2043,3628,-81
"19740",NA,8014,"Broomfield County, CO /1","County or equivalent",2007,53620,2166,500,729,229,1633,87,1546,33
"19740",NA,8019,"Clear Creek County, CO /1","County or equivalent",2007,8933,38,45,79,34,10,1,9,-17
"19740",NA,8031,"Denver County, CO /1","County or equivalent",2007,582860,10739,6320,10239,3919,4581,4934,-353,-162
"19740",NA,8035,"Douglas County, CO /1","County or equivalent",2007,271032,11826,3508,4238,730,8273,314,7959,45
"19740",NA,8039,"Elbert County, CO /1","County or equivalent",2007,22656,8,85,189,104,-78,4,-82,1
"19740",NA,8047,"Gilpin County, CO /1","County or equivalent",2007,5085,38,48,59,11,-9,1,-10,-1
"19740",NA,8059,"Jefferson County, CO /1","County or equivalent",2007,528114,3874,2842,6274,3432,1037,889,148,-5
"19740",NA,8093,"Park County, CO /1","County or equivalent",2007,16953,308,84,146,62,233,7,226,-9
"19780",NA,NA,"Des Moines-West Des Moines, IA","Metropolitan Statistical Area",2007,545669,11010,5041,8786,3745,5928,1088,4840,41
"19780",NA,19049,"Dallas County, IA","County or equivalent",2007,57201,2589,594,934,340,1955,56,1899,40
"19780",NA,19077,"Guthrie County, IA","County or equivalent",2007,11015,-51,-6,116,122,-33,2,-35,-12
"19780",NA,19121,"Madison County, IA","County or equivalent",2007,15377,183,62,190,128,123,-1,124,-2
"19780",NA,19153,"Polk County, IA","County or equivalent",2007,417668,7579,4208,7014,2806,3349,1023,2326,22
"19780",NA,19181,"Warren County, IA","County or equivalent",2007,44408,710,183,532,349,534,8,526,-7
"19820",NA,NA,"Detroit-Warren-Livonia, MI","Metropolitan Statistical Area",2007,4457523,-29097,19327,56972,37645,-49027,10054,-59081,603
"19820",19804,NA,"Detroit-Livonia-Dearborn, MI","Metropolitan Division",2007,1981654,-27550,9363,27480,18117,-37028,4605,-41633,115
"19820",19804,26163,"Wayne County, MI","County or equivalent",2007,1981654,-27550,9363,27480,18117,-37028,4605,-41633,115
"19820",47644,NA,"Warren-Troy-Farmington Hills, MI","Metropolitan Division",2007,2475869,-1547,9964,29492,19528,-11999,5449,-17448,488
"19820",47644,26087,"Lapeer County, MI","County or equivalent",2007,91723,-483,337,990,653,-855,32,-887,35
"19820",47644,26093,"Livingston County, MI","County or equivalent",2007,182655,580,896,2006,1110,-276,125,-401,-40
"19820",47644,26099,"Macomb County, MI","County or equivalent",2007,829364,1082,2783,10104,7321,-1796,1495,-3291,95
"19820",47644,26125,"Oakland County, MI","County or equivalent",2007,1202287,-2379,5304,14284,8980,-8063,3729,-11792,380
"19820",47644,26147,"St. Clair County, MI","County or equivalent",2007,169840,-347,644,2108,1464,-1009,68,-1077,18
"20020",NA,NA,"Dothan, AL","Metropolitan Statistical Area",2007,139336,1878,373,1852,1479,1536,48,1488,-31
"20020",NA,1061,"Geneva County, AL","County or equivalent",2007,25694,-55,-21,299,320,-34,3,-37,0
"20020",NA,1067,"Henry County, AL","County or equivalent",2007,16579,74,-33,184,217,101,7,94,6
"20020",NA,1069,"Houston County, AL","County or equivalent",2007,97063,1859,427,1369,942,1469,38,1431,-37
"20100",NA,NA,"Dover, DE","Metropolitan Statistical Area",2007,151705,4185,1076,2261,1185,3158,74,3084,-49
"20100",NA,10001,"Kent County, DE","County or equivalent",2007,151705,4185,1076,2261,1185,3158,74,3084,-49
"20220",NA,NA,"Dubuque, IA","Metropolitan Statistical Area",2007,92296,898,410,1253,843,469,86,383,19
"20220",NA,19061,"Dubuque County, IA","County or equivalent",2007,92296,898,410,1253,843,469,86,383,19
"20260",NA,NA,"Duluth, MN-WI","Metropolitan Statistical Area",2007,273757,75,199,3102,2903,-155,84,-239,31
"20260",NA,27017,"Carlton County, MN","County or equivalent",2007,33623,-54,78,428,350,-141,5,-146,9
"20260",NA,27137,"St. Louis County, MN","County or equivalent",2007,196420,202,85,2187,2102,108,56,52,9
"20260",NA,55031,"Douglas County, WI","County or equivalent",2007,43714,-73,36,487,451,-122,23,-145,13
"20500",NA,NA,"Durham, NC","Metropolitan Statistical Area",2007,478003,10869,3635,6925,3290,7182,2409,4773,52
"20500",NA,37037,"Chatham County, NC","County or equivalent",2007,61029,1468,217,745,528,1230,278,952,21
"20500",NA,37063,"Durham County, NC","County or equivalent",2007,255360,6503,2680,4365,1685,3788,1540,2248,35
"20500",NA,37135,"Orange County, NC","County or equivalent",2007,124308,2644,691,1349,658,1962,576,1386,-9
"20500",NA,37145,"Person County, NC","County or equivalent",2007,37306,254,47,466,419,202,15,187,5
"20740",NA,NA,"Eau Claire, WI","Metropolitan Statistical Area",2007,157549,1539,791,2034,1243,758,61,697,-10
"20740",NA,55017,"Chippewa County, WI","County or equivalent",2007,60000,576,322,822,500,244,12,232,10
"20740",NA,55035,"Eau Claire County, WI","County or equivalent",2007,97549,963,469,1212,743,514,49,465,-20
"20940",NA,NA,"El Centro, CA","Metropolitan Statistical Area",2007,160830,3831,2337,3291,954,1500,843,657,-6
"20940",NA,6025,"Imperial County, CA","County or equivalent",2007,160830,3831,2337,3291,954,1500,843,657,-6
"21060",NA,NA,"Elizabethtown, KY","Metropolitan Statistical Area",2007,111592,991,899,1783,884,83,-1,84,9
"21060",NA,21093,"Hardin County, KY","County or equivalent",2007,97924,932,890,1611,721,31,-2,33,11
"21060",NA,21123,"Larue County, KY","County or equivalent",2007,13668,59,9,172,163,52,1,51,-2
"21140",NA,NA,"Elkhart-Goshen, IN","Metropolitan Statistical Area",2007,197639,1298,2083,3490,1407,-808,667,-1475,23
"21140",NA,18039,"Elkhart County, IN","County or equivalent",2007,197639,1298,2083,3490,1407,-808,667,-1475,23
"21300",NA,NA,"Elmira, NY","Metropolitan Statistical Area",2007,87913,-176,201,1082,881,-360,33,-393,-17
"21300",NA,36015,"Chemung County, NY","County or equivalent",2007,87913,-176,201,1082,881,-360,33,-393,-17
"21340",NA,NA,"El Paso, TX","Metropolitan Statistical Area",2007,729969,7511,10190,14568,4378,-2583,3323,-5906,-96
"21340",NA,48141,"El Paso County, TX","County or equivalent",2007,729969,7511,10190,14568,4378,-2583,3323,-5906,-96
"21500",NA,NA,"Erie, PA","Metropolitan Statistical Area",2007,279293,-348,715,3369,2654,-1090,330,-1420,27
"21500",NA,42049,"Erie County, PA","County or equivalent",2007,279293,-348,715,3369,2654,-1090,330,-1420,27
"21660",NA,NA,"Eugene-Springfield, OR","Metropolitan Statistical Area",2007,342781,3359,897,3801,2904,2485,540,1945,-23
"21660",NA,41039,"Lane County, OR","County or equivalent",2007,342781,3359,897,3801,2904,2485,540,1945,-23
"21780",NA,NA,"Evansville, IN-KY","Metropolitan Statistical Area",2007,349723,1127,1190,4638,3448,-86,168,-254,23
"21780",NA,18051,"Gibson County, IN","County or equivalent",2007,32709,-234,118,429,311,-340,11,-351,-12
"21780",NA,18129,"Posey County, IN","County or equivalent",2007,26208,-132,27,243,216,-151,8,-159,-8
"21780",NA,18163,"Vanderburgh County, IN","County or equivalent",2007,174769,495,664,2475,1811,-217,101,-318,48
"21780",NA,18173,"Warrick County, IN","County or equivalent",2007,56996,925,222,703,481,714,12,702,-11
"21780",NA,21101,"Henderson County, KY","County or equivalent",2007,45183,57,139,602,463,-87,18,-105,5
"21780",NA,21233,"Webster County, KY","County or equivalent",2007,13858,16,20,186,166,-5,18,-23,1
"21820",NA,NA,"Fairbanks, AK","Metropolitan Statistical Area",2007,97986,3183,1367,1702,335,1800,-27,1827,16
"21820",NA,2090,"Fairbanks North Star Borough, AK","County or equivalent",2007,97986,3183,1367,1702,335,1800,-27,1827,16
"22020",NA,NA,"Fargo, ND-MN","Metropolitan Statistical Area",2007,191930,2982,1609,2822,1213,1370,279,1091,3
"22020",NA,27027,"Clay County, MN","County or equivalent",2007,54595,529,336,767,431,187,30,157,6
"22020",NA,38017,"Cass County, ND","County or equivalent",2007,137335,2453,1273,2055,782,1183,249,934,-3
"22140",NA,NA,"Farmington, NM","Metropolitan Statistical Area",2007,122239,619,1251,2116,865,-644,93,-737,12
"22140",NA,35045,"San Juan County, NM","County or equivalent",2007,122239,619,1251,2116,865,-644,93,-737,12
"22180",NA,NA,"Fayetteville, NC","Metropolitan Statistical Area",2007,351082,3029,4488,6701,2213,-1420,-258,-1162,-39
"22180",NA,37051,"Cumberland County, NC","County or equivalent",2007,308947,1963,3887,5833,1946,-1888,-336,-1552,-36
"22180",NA,37093,"Hoke County, NC","County or equivalent",2007,42135,1066,601,868,267,468,78,390,-3
"22220",NA,NA,"Fayetteville-Springdale-Rogers, AR-MO","Metropolitan Statistical Area",2007,434643,12197,4647,7534,2887,7535,1111,6424,15
"22220",NA,5007,"Benton County, AR","County or equivalent",2007,202639,7981,2107,3406,1299,5820,385,5435,54
"22220",NA,5087,"Madison County, AR","County or equivalent",2007,15389,219,65,219,154,164,6,158,-10
"22220",NA,5143,"Washington County, AR","County or equivalent",2007,193812,3992,2334,3535,1201,1682,662,1020,-24
"22220",NA,29119,"McDonald County, MO","County or equivalent",2007,22803,5,141,374,233,-131,58,-189,-5
"22380",NA,NA,"Flagstaff, AZ","Metropolitan Statistical Area",2007,127350,1384,1554,2131,577,-109,152,-261,-61
"22380",NA,4005,"Coconino County, AZ","County or equivalent",2007,127350,1384,1554,2131,577,-109,152,-261,-61
"22420",NA,NA,"Flint, MI","Metropolitan Statistical Area",2007,434027,-3418,2348,6105,3757,-5806,119,-5925,40
"22420",NA,26049,"Genesee County, MI","County or equivalent",2007,434027,-3418,2348,6105,3757,-5806,119,-5925,40
"22500",NA,NA,"Florence, SC","Metropolitan Statistical Area",2007,198537,936,697,2797,2100,209,73,136,30
"22500",NA,45031,"Darlington County, SC","County or equivalent",2007,66806,-44,81,841,760,-134,18,-152,9
"22500",NA,45041,"Florence County, SC","County or equivalent",2007,131731,980,616,1956,1340,343,55,288,21
"22520",NA,NA,"Florence-Muscle Shoals, AL","Metropolitan Statistical Area",2007,143007,632,41,1639,1598,556,46,510,35
"22520",NA,1033,"Colbert County, AL","County or equivalent",2007,54519,87,-21,633,654,101,11,90,7
"22520",NA,1077,"Lauderdale County, AL","County or equivalent",2007,88488,545,62,1006,944,455,35,420,28
"22540",NA,NA,"Fond du Lac, WI","Metropolitan Statistical Area",2007,99043,376,336,1248,912,32,83,-51,8
"22540",NA,55039,"Fond du Lac County, WI","County or equivalent",2007,99043,376,336,1248,912,32,83,-51,8
"22660",NA,NA,"Fort Collins-Loveland, CO","Metropolitan Statistical Area",2007,286727,5783,2122,3596,1474,3710,487,3223,-49
"22660",NA,8069,"Larimer County, CO","County or equivalent",2007,286727,5783,2122,3596,1474,3710,487,3223,-49
"22900",NA,NA,"Fort Smith, AR-OK","Metropolitan Statistical Area",2007,288913,3015,1726,4395,2669,1283,414,869,6
"22900",NA,5033,"Crawford County, AR","County or equivalent",2007,58939,907,370,860,490,533,18,515,4
"22900",NA,5047,"Franklin County, AR","County or equivalent",2007,18152,111,29,229,200,78,8,70,4
"22900",NA,5131,"Sebastian County, AR","County or equivalent",2007,121386,1367,933,1961,1028,433,314,119,1
"22900",NA,40079,"Le Flore County, OK","County or equivalent",2007,49510,390,214,760,546,167,67,100,9
"22900",NA,40135,"Sequoyah County, OK","County or equivalent",2007,40926,240,180,585,405,72,7,65,-12
"23020",NA,NA,"Fort Walton Beach-Crestview-Destin, FL","Metropolitan Statistical Area",2007,181087,-1747,1272,2690,1418,-2915,-55,-2860,-104
"23020",NA,12091,"Okaloosa County, FL","County or equivalent",2007,181087,-1747,1272,2690,1418,-2915,-55,-2860,-104
"23060",NA,NA,"Fort Wayne, IN","Metropolitan Statistical Area",2007,409177,3492,2965,6171,3206,525,619,-94,2
"23060",NA,18003,"Allen County, IN","County or equivalent",2007,348761,3232,2731,5384,2653,497,610,-113,4
"23060",NA,18179,"Wells County, IN","County or equivalent",2007,27899,48,113,380,267,-57,1,-58,-8
"23060",NA,18183,"Whitley County, IN","County or equivalent",2007,32517,212,121,407,286,85,8,77,6
"23420",NA,NA,"Fresno, CA","Metropolitan Statistical Area",2007,894748,12577,10876,16977,6101,1620,3668,-2048,81
"23420",NA,6019,"Fresno County, CA","County or equivalent",2007,894748,12577,10876,16977,6101,1620,3668,-2048,81
"23460",NA,NA,"Gadsden, AL","Metropolitan Statistical Area",2007,103080,329,-12,1329,1341,315,66,249,26
"23460",NA,1055,"Etowah County, AL","County or equivalent",2007,103080,329,-12,1329,1341,315,66,249,26
"23540",NA,NA,"Gainesville, FL","Metropolitan Statistical Area",2007,256417,3502,1358,3149,1791,2222,678,1544,-78
"23540",NA,12001,"Alachua County, FL","County or equivalent",2007,239434,3094,1314,2935,1621,1859,675,1184,-79
"23540",NA,12041,"Gilchrist County, FL","County or equivalent",2007,16983,408,44,214,170,363,3,360,1
"23580",NA,NA,"Gainesville, GA","Metropolitan Statistical Area",2007,178620,7176,1983,3162,1179,5208,1288,3920,-15
"23580",NA,13139,"Hall County, GA","County or equivalent",2007,178620,7176,1983,3162,1179,5208,1288,3920,-15
"24020",NA,NA,"Glens Falls, NY","Metropolitan Statistical Area",2007,128470,454,75,1330,1255,361,26,335,18
"24020",NA,36113,"Warren County, NY","County or equivalent",2007,65901,177,-18,635,653,194,21,173,1
"24020",NA,36115,"Washington County, NY","County or equivalent",2007,62569,277,93,695,602,167,5,162,17
"24140",NA,NA,"Goldsboro, NC","Metropolitan Statistical Area",2007,113396,793,746,1806,1060,78,137,-59,-31
"24140",NA,37191,"Wayne County, NC","County or equivalent",2007,113396,793,746,1806,1060,78,137,-59,-31
"24220",NA,NA,"Grand Forks, ND-MN","Metropolitan Statistical Area",2007,96781,-938,556,1366,810,-1520,69,-1589,26
"24220",NA,27119,"Polk County, MN","County or equivalent",2007,30755,72,38,408,370,40,8,32,-6
"24220",NA,38035,"Grand Forks County, ND","County or equivalent",2007,66026,-1010,518,958,440,-1560,61,-1621,32
"24300",NA,NA,"Grand Junction, CO","Metropolitan Statistical Area",2007,138883,5015,829,2033,1204,4165,92,4073,21
"24300",NA,8077,"Mesa County, CO","County or equivalent",2007,138883,5015,829,2033,1204,4165,92,4073,21
"24340",NA,NA,"Grand Rapids-Wyoming, MI","Metropolitan Statistical Area",2007,774931,3666,6575,11800,5225,-2940,1687,-4627,31
"24340",NA,26015,"Barry County, MI","County or equivalent",2007,59115,231,293,759,466,-46,3,-49,-16
"24340",NA,26067,"Ionia County, MI","County or equivalent",2007,64041,-34,482,899,417,-500,11,-511,-16
"24340",NA,26081,"Kent County, MI","County or equivalent",2007,602676,3477,5563,9513,3950,-2170,1650,-3820,84
"24340",NA,26123,"Newaygo County, MI","County or equivalent",2007,49099,-8,237,629,392,-224,23,-247,-21
"24500",NA,NA,"Great Falls, MT","Metropolitan Statistical Area",2007,81784,-70,507,1177,670,-557,-25,-532,-20
"24500",NA,30013,"Cascade County, MT","County or equivalent",2007,81784,-70,507,1177,670,-557,-25,-532,-20
"24540",NA,NA,"Greeley, CO /1","Metropolitan Statistical Area",2007,242648,7938,2853,4128,1275,5002,686,4316,83
"24540",NA,8123,"Weld County, CO /1","County or equivalent",2007,242648,7938,2853,4128,1275,5002,686,4316,83
"24580",NA,NA,"Green Bay, WI","Metropolitan Statistical Area",2007,301056,2749,1993,4128,2135,778,386,392,-22
"24580",NA,55009,"Brown County, WI","County or equivalent",2007,243166,2762,1907,3526,1619,882,381,501,-27
"24580",NA,55061,"Kewaunee County, WI","County or equivalent",2007,20463,-87,15,207,192,-108,3,-111,6
"24580",NA,55083,"Oconto County, WI","County or equivalent",2007,37427,74,71,395,324,4,2,2,-1
"24660",NA,NA,"Greensboro-High Point, NC","Metropolitan Statistical Area",2007,695738,11180,3573,9360,5787,7448,2146,5302,159
"24660",NA,37081,"Guilford County, NC","County or equivalent",2007,464034,9683,2929,6411,3482,6618,1518,5100,136
"24660",NA,37151,"Randolph County, NC","County or equivalent",2007,139512,1286,615,1844,1229,647,483,164,24
"24660",NA,37157,"Rockingham County, NC","County or equivalent",2007,92192,211,29,1105,1076,183,145,38,-1
"24780",NA,NA,"Greenville, NC","Metropolitan Statistical Area",2007,172838,4421,1338,2582,1244,3067,298,2769,16
"24780",NA,37079,"Greene County, NC","County or equivalent",2007,20700,450,101,269,168,349,64,285,0
"24780",NA,37147,"Pitt County, NC","County or equivalent",2007,152138,3971,1237,2313,1076,2718,234,2484,16
"24860",NA,NA,"Greenville-Mauldin-Easley, SC","Metropolitan Statistical Area",2007,612567,13058,3177,8448,5271,9741,1219,8522,140
"24860",NA,45045,"Greenville County, SC","County or equivalent",2007,427428,11753,2761,6255,3494,8865,995,7870,127
"24860",NA,45059,"Laurens County, SC","County or equivalent",2007,69533,163,82,867,785,79,62,17,2
"24860",NA,45077,"Pickens County, SC","County or equivalent",2007,115606,1142,334,1326,992,797,162,635,11
"25060",NA,NA,"Gulfport-Biloxi, MS","Metropolitan Statistical Area",2007,231656,4458,1680,3645,1965,3090,58,3032,-312
"25060",NA,28045,"Hancock County, MS","County or equivalent",2007,39741,888,199,508,309,769,7,762,-80
"25060",NA,28047,"Harrison County, MS","County or equivalent",2007,176366,3411,1398,2902,1504,2247,50,2197,-234
"25060",NA,28131,"Stone County, MS","County or equivalent",2007,15549,159,83,235,152,74,1,73,2
"25180",NA,NA,"Hagerstown-Martinsburg, MD-WV","Metropolitan Statistical Area",2007,260539,4665,1122,3374,2252,3490,77,3413,53
"25180",NA,24043,"Washington County, MD","County or equivalent",2007,144662,1678,548,1867,1319,1093,56,1037,37
"25180",NA,54003,"Berkeley County, WV","County or equivalent",2007,99531,2808,612,1352,740,2177,15,2162,19
"25180",NA,54065,"Morgan County, WV","County or equivalent",2007,16346,179,-38,155,193,220,6,214,-3
"25260",NA,NA,"Hanford-Corcoran, CA","Metropolitan Statistical Area",2007,148232,2509,1915,2701,786,606,378,228,-12
"25260",NA,6031,"Kings County, CA","County or equivalent",2007,148232,2509,1915,2701,786,606,378,228,-12
"25420",NA,NA,"Harrisburg-Carlisle, PA","Metropolitan Statistical Area",2007,527880,3780,1547,6460,4913,2323,624,1699,-90
"25420",NA,42041,"Cumberland County, PA","County or equivalent",2007,227203,1715,276,2434,2158,1455,224,1231,-16
"25420",NA,42043,"Dauphin County, PA","County or equivalent",2007,255592,1781,1095,3465,2370,763,399,364,-77
"25420",NA,42099,"Perry County, PA","County or equivalent",2007,45085,284,176,561,385,105,1,104,3
"25500",NA,NA,"Harrisonburg, VA","Metropolitan Statistical Area",2007,117429,1367,640,1508,868,722,320,402,5
"25500",NA,51165,"Rockingham County, VA","County or equivalent",2007,73673,1053,326,928,602,708,95,613,19
"25500",NA,51660,"Harrisonburg city, VA","County or equivalent",2007,43756,314,314,580,266,14,225,-211,-14
"25540",NA,NA,"Hartford-West Hartford-East Hartford, CT","Metropolitan Statistical Area",2007,1186485,3200,4157,13712,9555,-892,3315,-4207,-65
"25540",NA,9003,"Hartford County, CT","County or equivalent",2007,875075,2130,3226,10621,7395,-1059,2916,-3975,-37
"25540",NA,9007,"Middlesex County, CT","County or equivalent",2007,163827,699,407,1707,1300,290,205,85,2
"25540",NA,9013,"Tolland County, CT","County or equivalent",2007,147583,371,524,1384,860,-123,194,-317,-30
"25620",NA,NA,"Hattiesburg, MS","Metropolitan Statistical Area",2007,138469,3386,1200,2325,1125,2181,83,2098,5
"25620",NA,28035,"Forrest County, MS","County or equivalent",2007,78611,1425,626,1303,677,799,81,718,0
"25620",NA,28073,"Lamar County, MS","County or equivalent",2007,47648,1732,506,817,311,1221,3,1218,5
"25620",NA,28111,"Perry County, MS","County or equivalent",2007,12210,229,68,205,137,161,-1,162,0
"25860",NA,NA,"Hickory-Lenoir-Morganton, NC","Metropolitan Statistical Area",2007,359569,3338,1293,4549,3256,1970,740,1230,75
"25860",NA,37003,"Alexander County, NC","County or equivalent",2007,36298,368,116,435,319,244,28,216,8
"25860",NA,37023,"Burke County, NC","County or equivalent",2007,88787,128,222,1026,804,-111,159,-270,17
"25860",NA,37027,"Caldwell County, NC","County or equivalent",2007,79361,367,176,962,786,183,73,110,8
"25860",NA,37035,"Catawba County, NC","County or equivalent",2007,155123,2475,779,2126,1347,1654,480,1174,42
"25980",NA,NA,"Hinesville-Fort Stewart, GA","Metropolitan Statistical Area",2007,71726,264,1205,1603,398,-950,-67,-883,9
"25980",NA,13179,"Liberty County, GA","County or equivalent",2007,60430,110,1080,1413,333,-980,-90,-890,10
"25980",NA,13183,"Long County, GA","County or equivalent",2007,11296,154,125,190,65,30,23,7,-1
"26100",NA,NA,"Holland-Grand Haven, MI","Metropolitan Statistical Area",2007,258461,1949,2097,3608,1511,-177,266,-443,29
"26100",NA,26139,"Ottawa County, MI","County or equivalent",2007,258461,1949,2097,3608,1511,-177,266,-443,29
"26180",NA,NA,"Honolulu, HI","Metropolitan Statistical Area",2007,900525,-3609,7312,13677,6365,-11433,2435,-13868,512
"26180",NA,15003,"Honolulu County, HI","County or equivalent",2007,900525,-3609,7312,13677,6365,-11433,2435,-13868,512
"26300",NA,NA,"Hot Springs, AR","Metropolitan Statistical Area",2007,96245,1118,-4,1220,1224,1084,51,1033,38
"26300",NA,5051,"Garland County, AR","County or equivalent",2007,96245,1118,-4,1220,1224,1084,51,1033,38
"26380",NA,NA,"Houma-Bayou Cane-Thibodaux, LA","Metropolitan Statistical Area",2007,201020,202,1366,3075,1709,-1006,89,-1095,-158
"26380",NA,22057,"Lafourche Parish, LA","County or equivalent",2007,92704,-71,531,1310,779,-549,42,-591,-53
"26380",NA,22109,"Terrebonne Parish, LA","County or equivalent",2007,108316,273,835,1765,930,-457,47,-504,-105
"26420",NA,NA,"Houston-Sugar Land-Baytown, TX","Metropolitan Statistical Area",2007,5597958,112413,63131,95104,31973,49311,29330,19981,-29
"26420",NA,48015,"Austin County, TX","County or equivalent",2007,26510,448,85,362,277,355,47,308,8
"26420",NA,48039,"Brazoria County, TX","County or equivalent",2007,293091,9387,2973,4825,1852,6307,547,5760,107
"26420",NA,48071,"Chambers County, TX","County or equivalent",2007,28740,438,221,406,185,219,36,183,-2
"26420",NA,48157,"Fort Bend County, TX","County or equivalent",2007,507576,23416,5211,7249,2038,17890,1451,16439,315
"26420",NA,48167,"Galveston County, TX","County or equivalent",2007,283082,4319,1882,4247,2365,2574,639,1935,-137
"26420",NA,48201,"Harris County, TX","County or equivalent",2007,3912196,53764,48436,69876,21440,5726,25523,-19797,-398
"26420",NA,48291,"Liberty County, TX","County or equivalent",2007,74930,460,445,1118,673,5,78,-73,10
"26420",NA,48339,"Montgomery County, TX","County or equivalent",2007,411254,18931,3538,6164,2626,15337,915,14422,56
"26420",NA,48407,"San Jacinto County, TX","County or equivalent",2007,24764,412,0,257,257,404,18,386,8
"26420",NA,48473,"Waller County, TX","County or equivalent",2007,35815,838,340,600,260,494,76,418,4
"26580",NA,NA,"Huntington-Ashland, WV-KY-OH","Metropolitan Statistical Area",2007,283943,-284,98,3432,3334,-335,59,-394,-47
"26580",NA,21019,"Boyd County, KY","County or equivalent",2007,48480,-197,28,613,585,-201,6,-207,-24
"26580",NA,21089,"Greenup County, KY","County or equivalent",2007,37238,153,-11,384,395,159,-1,160,5
"26580",NA,39087,"Lawrence County, OH","County or equivalent",2007,62598,-47,60,799,739,-101,9,-110,-6
"26580",NA,54011,"Cabell County, WV","County or equivalent",2007,94410,83,48,1187,1139,18,37,-19,17
"26580",NA,54099,"Wayne County, WV","County or equivalent",2007,41217,-276,-27,449,476,-210,8,-218,-39
"26620",NA,NA,"Huntsville, AL","Metropolitan Statistical Area",2007,386322,8575,2014,5063,3049,6373,394,5979,188
"26620",NA,1083,"Limestone County, AL","County or equivalent",2007,73876,2146,324,944,620,1781,31,1750,41
"26620",NA,1089,"Madison County, AL","County or equivalent",2007,312446,6429,1690,4119,2429,4592,363,4229,147
"26820",NA,NA,"Idaho Falls, ID","Metropolitan Statistical Area",2007,119133,3868,1606,2406,800,2276,106,2170,-14
"26820",NA,16019,"Bonneville County, ID","County or equivalent",2007,96356,2935,1218,1909,691,1741,85,1656,-24
"26820",NA,16051,"Jefferson County, ID","County or equivalent",2007,22777,933,388,497,109,535,21,514,10
"26900",NA,NA,"Indianapolis-Carmel, IN","Metropolitan Statistical Area",2007,1692737,24489,13267,26098,12831,11113,2298,8815,109
"26900",NA,18011,"Boone County, IN","County or equivalent",2007,53979,1077,213,671,458,870,14,856,-6
"26900",NA,18013,"Brown County, IN","County or equivalent",2007,14641,-172,-34,103,137,-129,5,-134,-9
"26900",NA,18057,"Hamilton County, IN","County or equivalent",2007,260804,9193,2689,3835,1146,6478,229,6249,26
"26900",NA,18059,"Hancock County, IN","County or equivalent",2007,66107,1622,412,917,505,1201,5,1196,9
"26900",NA,18063,"Hendricks County, IN","County or equivalent",2007,134230,4424,873,1729,856,3502,54,3448,49
"26900",NA,18081,"Johnson County, IN","County or equivalent",2007,136032,3457,821,1899,1078,2627,72,2555,9
"26900",NA,18097,"Marion County, IN","County or equivalent",2007,876144,4075,7779,15137,7358,-3728,1850,-5578,24
"26900",NA,18109,"Morgan County, IN","County or equivalent",2007,69755,229,283,874,591,-64,9,-73,10
"26900",NA,18133,"Putnam County, IN","County or equivalent",2007,37139,287,91,397,306,206,11,195,-10
"26900",NA,18145,"Shelby County, IN","County or equivalent",2007,43906,297,140,536,396,150,49,101,7
"26980",NA,NA,"Iowa City, IA","Metropolitan Statistical Area",2007,146690,2402,1253,1976,723,1135,404,731,14
"26980",NA,19103,"Johnson County, IA","County or equivalent",2007,125454,2328,1174,1688,514,1134,399,735,20
"26980",NA,19183,"Washington County, IA","County or equivalent",2007,21236,74,79,288,209,1,5,-4,-6
"27060",NA,NA,"Ithaca, NY","Metropolitan Statistical Area",2007,100401,334,372,959,587,-32,530,-562,-6
"27060",NA,36109,"Tompkins County, NY","County or equivalent",2007,100401,334,372,959,587,-32,530,-562,-6
"27100",NA,NA,"Jackson, MI","Metropolitan Statistical Area",2007,162706,-161,631,2079,1448,-817,81,-898,25
"27100",NA,26075,"Jackson County, MI","County or equivalent",2007,162706,-161,631,2079,1448,-817,81,-898,25
"27140",NA,NA,"Jackson, MS","Metropolitan Statistical Area",2007,533794,3263,4342,8775,4433,-915,208,-1123,-164
"27140",NA,28029,"Copiah County, MS","County or equivalent",2007,29303,92,206,508,302,-117,1,-118,3
"27140",NA,28049,"Hinds County, MS","County or equivalent",2007,249155,-1889,2199,4146,1947,-4039,88,-4127,-49
"27140",NA,28089,"Madison County, MS","County or equivalent",2007,89321,2202,450,1483,1033,1829,36,1793,-77
"27140",NA,28121,"Rankin County, MS","County or equivalent",2007,138192,2909,1317,2197,880,1643,69,1574,-51
"27140",NA,28127,"Simpson County, MS","County or equivalent",2007,27823,-51,170,441,271,-231,14,-245,10
"27180",NA,NA,"Jackson, TN","Metropolitan Statistical Area",2007,112390,394,525,1591,1066,-141,107,-248,10
"27180",NA,47023,"Chester County, TN","County or equivalent",2007,16094,114,37,194,157,73,2,71,4
"27180",NA,47113,"Madison County, TN","County or equivalent",2007,96296,280,488,1397,909,-214,105,-319,6
"27260",NA,NA,"Jacksonville, FL","Metropolitan Statistical Area",2007,1297813,21318,8487,18818,10331,12715,1310,11405,116
"27260",NA,12003,"Baker County, FL","County or equivalent",2007,25691,663,167,393,226,503,2,501,-7
"27260",NA,12019,"Clay County, FL","County or equivalent",2007,181679,5578,1169,2435,1266,4326,102,4224,83
"27260",NA,12031,"Duval County, FL","County or equivalent",2007,846964,6179,6394,13242,6848,-236,1079,-1315,21
"27260",NA,12089,"Nassau County, FL","County or equivalent",2007,68321,1920,250,851,601,1626,24,1602,44
"27260",NA,12109,"St. Johns County, FL","County or equivalent",2007,175158,6978,507,1897,1390,6496,103,6393,-25
"27340",NA,NA,"Jacksonville, NC","Metropolitan Statistical Area",2007,163336,2440,2956,3771,815,-431,-587,156,-85
"27340",NA,37133,"Onslow County, NC","County or equivalent",2007,163336,2440,2956,3771,815,-431,-587,156,-85
"27500",NA,NA,"Janesville, WI","Metropolitan Statistical Area",2007,159398,1352,925,2198,1273,428,209,219,-1
"27500",NA,55105,"Rock County, WI","County or equivalent",2007,159398,1352,925,2198,1273,428,209,219,-1
"27620",NA,NA,"Jefferson City, MO","Metropolitan Statistical Area",2007,145170,685,903,1999,1096,-225,98,-323,7
"27620",NA,29027,"Callaway County, MO","County or equivalent",2007,43180,261,212,529,317,47,20,27,2
"27620",NA,29051,"Cole County, MO","County or equivalent",2007,73506,454,502,1043,541,-46,76,-122,-2
"27620",NA,29135,"Moniteau County, MO","County or equivalent",2007,15126,68,104,238,134,-39,2,-41,3
"27620",NA,29151,"Osage County, MO","County or equivalent",2007,13358,-98,85,189,104,-187,0,-187,4
"27740",NA,NA,"Johnson City, TN","Metropolitan Statistical Area",2007,193295,2070,51,2189,2138,2047,101,1946,-28
"27740",NA,47019,"Carter County, TN","County or equivalent",2007,59142,174,-58,615,673,233,17,216,-1
"27740",NA,47171,"Unicoi County, TN","County or equivalent",2007,17683,62,-59,194,253,115,-1,116,6
"27740",NA,47179,"Washington County, TN","County or equivalent",2007,116470,1834,168,1380,1212,1699,85,1614,-33
"27780",NA,NA,"Johnstown, PA","Metropolitan Statistical Area",2007,144996,-926,-354,1498,1852,-557,33,-590,-15
"27780",NA,42021,"Cambria County, PA","County or equivalent",2007,144996,-926,-354,1498,1852,-557,33,-590,-15
"27860",NA,NA,"Jonesboro, AR","Metropolitan Statistical Area",2007,115548,1097,666,1766,1100,444,100,344,-13
"27860",NA,5031,"Craighead County, AR","County or equivalent",2007,90727,1164,601,1382,781,575,90,485,-12
"27860",NA,5111,"Poinsett County, AR","County or equivalent",2007,24821,-67,65,384,319,-131,10,-141,-1
"27900",NA,NA,"Joplin, MO","Metropolitan Statistical Area",2007,171043,2707,1107,2699,1592,1598,147,1451,2
"27900",NA,29097,"Jasper County, MO","County or equivalent",2007,115049,2131,810,1892,1082,1329,124,1205,-8
"27900",NA,29145,"Newton County, MO","County or equivalent",2007,55994,576,297,807,510,269,23,246,10
"28020",NA,NA,"Kalamazoo-Portage, MI","Metropolitan Statistical Area",2007,322340,904,1766,4264,2498,-906,439,-1345,44
"28020",NA,26077,"Kalamazoo County, MI","County or equivalent",2007,244559,1117,1375,3191,1816,-306,397,-703,48
"28020",NA,26159,"Van Buren County, MI","County or equivalent",2007,77781,-213,391,1073,682,-600,42,-642,-4
"28100",NA,NA,"Kankakee-Bradley, IL","Metropolitan Statistical Area",2007,111538,1594,624,1666,1042,945,107,838,25
"28100",NA,17091,"Kankakee County, IL","County or equivalent",2007,111538,1594,624,1666,1042,945,107,838,25
"28140",NA,NA,"Kansas City, MO-KS","Metropolitan Statistical Area",2007,1981480,23152,15420,30447,15027,7698,3169,4529,34
"28140",NA,20059,"Franklin County, KS","County or equivalent",2007,26411,117,163,400,237,-46,13,-59,0
"28140",NA,20091,"Johnson County, KS","County or equivalent",2007,524801,9526,4903,7905,3002,4624,962,3662,-1
"28140",NA,20103,"Leavenworth County, KS","County or equivalent",2007,73507,977,490,955,465,494,-2,496,-7
"28140",NA,20107,"Linn County, KS","County or equivalent",2007,9726,-134,17,123,106,-159,0,-159,8
"28140",NA,20121,"Miami County, KS","County or equivalent",2007,30897,653,182,409,227,467,3,464,4
"28140",NA,20209,"Wyandotte County, KS","County or equivalent",2007,153601,395,1592,2895,1303,-1147,759,-1906,-50
"28140",NA,29013,"Bates County, MO","County or equivalent",2007,17002,-6,21,215,194,-28,5,-33,1
"28140",NA,29025,"Caldwell County, MO","County or equivalent",2007,9273,57,23,121,98,33,0,33,1
"28140",NA,29037,"Cass County, MO","County or equivalent",2007,96927,2397,598,1370,772,1759,39,1720,40
"28140",NA,29047,"Clay County, MO","County or equivalent",2007,211525,4933,1818,3234,1416,3071,199,2872,44
"28140",NA,29049,"Clinton County, MO","County or equivalent",2007,20975,490,38,261,223,458,0,458,-6
"28140",NA,29095,"Jackson County, MO","County or equivalent",2007,666000,2397,4818,10735,5917,-2395,1084,-3479,-26
"28140",NA,29107,"Lafayette County, MO","County or equivalent",2007,32667,-90,84,434,350,-186,2,-188,12
"28140",NA,29165,"Platte County, MO","County or equivalent",2007,84722,1618,593,1092,499,1011,106,905,14
"28140",NA,29177,"Ray County, MO","County or equivalent",2007,23446,-178,80,298,218,-258,-1,-257,0
"28420",NA,NA,"Kennewick-Pasco-Richland, WA","Metropolitan Statistical Area",2007,227905,5041,2574,3949,1375,2486,840,1646,-19
"28420",NA,53005,"Benton County, WA","County or equivalent",2007,158781,1732,1264,2333,1069,489,392,97,-21
"28420",NA,53021,"Franklin County, WA","County or equivalent",2007,69124,3309,1310,1616,306,1997,448,1549,2
"28660",NA,NA,"Killeen-Temple-Fort Hood, TX","Metropolitan Statistical Area",2007,370755,12889,4710,6956,2246,8110,-176,8286,69
"28660",NA,48027,"Bell County, TX","County or equivalent",2007,277773,11785,4102,5797,1695,7523,22,7501,160
"28660",NA,48099,"Coryell County, TX","County or equivalent",2007,72108,585,556,892,336,92,-211,303,-63
"28660",NA,48281,"Lampasas County, TX","County or equivalent",2007,20874,519,52,267,215,495,13,482,-28
"28700",NA,NA,"Kingsport-Bristol-Bristol, TN-VA","Metropolitan Statistical Area",2007,303310,1942,-260,3277,3537,2116,103,2013,86
"28700",NA,47073,"Hawkins County, TN","County or equivalent",2007,56928,469,20,629,609,449,12,437,0
"28700",NA,47163,"Sullivan County, TN","County or equivalent",2007,153357,984,-163,1674,1837,1079,71,1008,68
"28700",NA,51169,"Scott County, VA","County or equivalent",2007,22888,-17,-45,239,284,25,3,22,3
"28700",NA,51191,"Washington County, VA","County or equivalent",2007,52746,670,-33,535,568,693,12,681,10
"28700",NA,51520,"Bristol city, VA","County or equivalent",2007,17391,-164,-39,200,239,-130,5,-135,5
"28740",NA,NA,"Kingston, NY","Metropolitan Statistical Area",2007,181593,-59,380,1888,1508,-463,169,-632,24
"28740",NA,36111,"Ulster County, NY","County or equivalent",2007,181593,-59,380,1888,1508,-463,169,-632,24
"28940",NA,NA,"Knoxville, TN","Metropolitan Statistical Area",2007,680652,11122,2002,8487,6485,9106,490,8616,14
"28940",NA,47001,"Anderson County, TN","County or equivalent",2007,73246,511,1,854,853,498,67,431,12
"28940",NA,47009,"Blount County, TN","County or equivalent",2007,119602,1854,210,1394,1184,1654,69,1585,-10
"28940",NA,47093,"Knox County, TN","County or equivalent",2007,423603,7589,1704,5457,3753,5831,327,5504,54
"28940",NA,47105,"Loudon County, TN","County or equivalent",2007,45363,1082,41,558,517,1071,28,1043,-30
"28940",NA,47173,"Union County, TN","County or equivalent",2007,18838,86,46,224,178,52,-1,53,-12
"29020",NA,NA,"Kokomo, IN","Metropolitan Statistical Area",2007,99675,-238,238,1277,1039,-495,47,-542,19
"29020",NA,18067,"Howard County, IN","County or equivalent",2007,83648,-147,228,1097,869,-387,44,-431,12
"29020",NA,18159,"Tipton County, IN","County or equivalent",2007,16027,-91,10,180,170,-108,3,-111,7
"29100",NA,NA,"La Crosse, WI-MN","Metropolitan Statistical Area",2007,131034,1232,609,1655,1046,638,51,587,-15
"29100",NA,27055,"Houston County, MN","County or equivalent",2007,19499,-70,71,248,177,-135,2,-137,-6
"29100",NA,55063,"La Crosse County, WI","County or equivalent",2007,111535,1302,538,1407,869,773,49,724,-9
"29140",NA,NA,"Lafayette, IN","Metropolitan Statistical Area",2007,190759,2471,1217,2535,1318,1276,736,540,-22
"29140",NA,18007,"Benton County, IN","County or equivalent",2007,8774,-57,33,114,81,-94,1,-95,4
"29140",NA,18015,"Carroll County, IN","County or equivalent",2007,19921,-56,47,219,172,-103,14,-117,0
"29140",NA,18157,"Tippecanoe County, IN","County or equivalent",2007,162064,2584,1137,2202,1065,1473,721,752,-26
"29180",NA,NA,"Lafayette, LA","Metropolitan Statistical Area",2007,256273,1907,1923,3936,2013,90,189,-99,-106
"29180",NA,22055,"Lafayette Parish, LA","County or equivalent",2007,204649,1446,1603,3159,1556,-51,184,-235,-106
"29180",NA,22099,"St. Martin Parish, LA","County or equivalent",2007,51624,461,320,777,457,141,5,136,0
"29340",NA,NA,"Lake Charles, LA","Metropolitan Statistical Area",2007,191880,992,1171,2978,1807,-68,68,-136,-111
"29340",NA,22019,"Calcasieu Parish, LA","County or equivalent",2007,184471,1267,1142,2906,1764,218,61,157,-93
"29340",NA,22023,"Cameron Parish, LA","County or equivalent",2007,7409,-275,29,72,43,-286,7,-293,-18
"29420",NA,NA,"Lake Havasu City-Kingman, AZ","Metropolitan Statistical Area",2007,195873,3306,376,2562,2186,2837,235,2602,93
"29420",NA,4015,"Mohave County, AZ","County or equivalent",2007,195873,3306,376,2562,2186,2837,235,2602,93
"29460",NA,NA,"Lakeland-Winter Haven, FL","Metropolitan Statistical Area",2007,572967,16181,2895,8542,5647,12954,1039,11915,332
"29460",NA,12105,"Polk County, FL","County or equivalent",2007,572967,16181,2895,8542,5647,12954,1039,11915,332
"29540",NA,NA,"Lancaster, PA","Metropolitan Statistical Area",2007,497955,4634,2753,7090,4337,1927,505,1422,-46
"29540",NA,42071,"Lancaster County, PA","County or equivalent",2007,497955,4634,2753,7090,4337,1927,505,1422,-46
"29620",NA,NA,"Lansing-East Lansing, MI","Metropolitan Statistical Area",2007,455071,-379,2529,5708,3179,-3009,959,-3968,101
"29620",NA,26037,"Clinton County, MI","County or equivalent",2007,69637,307,385,852,467,-74,11,-85,-4
"29620",NA,26045,"Eaton County, MI","County or equivalent",2007,107118,9,369,1209,840,-372,64,-436,12
"29620",NA,26065,"Ingham County, MI","County or equivalent",2007,278316,-695,1775,3647,1872,-2563,884,-3447,93
"29700",NA,NA,"Laredo, TX","Metropolitan Statistical Area",2007,231477,5042,4922,6051,1129,122,1278,-1156,-2
"29700",NA,48479,"Webb County, TX","County or equivalent",2007,231477,5042,4922,6051,1129,122,1278,-1156,-2
"29740",NA,NA,"Las Cruces, NM","Metropolitan Statistical Area",2007,198048,4593,2143,3452,1309,2454,575,1879,-4
"29740",NA,35013,"Dona Ana County, NM","County or equivalent",2007,198048,4593,2143,3452,1309,2454,575,1879,-4
"29820",NA,NA,"Las Vegas-Paradise, NV","Metropolitan Statistical Area",2007,1827655,56979,16640,29594,12954,40121,7245,32876,218
"29820",NA,32003,"Clark County, NV","County or equivalent",2007,1827655,56979,16640,29594,12954,40121,7245,32876,218
"29940",NA,NA,"Lawrence, KS","Metropolitan Statistical Area",2007,113400,841,728,1285,557,149,259,-110,-36
"29940",NA,20045,"Douglas County, KS","County or equivalent",2007,113400,841,728,1285,557,149,259,-110,-36
"30020",NA,NA,"Lawton, OK","Metropolitan Statistical Area",2007,113931,1675,1130,2025,895,549,-136,685,-4
"30020",NA,40031,"Comanche County, OK","County or equivalent",2007,113931,1675,1130,2025,895,549,-136,685,-4
"30140",NA,NA,"Lebanon, PA","Metropolitan Statistical Area",2007,127861,1451,258,1596,1338,1189,120,1069,4
"30140",NA,42075,"Lebanon County, PA","County or equivalent",2007,127861,1451,258,1596,1338,1189,120,1069,4
"30300",NA,NA,"Lewiston, ID-WA","Metropolitan Statistical Area",2007,59905,360,79,734,655,327,13,314,-46
"30300",NA,16069,"Nez Perce County, ID","County or equivalent",2007,38820,326,54,482,428,321,13,308,-49
"30300",NA,53003,"Asotin County, WA","County or equivalent",2007,21085,34,25,252,227,6,0,6,3
"30340",NA,NA,"Lewiston-Auburn, ME","Metropolitan Statistical Area",2007,106701,-215,428,1433,1005,-640,42,-682,-3
"30340",NA,23001,"Androscoggin County, ME","County or equivalent",2007,106701,-215,428,1433,1005,-640,42,-682,-3
"30460",NA,NA,"Lexington-Fayette, KY","Metropolitan Statistical Area",2007,446109,6250,3058,6395,3337,3231,996,2235,-39
"30460",NA,21017,"Bourbon County, KY","County or equivalent",2007,19716,95,67,259,192,27,27,0,1
"30460",NA,21049,"Clark County, KY","County or equivalent",2007,35521,470,115,472,357,353,13,340,2
"30460",NA,21067,"Fayette County, KY","County or equivalent",2007,278287,3088,2028,3998,1970,1081,858,223,-21
"30460",NA,21113,"Jessamine County, KY","County or equivalent",2007,45553,1003,348,691,343,668,23,645,-13
"30460",NA,21209,"Scott County, KY","County or equivalent",2007,42828,1490,421,688,267,1078,32,1046,-9
"30460",NA,21239,"Woodford County, KY","County or equivalent",2007,24204,104,79,287,208,24,43,-19,1
"30620",NA,NA,"Lima, OH","Metropolitan Statistical Area",2007,105133,-69,356,1438,1082,-434,22,-456,9
"30620",NA,39003,"Allen County, OH","County or equivalent",2007,105133,-69,356,1438,1082,-434,22,-456,9
"30700",NA,NA,"Lincoln, NE","Metropolitan Statistical Area",2007,291248,3477,2562,4375,1813,894,732,162,21
"30700",NA,31109,"Lancaster County, NE","County or equivalent",2007,274725,3634,2521,4178,1657,1097,726,371,16
"30700",NA,31159,"Seward County, NE","County or equivalent",2007,16523,-157,41,197,156,-203,6,-209,5
"30780",NA,NA,"Little Rock-North Little Rock-Conway, AR","Metropolitan Statistical Area",2007,665657,9044,4676,10204,5528,4234,421,3813,134
"30780",NA,5045,"Faulkner County, AR","County or equivalent",2007,104294,2283,837,1562,725,1439,63,1376,7
"30780",NA,5053,"Grant County, AR","County or equivalent",2007,17450,34,50,215,165,-17,-1,-16,1
"30780",NA,5085,"Lonoke County, AR","County or equivalent",2007,63468,1619,444,934,490,1149,4,1145,26
"30780",NA,5105,"Perry County, AR","County or equivalent",2007,10388,150,6,133,127,143,0,143,1
"30780",NA,5119,"Pulaski County, AR","County or equivalent",2007,374011,1854,2921,6146,3225,-1120,331,-1451,53
"30780",NA,5125,"Saline County, AR","County or equivalent",2007,96046,3104,418,1214,796,2640,24,2616,46
"30860",NA,NA,"Logan, UT-ID","Metropolitan Statistical Area",2007,121153,2751,2317,2822,505,460,306,154,-26
"30860",NA,16041,"Franklin County, ID","County or equivalent",2007,12158,155,123,211,88,35,17,18,-3
"30860",NA,49005,"Cache County, UT","County or equivalent",2007,108995,2596,2194,2611,417,425,289,136,-23
"30980",NA,NA,"Longview, TX","Metropolitan Statistical Area",2007,203205,1873,1161,3184,2023,724,296,428,-12
"30980",NA,48183,"Gregg County, TX","County or equivalent",2007,116872,1069,845,1978,1133,226,207,19,-2
"30980",NA,48401,"Rusk County, TX","County or equivalent",2007,48452,488,217,706,489,277,77,200,-6
"30980",NA,48459,"Upshur County, TX","County or equivalent",2007,37881,316,99,500,401,221,12,209,-4
"31020",NA,NA,"Longview, WA","Metropolitan Statistical Area",2007,100216,1531,338,1327,989,1201,105,1096,-8
"31020",NA,53015,"Cowlitz County, WA","County or equivalent",2007,100216,1531,338,1327,989,1201,105,1096,-8
"31100",NA,NA,"Los Angeles-Long Beach-Santa Ana, CA","Metropolitan Statistical Area",2007,12784612,-12366,116227,194308,78081,-131636,89508,-221144,3043
"31100",31084,NA,"Los Angeles-Long Beach-Glendale, CA","Metropolitan Division",2007,9807870,-18623,90019,150587,60568,-110610,70022,-180632,1968
"31100",31084,6037,"Los Angeles County, CA","County or equivalent",2007,9807870,-18623,90019,150587,60568,-110610,70022,-180632,1968
"31100",42044,NA,"Santa Ana-Anaheim-Irvine, CA","Metropolitan Division",2007,2976742,6257,26208,43721,17513,-21026,19486,-40512,1075
"31100",42044,6059,"Orange County, CA","County or equivalent",2007,2976742,6257,26208,43721,17513,-21026,19486,-40512,1075
"31140",NA,NA,"Louisville/Jefferson County, KY-IN","Metropolitan Statistical Area",2007,1232304,13340,5654,16775,11121,7502,1264,6238,184
"31140",NA,18019,"Clark County, IN","County or equivalent",2007,105050,1421,507,1504,997,903,78,825,11
"31140",NA,18043,"Floyd County, IN","County or equivalent",2007,72943,627,188,868,680,443,10,433,-4
"31140",NA,18061,"Harrison County, IN","County or equivalent",2007,36775,161,134,444,310,32,11,21,-5
"31140",NA,18175,"Washington County, IN","County or equivalent",2007,27879,71,77,350,273,-8,3,-11,2
"31140",NA,21029,"Bullitt County, KY","County or equivalent",2007,73887,1429,393,838,445,1030,1,1029,6
"31140",NA,21103,"Henry County, KY","County or equivalent",2007,15667,-9,42,192,150,-44,9,-53,-7
"31140",NA,21111,"Jefferson County, KY","County or equivalent",2007,708613,5898,3247,10227,6980,2508,1026,1482,143
"31140",NA,21163,"Meade County, KY","County or equivalent",2007,27213,-270,63,249,186,-336,-8,-328,3
"31140",NA,21179,"Nelson County, KY","County or equivalent",2007,42411,711,280,592,312,421,25,396,10
"31140",NA,21185,"Oldham County, KY","County or equivalent",2007,55769,1411,297,597,300,1100,20,1080,14
"31140",NA,21211,"Shelby County, KY","County or equivalent",2007,40345,1044,290,583,293,755,86,669,-1
"31140",NA,21215,"Spencer County, KY","County or equivalent",2007,16798,772,90,206,116,672,2,670,10
"31140",NA,21223,"Trimble County, KY","County or equivalent",2007,8954,74,46,125,79,26,1,25,2
"31180",NA,NA,"Lubbock, TX","Metropolitan Statistical Area",2007,268085,2197,2257,4359,2102,-62,215,-277,2
"31180",NA,48107,"Crosby County, TX","County or equivalent",2007,6258,-226,47,99,52,-265,2,-267,-8
"31180",NA,48303,"Lubbock County, TX","County or equivalent",2007,261827,2423,2210,4260,2050,203,213,-10,10
"31340",NA,NA,"Lynchburg, VA","Metropolitan Statistical Area",2007,243652,3598,459,2780,2321,3184,155,3029,-45
"31340",NA,51009,"Amherst County, VA","County or equivalent",2007,32214,165,20,333,313,144,12,132,1
"31340",NA,51011,"Appomattox County, VA","County or equivalent",2007,14196,210,29,167,138,185,7,178,-4
"31340",NA,51019,"Bedford County, VA","County or equivalent",2007,66578,1104,141,670,529,960,22,938,3
"31340",NA,51031,"Campbell County, VA","County or equivalent",2007,52622,210,89,555,466,124,21,103,-3
"31340",NA,51515,"Bedford city, VA","County or equivalent",2007,6292,61,-26,65,91,94,-1,95,-7
"31340",NA,51680,"Lynchburg city, VA","County or equivalent",2007,71750,1848,206,990,784,1677,94,1583,-35
"31420",NA,NA,"Macon, GA","Metropolitan Statistical Area",2007,229831,1044,1188,3478,2290,-170,129,-299,26
"31420",NA,13021,"Bibb County, GA","County or equivalent",2007,154806,120,1005,2672,1667,-912,111,-1023,27
"31420",NA,13079,"Crawford County, GA","County or equivalent",2007,12500,-68,51,144,93,-121,1,-122,2
"31420",NA,13169,"Jones County, GA","County or equivalent",2007,27161,248,51,252,201,189,9,180,8
"31420",NA,13207,"Monroe County, GA","County or equivalent",2007,25103,805,53,294,241,764,9,755,-12
"31420",NA,13289,"Twiggs County, GA","County or equivalent",2007,10261,-61,28,116,88,-90,-1,-89,1
"31460",NA,NA,"Madera, CA","Metropolitan Statistical Area",2007,145654,2323,1670,2649,979,703,642,61,-50
"31460",NA,6039,"Madera County, CA","County or equivalent",2007,145654,2323,1670,2649,979,703,642,61,-50
"31540",NA,NA,"Madison, WI","Metropolitan Statistical Area",2007,554267,7787,3913,7246,3333,3849,1369,2480,25
"31540",NA,55021,"Columbia County, WI","County or equivalent",2007,55146,314,201,678,477,120,16,104,-7
"31540",NA,55025,"Dane County, WI","County or equivalent",2007,475601,7473,3584,6250,2666,3851,1353,2498,38
"31540",NA,55049,"Iowa County, WI","County or equivalent",2007,23520,0,128,318,190,-122,0,-122,-6
"31700",NA,NA,"Manchester-Nashua, NH","Metropolitan Statistical Area",2007,401060,1058,2053,4975,2922,-1081,964,-2045,86
"31700",NA,33011,"Hillsborough County, NH","County or equivalent",2007,401060,1058,2053,4975,2922,-1081,964,-2045,86
"31900",NA,NA,"Mansfield, OH","Metropolitan Statistical Area",2007,125868,-430,373,1636,1263,-809,38,-847,6
"31900",NA,39139,"Richland County, OH","County or equivalent",2007,125868,-430,373,1636,1263,-809,38,-847,6
"32580",NA,NA,"McAllen-Edinburg-Mission, TX","Metropolitan Statistical Area",2007,705478,19444,13910,17379,3469,5627,3671,1956,-93
"32580",NA,48215,"Hidalgo County, TX","County or equivalent",2007,705478,19444,13910,17379,3469,5627,3671,1956,-93
"32780",NA,NA,"Medford, OR","Metropolitan Statistical Area",2007,199003,2501,478,2394,1916,2084,204,1880,-61
"32780",NA,41029,"Jackson County, OR","County or equivalent",2007,199003,2501,478,2394,1916,2084,204,1880,-61
"32820",NA,NA,"Memphis, TN-MS-AR","Metropolitan Statistical Area",2007,1279120,8857,10000,20521,10521,-1312,1406,-2718,169
"32820",NA,5035,"Crittenden County, AR","County or equivalent",2007,52110,329,484,942,458,-158,23,-181,3
"32820",NA,28033,"DeSoto County, MS","County or equivalent",2007,149136,5524,1361,2280,919,4117,89,4028,46
"32820",NA,28093,"Marshall County, MS","County or equivalent",2007,36711,657,186,556,370,497,4,493,-26
"32820",NA,28137,"Tate County, MS","County or equivalent",2007,26880,221,189,432,243,42,1,41,-10
"32820",NA,28143,"Tunica County, MS","County or equivalent",2007,10464,66,182,247,65,-112,6,-118,-4
"32820",NA,47047,"Fayette County, TN","County or equivalent",2007,37135,1405,150,462,312,1243,5,1238,12
"32820",NA,47157,"Shelby County, TN","County or equivalent",2007,909062,-596,7141,14802,7661,-7862,1270,-9132,125
"32820",NA,47167,"Tipton County, TN","County or equivalent",2007,57622,1251,307,800,493,921,8,913,23
"32900",NA,NA,"Merced, CA","Metropolitan Statistical Area",2007,244218,2964,3275,4757,1482,-311,979,-1290,0
"32900",NA,6047,"Merced County, CA","County or equivalent",2007,244218,2964,3275,4757,1482,-311,979,-1290,0
"33100",NA,NA,"Miami-Fort Lauderdale-Pompano Beach, FL","Metropolitan Statistical Area",2007,5392118,-10216,22859,70755,47896,-37124,47144,-84268,4049
"33100",22744,NA,"Fort Lauderdale-Pompano Beach-Deerfield Beach, FL","Metropolitan Division",2007,1748771,-15762,7538,22723,15185,-24245,11743,-35988,945
"33100",22744,12011,"Broward County, FL","County or equivalent",2007,1748771,-15762,7538,22723,15185,-24245,11743,-35988,945
"33100",33124,NA,"Miami-Miami Beach-Kendall, FL","Metropolitan Division",2007,2382961,6540,13945,32736,18791,-10193,29539,-39732,2788
"33100",33124,12086,"Miami-Dade County, FL","County or equivalent",2007,2382961,6540,13945,32736,18791,-10193,29539,-39732,2788
"33100",48424,NA,"West Palm Beach-Boca Raton-Boynton Beach, FL","Metropolitan Division",2007,1260386,-994,1376,15296,13920,-2686,5862,-8548,316
"33100",48424,12099,"Palm Beach County, FL","County or equivalent",2007,1260386,-994,1376,15296,13920,-2686,5862,-8548,316
"33140",NA,NA,"Michigan City-La Porte, IN","Metropolitan Statistical Area",2007,110274,1107,302,1354,1052,775,72,703,30
"33140",NA,18091,"LaPorte County, IN","County or equivalent",2007,110274,1107,302,1354,1052,775,72,703,30
"33260",NA,NA,"Midland, TX","Metropolitan Statistical Area",2007,126259,2826,1212,2145,933,1604,149,1455,10
"33260",NA,48329,"Midland County, TX","County or equivalent",2007,126259,2826,1212,2145,933,1604,149,1455,10
"33340",NA,NA,"Milwaukee-Waukesha-West Allis, WI","Metropolitan Statistical Area",2007,1543378,4657,9915,22124,12209,-5143,2701,-7844,-115
"33340",NA,55079,"Milwaukee County, WI","County or equivalent",2007,951331,-3,7537,15528,7991,-7326,2347,-9673,-214
"33340",NA,55089,"Ozaukee County, WI","County or equivalent",2007,85378,274,194,869,675,66,60,6,14
"33340",NA,55131,"Washington County, WI","County or equivalent",2007,128014,1564,708,1559,851,845,53,792,11
"33340",NA,55133,"Waukesha County, WI","County or equivalent",2007,378655,2822,1476,4168,2692,1272,241,1031,74
"33460",NA,NA,"Minneapolis-St. Paul-Bloomington, MN-WI","Metropolitan Statistical Area",2007,3197620,33440,27712,46896,19184,6013,7978,-1965,-285
"33460",NA,27003,"Anoka County, MN","County or equivalent",2007,325320,1953,2945,4468,1523,-845,323,-1168,-147
"33460",NA,27019,"Carver County, MN","County or equivalent",2007,88096,1825,928,1297,369,918,108,810,-21
"33460",NA,27025,"Chisago County, MN","County or equivalent",2007,49890,546,382,727,345,184,3,181,-20
"33460",NA,27037,"Dakota County, MN","County or equivalent",2007,389418,4342,3712,5591,1879,650,542,108,-20
"33460",NA,27053,"Hennepin County, MN","County or equivalent",2007,1131955,7106,8941,16509,7568,-1770,4932,-6702,-65
"33460",NA,27059,"Isanti County, MN","County or equivalent",2007,38812,728,281,532,251,448,5,443,-1
"33460",NA,27123,"Ramsey County, MN","County or equivalent",2007,498628,2091,3450,7365,3915,-1398,1741,-3139,39
"33460",NA,27139,"Scott County, MN","County or equivalent",2007,125938,3406,1690,2183,493,1752,101,1651,-36
"33460",NA,27141,"Sherburne County, MN","County or equivalent",2007,86053,1845,930,1358,428,933,17,916,-18
"33460",NA,27163,"Washington County, MN","County or equivalent",2007,225792,4166,1888,2983,1095,2262,164,2098,16
"33460",NA,27171,"Wright County, MN","County or equivalent",2007,116932,3234,1558,2186,628,1669,22,1647,7
"33460",NA,55093,"Pierce County, WI","County or equivalent",2007,39794,273,246,466,220,25,5,20,2
"33460",NA,55109,"St. Croix County, WI","County or equivalent",2007,80992,1925,761,1231,470,1185,15,1170,-21
"33540",NA,NA,"Missoula, MT","Metropolitan Statistical Area",2007,105638,1665,599,1303,704,1063,60,1003,3
"33540",NA,30063,"Missoula County, MT","County or equivalent",2007,105638,1665,599,1303,704,1063,60,1003,3
"33660",NA,NA,"Mobile, AL","Metropolitan Statistical Area",2007,404097,2468,2244,6114,3870,375,346,29,-151
"33660",NA,1097,"Mobile County, AL","County or equivalent",2007,404097,2468,2244,6114,3870,375,346,29,-151
"33700",NA,NA,"Modesto, CA","Metropolitan Statistical Area",2007,509068,3863,5075,8864,3789,-1268,1643,-2911,56
"33700",NA,6099,"Stanislaus County, CA","County or equivalent",2007,509068,3863,5075,8864,3789,-1268,1643,-2911,56
"33740",NA,NA,"Monroe, LA","Metropolitan Statistical Area",2007,172231,-190,1103,2774,1671,-1331,43,-1374,38
"33740",NA,22073,"Ouachita Parish, LA","County or equivalent",2007,149493,-125,1019,2432,1413,-1173,34,-1207,29
"33740",NA,22111,"Union Parish, LA","County or equivalent",2007,22738,-65,84,342,258,-158,9,-167,9
"33780",NA,NA,"Monroe, MI","Metropolitan Statistical Area",2007,153331,181,544,1802,1258,-382,85,-467,19
"33780",NA,26115,"Monroe County, MI","County or equivalent",2007,153331,181,544,1802,1258,-382,85,-467,19
"33860",NA,NA,"Montgomery, AL","Metropolitan Statistical Area",2007,365976,3529,2116,5370,3254,1348,93,1255,65
"33860",NA,1001,"Autauga County, AL","County or equivalent",2007,49830,791,216,661,445,561,0,561,14
"33860",NA,1051,"Elmore County, AL","County or equivalent",2007,77358,1976,405,1039,634,1534,4,1530,37
"33860",NA,1085,"Lowndes County, AL","County or equivalent",2007,12699,-41,74,200,126,-113,-1,-112,-2
"33860",NA,1101,"Montgomery County, AL","County or equivalent",2007,226089,803,1421,3470,2049,-634,90,-724,16
"34060",NA,NA,"Morgantown, WV","Metropolitan Statistical Area",2007,117547,788,355,1297,942,441,174,267,-8
"34060",NA,54061,"Monongalia County, WV","County or equivalent",2007,87314,665,351,955,604,331,173,158,-17
"34060",NA,54077,"Preston County, WV","County or equivalent",2007,30233,123,4,342,338,110,1,109,9
"34100",NA,NA,"Morristown, TN","Metropolitan Statistical Area",2007,134247,2332,329,1719,1390,1953,286,1667,50
"34100",NA,47057,"Grainger County, TN","County or equivalent",2007,22528,192,16,264,248,169,12,157,7
"34100",NA,47063,"Hamblen County, TN","County or equivalent",2007,61565,1027,241,886,645,771,230,541,15
"34100",NA,47089,"Jefferson County, TN","County or equivalent",2007,50154,1113,72,569,497,1013,44,969,28
"34580",NA,NA,"Mount Vernon-Anacortes, WA","Metropolitan Statistical Area",2007,115898,1762,516,1558,1042,1281,280,1001,-35
"34580",NA,53057,"Skagit County, WA","County or equivalent",2007,115898,1762,516,1558,1042,1281,280,1001,-35
"34620",NA,NA,"Muncie, IN","Metropolitan Statistical Area",2007,115167,-331,93,1279,1186,-454,96,-550,30
"34620",NA,18035,"Delaware County, IN","County or equivalent",2007,115167,-331,93,1279,1186,-454,96,-550,30
"34740",NA,NA,"Muskegon-Norton Shores, MI","Metropolitan Statistical Area",2007,174108,63,850,2385,1535,-816,79,-895,29
"34740",NA,26121,"Muskegon County, MI","County or equivalent",2007,174108,63,850,2385,1535,-816,79,-895,29
"34820",NA,NA,"Myrtle Beach-North Myrtle Beach-Conway, SC","Metropolitan Statistical Area",2007,249711,10215,950,3336,2386,9310,324,8986,-45
"34820",NA,45051,"Horry County, SC","County or equivalent",2007,249711,10215,950,3336,2386,9310,324,8986,-45
"34900",NA,NA,"Napa, CA","Metropolitan Statistical Area",2007,131781,915,525,1717,1192,397,615,-218,-7
"34900",NA,6055,"Napa County, CA","County or equivalent",2007,131781,915,525,1717,1192,397,615,-218,-7
"34940",NA,NA,"Naples-Marco Island, FL","Metropolitan Statistical Area",2007,313655,2053,1318,4129,2811,751,1805,-1054,-16
"34940",NA,12021,"Collier County, FL","County or equivalent",2007,313655,2053,1318,4129,2811,751,1805,-1054,-16
"34980",NA,NA,"Nashville-Davidson--Murfreesboro--Franklin, TN","Metropolitan Statistical Area",2007,1520160,34471,10917,22509,11592,23447,2809,20638,107
"34980",NA,47015,"Cannon County, TN","County or equivalent",2007,13434,144,18,156,138,128,4,124,-2
"34980",NA,47021,"Cheatham County, TN","County or equivalent",2007,38999,514,150,462,312,357,6,351,7
"34980",NA,47037,"Davidson County, TN","County or equivalent",2007,620267,6067,4515,9715,5200,1585,2049,-464,-33
"34980",NA,47043,"Dickson County, TN","County or equivalent",2007,47337,1021,249,720,471,760,3,757,12
"34980",NA,47081,"Hickman County, TN","County or equivalent",2007,23753,240,19,272,253,212,0,212,9
"34980",NA,47111,"Macon County, TN","County or equivalent",2007,21559,138,65,293,228,73,26,47,0
"34980",NA,47147,"Robertson County, TN","County or equivalent",2007,63162,1580,519,1053,534,1044,101,943,17
"34980",NA,47149,"Rutherford County, TN","County or equivalent",2007,240877,10296,2402,3761,1359,7882,258,7624,12
"34980",NA,47159,"Smith County, TN","County or equivalent",2007,18795,217,33,247,214,180,7,173,4
"34980",NA,47165,"Sumner County, TN","County or equivalent",2007,152411,4108,903,2074,1171,3183,128,3055,22
"34980",NA,47169,"Trousdale County, TN","County or equivalent",2007,7699,188,13,89,76,174,7,167,1
"34980",NA,47187,"Williamson County, TN","County or equivalent",2007,165690,6824,1330,2187,857,5436,183,5253,58
"34980",NA,47189,"Wilson County, TN","County or equivalent",2007,106177,3134,701,1480,779,2433,37,2396,0
"35300",NA,NA,"New Haven-Milford, CT","Metropolitan Statistical Area",2007,844358,2477,3327,10573,7246,-880,2617,-3497,30
"35300",NA,9009,"New Haven County, CT","County or equivalent",2007,844358,2477,3327,10573,7246,-880,2617,-3497,30
"35380",NA,NA,"New Orleans-Metairie-Kenner, LA","Metropolitan Statistical Area",2007,1109411,117509,4810,14275,9465,37293,1138,36155,75406
"35380",NA,22051,"Jefferson Parish, LA","County or equivalent",2007,440339,18117,1631,5670,4039,2164,611,1553,14322
"35380",NA,22071,"Orleans Parish, LA","County or equivalent",2007,288113,77345,765,3314,2549,28688,375,28313,47892
"35380",NA,22075,"Plaquemines Parish, LA","County or equivalent",2007,21597,-13,148,297,149,-116,-6,-110,-45
"35380",NA,22087,"St. Bernard Parish, LA","County or equivalent",2007,33439,19515,88,304,216,5934,17,5917,13493
"35380",NA,22089,"St. Charles Parish, LA","County or equivalent",2007,51982,114,363,743,380,-203,35,-238,-46
"35380",NA,22095,"St. John the Baptist Parish, LA","County or equivalent",2007,47678,31,433,765,332,-354,21,-375,-48
"35380",NA,22103,"St. Tammany Parish, LA","County or equivalent",2007,226263,2400,1382,3182,1800,1180,85,1095,-162
"35620",NA,NA,"New York-Northern New Jersey-Long Island, NY-NJ-PA","Metropolitan Statistical Area",2007,18922571,74331,117253,254171,136918,-96196,122908,-219104,53274
"35620",20764,NA,"Edison-New Brunswick, NJ","Metropolitan Division",2007,2310936,11519,10659,29584,18925,840,9815,-8975,20
"35620",20764,34023,"Middlesex County, NJ","County or equivalent",2007,783029,4223,5442,10667,5225,-1139,6143,-7282,-80
"35620",20764,34025,"Monmouth County, NJ","County or equivalent",2007,641365,160,2109,7139,5030,-2001,1497,-3498,52
"35620",20764,34029,"Ocean County, NJ","County or equivalent",2007,564791,3839,1176,7793,6617,2589,518,2071,74
"35620",20764,34035,"Somerset County, NJ","County or equivalent",2007,321751,3297,1932,3985,2053,1391,1657,-266,-26
"35620",35004,NA,"Nassau-Suffolk, NY","Metropolitan Division",2007,2864793,2835,10949,32906,21957,-21229,6980,-28209,13115
"35620",35004,36059,"Nassau County, NY","County or equivalent",2007,1353061,-705,3816,14462,10646,-9859,3641,-13500,5338
"35620",35004,36103,"Suffolk County, NY","County or equivalent",2007,1511732,3540,7133,18444,11311,-11370,3339,-14709,7777
"35620",35084,NA,"Newark-Union, NJ-PA","Metropolitan Division",2007,2118911,-1278,12801,28165,15364,-13350,10729,-24079,-729
"35620",35084,34013,"Essex County, NJ","County or equivalent",2007,772273,-2768,5853,11776,5923,-8292,4895,-13187,-329
"35620",35084,34019,"Hunterdon County, NJ","County or equivalent",2007,128973,-24,448,1224,776,-405,165,-570,-67
"35620",35084,34027,"Morris County, NJ","County or equivalent",2007,486172,514,2233,5523,3290,-1634,2077,-3711,-85
"35620",35084,34037,"Sussex County, NJ","County or equivalent",2007,151257,227,630,1604,974,-411,116,-527,8
"35620",35084,34039,"Union County, NJ","County or equivalent",2007,521678,-601,3579,7563,3984,-3900,3471,-7371,-280
"35620",35084,42103,"Pike County, PA","County or equivalent",2007,58558,1374,58,475,417,1292,5,1287,24
"35620",35644,NA,"New York-White Plains-Wayne, NY-NJ","Metropolitan Division",2007,11627931,61255,82844,163516,80672,-62457,95384,-157841,40868
"35620",35644,34003,"Bergen County, NJ","County or equivalent",2007,890064,1230,2748,9347,6599,-947,5433,-6380,-571
"35620",35644,34017,"Hudson County, NJ","County or equivalent",2007,592364,-2856,4590,8415,3825,-7090,7045,-14135,-356
"35620",35644,34031,"Passaic County, NJ","County or equivalent",2007,489510,-286,4049,7644,3595,-4368,3500,-7868,33
"35620",35644,36005,"Bronx County, NY","County or equivalent",2007,1385122,13769,13222,22917,9695,-11080,10554,-21634,11627
"35620",35644,36047,"Kings County, NY","County or equivalent",2007,2539206,16159,23368,40654,17286,-20175,22687,-42862,12966
"35620",35644,36061,"New York County, NY","County or equivalent",2007,1625251,12621,9855,20724,10869,-1965,12603,-14568,4731
"35620",35644,36079,"Putnam County, NY","County or equivalent",2007,99207,74,389,995,606,-310,172,-482,-5
"35620",35644,36081,"Queens County, NY","County or equivalent",2007,2277779,13118,15069,30340,15271,-12339,25442,-37781,10388
"35620",35644,36085,"Richmond County, NY","County or equivalent",2007,482854,3978,2218,5897,3679,199,1516,-1317,1561
"35620",35644,36087,"Rockland County, NY","County or equivalent",2007,297005,1078,2624,4652,2028,-2159,1163,-3322,613
"35620",35644,36119,"Westchester County, NY","County or equivalent",2007,949569,2370,4712,11931,7219,-2223,5269,-7492,-119
"35660",NA,NA,"Niles-Benton Harbor, MI","Metropolitan Statistical Area",2007,159346,-20,463,2025,1562,-518,260,-778,35
"35660",NA,26021,"Berrien County, MI","County or equivalent",2007,159346,-20,463,2025,1562,-518,260,-778,35
"35980",NA,NA,"Norwich-New London, CT","Metropolitan Statistical Area",2007,263770,-4107,1008,3082,2074,-5217,250,-5467,102
"35980",NA,9011,"New London County, CT","County or equivalent",2007,263770,-4107,1008,3082,2074,-5217,250,-5467,102
"36100",NA,NA,"Ocala, FL","Metropolitan Statistical Area",2007,324093,10332,-467,3741,4208,11030,292,10738,-231
"36100",NA,12083,"Marion County, FL","County or equivalent",2007,324093,10332,-467,3741,4208,11030,292,10738,-231
"36140",NA,NA,"Ocean City, NJ","Metropolitan Statistical Area",2007,96328,-1210,-262,953,1215,-881,62,-943,-67
"36140",NA,34009,"Cape May County, NJ","County or equivalent",2007,96328,-1210,-262,953,1215,-881,62,-943,-67
"36220",NA,NA,"Odessa, TX","Metropolitan Statistical Area",2007,129410,2961,1433,2507,1074,1529,165,1364,-1
"36220",NA,48135,"Ector County, TX","County or equivalent",2007,129410,2961,1433,2507,1074,1529,165,1364,-1
"36260",NA,NA,"Ogden-Clearfield, UT","Metropolitan Statistical Area",2007,517505,14284,7802,10443,2641,6366,666,5700,116
"36260",NA,49011,"Davis County, UT","County or equivalent",2007,287751,8992,4882,6152,1270,4028,188,3840,82
"36260",NA,49029,"Morgan County, UT","County or equivalent",2007,8335,318,122,150,28,205,2,203,-9
"36260",NA,49057,"Weber County, UT","County or equivalent",2007,221419,4974,2798,4141,1343,2133,476,1657,43
"36420",NA,NA,"Oklahoma City, OK","Metropolitan Statistical Area",2007,1189158,15866,9090,19016,9926,6824,2160,4664,-48
"36420",NA,40017,"Canadian County, OK","County or equivalent",2007,103331,3375,834,1519,685,2511,65,2446,30
"36420",NA,40027,"Cleveland County, OK","County or equivalent",2007,235241,3393,1559,2966,1407,1872,323,1549,-38
"36420",NA,40051,"Grady County, OK","County or equivalent",2007,50446,409,210,672,462,190,1,189,9
"36420",NA,40081,"Lincoln County, OK","County or equivalent",2007,32211,-29,74,418,344,-94,3,-97,-9
"36420",NA,40083,"Logan County, OK","County or equivalent",2007,37123,1360,161,457,296,1201,7,1194,-2
"36420",NA,40087,"McClain County, OK","County or equivalent",2007,31779,1008,148,426,278,840,22,818,20
"36420",NA,40109,"Oklahoma County, OK","County or equivalent",2007,699027,6350,6104,12558,6454,304,1739,-1435,-58
"36500",NA,NA,"Olympia, WA","Metropolitan Statistical Area",2007,238166,5304,1079,2874,1795,4346,219,4127,-121
"36500",NA,53067,"Thurston County, WA","County or equivalent",2007,238166,5304,1079,2874,1795,4346,219,4127,-121
"36540",NA,NA,"Omaha-Council Bluffs, NE-IA","Metropolitan Statistical Area",2007,827666,8593,7555,13543,5988,1018,1261,-243,20
"36540",NA,19085,"Harrison County, IA","County or equivalent",2007,15403,-104,2,192,190,-112,2,-114,6
"36540",NA,19129,"Mills County, IA","County or equivalent",2007,15123,6,36,182,146,-27,1,-28,-3
"36540",NA,19155,"Pottawattamie County, IA","County or equivalent",2007,89355,71,434,1220,786,-338,40,-378,-25
"36540",NA,31025,"Cass County, NE","County or equivalent",2007,25480,46,119,320,201,-68,3,-71,-5
"36540",NA,31055,"Douglas County, NE","County or equivalent",2007,495947,4539,4949,8579,3630,-445,1157,-1602,35
"36540",NA,31153,"Sarpy County, NE","County or equivalent",2007,146315,3848,1906,2574,668,1929,38,1891,13
"36540",NA,31155,"Saunders County, NE","County or equivalent",2007,20119,62,58,256,198,10,8,2,-6
"36540",NA,31177,"Washington County, NE","County or equivalent",2007,19924,125,51,220,169,69,12,57,5
"36740",NA,NA,"Orlando-Kissimmee, FL","Metropolitan Statistical Area",2007,2028669,34724,14439,29298,14859,20746,9176,11570,-461
"36740",NA,12069,"Lake County, FL","County or equivalent",2007,300303,11671,-58,3613,3671,12421,301,12120,-692
"36740",NA,12095,"Orange County, FL","County or equivalent",2007,1063979,11464,10070,16807,6737,1240,5870,-4630,154
"36740",NA,12097,"Osceola County, FL","County or equivalent",2007,255826,11461,2401,4058,1657,9067,1838,7229,-7
"36740",NA,12117,"Seminole County, FL","County or equivalent",2007,408561,128,2026,4820,2794,-1982,1167,-3149,84
"36780",NA,NA,"Oshkosh-Neenah, WI","Metropolitan Statistical Area",2007,161308,1061,660,1934,1274,402,144,258,-1
"36780",NA,55139,"Winnebago County, WI","County or equivalent",2007,161308,1061,660,1934,1274,402,144,258,-1
"36980",NA,NA,"Owensboro, KY","Metropolitan Statistical Area",2007,111984,696,461,1590,1129,225,32,193,10
"36980",NA,21059,"Daviess County, KY","County or equivalent",2007,93690,661,443,1376,933,208,28,180,10
"36980",NA,21091,"Hancock County, KY","County or equivalent",2007,8573,22,30,104,74,-9,1,-10,1
"36980",NA,21149,"McLean County, KY","County or equivalent",2007,9721,13,-12,110,122,26,3,23,-1
"37100",NA,NA,"Oxnard-Thousand Oaks-Ventura, CA","Metropolitan Statistical Area",2007,792456,1209,7321,12236,4915,-6326,2949,-9275,214
"37100",NA,6111,"Ventura County, CA","County or equivalent",2007,792456,1209,7321,12236,4915,-6326,2949,-9275,214
"37340",NA,NA,"Palm Bay-Melbourne-Titusville, FL","Metropolitan Statistical Area",2007,535005,4035,-78,5728,5806,4029,491,3538,84
"37340",NA,12009,"Brevard County, FL","County or equivalent",2007,535005,4035,-78,5728,5806,4029,491,3538,84
"37380",NA,NA,"Palm Coast, FL","Metropolitan Statistical Area",2007,88178,5904,51,958,907,5857,58,5799,-4
"37380",NA,12035,"Flagler County, FL","County or equivalent",2007,88178,5904,51,958,907,5857,58,5799,-4
"37460",NA,NA,"Panama City-Lynn Haven, FL","Metropolitan Statistical Area",2007,163554,-362,923,2443,1520,-1291,32,-1323,6
"37460",NA,12005,"Bay County, FL","County or equivalent",2007,163554,-362,923,2443,1520,-1291,32,-1323,6
"37620",NA,NA,"Parkersburg-Marietta-Vienna, WV-OH","Metropolitan Statistical Area",2007,160679,-262,-27,1739,1766,-259,21,-280,24
"37620",NA,39167,"Washington County, OH","County or equivalent",2007,61682,-74,-31,664,695,-46,2,-48,3
"37620",NA,54073,"Pleasants County, WV","County or equivalent",2007,7196,-36,-18,65,83,-17,2,-19,-1
"37620",NA,54105,"Wirt County, WV","County or equivalent",2007,5795,22,1,55,54,22,2,20,-1
"37620",NA,54107,"Wood County, WV","County or equivalent",2007,86006,-174,21,955,934,-218,15,-233,23
"37700",NA,NA,"Pascagoula, MS","Metropolitan Statistical Area",2007,152137,2651,1102,2420,1318,1708,86,1622,-159
"37700",NA,28039,"George County, MS","County or equivalent",2007,21936,411,193,417,224,215,11,204,3
"37700",NA,28059,"Jackson County, MS","County or equivalent",2007,130201,2240,909,2003,1094,1493,75,1418,-162
"37860",NA,NA,"Pensacola-Ferry Pass-Brent, FL","Metropolitan Statistical Area",2007,451391,688,2457,6355,3898,-1917,76,-1993,148
"37860",NA,12033,"Escambia County, FL","County or equivalent",2007,303657,-2586,1611,4498,2887,-4382,61,-4443,185
"37860",NA,12113,"Santa Rosa County, FL","County or equivalent",2007,147734,3274,846,1857,1011,2465,15,2450,-37
"37900",NA,NA,"Peoria, IL","Metropolitan Statistical Area",2007,370793,2157,1406,5067,3661,719,235,484,32
"37900",NA,17123,"Marshall County, IL","County or equivalent",2007,12823,-3,-26,152,178,20,0,20,3
"37900",NA,17143,"Peoria County, IL","County or equivalent",2007,183006,461,913,2651,1738,-463,204,-667,11
"37900",NA,17175,"Stark County, IL","County or equivalent",2007,6151,16,-12,73,85,33,-1,34,-5
"37900",NA,17179,"Tazewell County, IL","County or equivalent",2007,130869,1104,408,1735,1327,679,29,650,17
"37900",NA,17203,"Woodford County, IL","County or equivalent",2007,37944,579,123,456,333,450,3,447,6
"37980",NA,NA,"Philadelphia-Camden-Wilmington, PA-NJ-DE-MD","Metropolitan Statistical Area",2007,5823285,17936,25212,77247,52035,-7533,11065,-18598,257
"37980",15804,NA,"Camden, NJ","Metropolitan Division",2007,1249035,4214,5707,15854,10147,-1902,1557,-3459,409
"37980",15804,34005,"Burlington County, NJ","County or equivalent",2007,446220,-871,1742,5242,3500,-2619,442,-3061,6
"37980",15804,34007,"Camden County, NJ","County or equivalent",2007,517287,826,2851,7290,4439,-2364,986,-3350,339
"37980",15804,34015,"Gloucester County, NJ","County or equivalent",2007,285528,4259,1114,3322,2208,3081,129,2952,64
"37980",37964,NA,"Philadelphia, PA","Metropolitan Division",2007,3882564,9554,15438,51982,36544,-5691,8172,-13863,-193
"37980",37964,42017,"Bucks County, PA","County or equivalent",2007,620063,1597,1750,6896,5146,-277,727,-1004,124
"37980",37964,42029,"Chester County, PA","County or equivalent",2007,485598,7437,2828,6307,3479,4594,732,3862,15
"37980",37964,42045,"Delaware County, PA","County or equivalent",2007,553162,240,1186,6802,5616,-939,922,-1861,-7
"37980",37964,42091,"Montgomery County, PA","County or equivalent",2007,775110,2357,2379,9341,6962,-92,1176,-1268,70
"37980",37964,42101,"Philadelphia County, PA","County or equivalent",2007,1448631,-2077,7295,22636,15341,-8977,4615,-13592,-395
"37980",48864,NA,"Wilmington, DE-MD-NJ","Metropolitan Division",2007,691686,4168,4067,9411,5344,60,1336,-1276,41
"37980",48864,10003,"New Castle County, DE","County or equivalent",2007,526408,3214,3512,7378,3866,-322,1230,-1552,24
"37980",48864,24015,"Cecil County, MD","County or equivalent",2007,99368,848,571,1343,772,275,42,233,2
"37980",48864,34033,"Salem County, NJ","County or equivalent",2007,65910,106,-16,690,706,107,64,43,15
"38060",NA,NA,"Phoenix-Mesa-Scottsdale, AZ","Metropolitan Statistical Area",2007,4165921,130745,46355,72225,25870,84491,18542,65949,-101
"38060",NA,4013,"Maricopa County, AZ","County or equivalent",2007,3865048,98587,43144,67128,23984,56018,18135,37883,-575
"38060",NA,4021,"Pinal County, AZ","County or equivalent",2007,300873,32158,3211,5097,1886,28473,407,28066,474
"38220",NA,NA,"Pine Bluff, AR","Metropolitan Statistical Area",2007,101608,-1120,340,1395,1055,-1452,45,-1497,-8
"38220",NA,5025,"Cleveland County, AR","County or equivalent",2007,8751,76,22,110,88,52,0,52,2
"38220",NA,5069,"Jefferson County, AR","County or equivalent",2007,79156,-1083,299,1144,845,-1376,45,-1421,-6
"38220",NA,5079,"Lincoln County, AR","County or equivalent",2007,13701,-113,19,141,122,-128,0,-128,-4
"38300",NA,NA,"Pittsburgh, PA","Metropolitan Statistical Area",2007,2354159,-6591,-3237,24255,27492,-3351,1711,-5062,-3
"38300",NA,42003,"Allegheny County, PA","County or equivalent",2007,1218429,-4950,-1313,12867,14180,-3447,1528,-4975,-190
"38300",NA,42005,"Armstrong County, PA","County or equivalent",2007,69004,-264,-162,694,856,-126,-1,-125,24
"38300",NA,42007,"Beaver County, PA","County or equivalent",2007,173023,-927,-389,1779,2168,-549,36,-585,11
"38300",NA,42019,"Butler County, PA","County or equivalent",2007,181734,664,186,1995,1809,493,60,433,-15
"38300",NA,42051,"Fayette County, PA","County or equivalent",2007,144376,-394,-247,1481,1728,-146,13,-159,-1
"38300",NA,42125,"Washington County, PA","County or equivalent",2007,205432,296,-321,2100,2421,540,36,504,77
"38300",NA,42129,"Westmoreland County, PA","County or equivalent",2007,362161,-1016,-991,3339,4330,-116,39,-155,91
"38340",NA,NA,"Pittsfield, MA","Metropolitan Statistical Area",2007,130032,-318,-209,1258,1467,-136,106,-242,27
"38340",NA,25003,"Berkshire County, MA","County or equivalent",2007,130032,-318,-209,1258,1467,-136,106,-242,27
"38540",NA,NA,"Pocatello, ID","Metropolitan Statistical Area",2007,87571,528,1016,1637,621,-485,75,-560,-3
"38540",NA,16005,"Bannock County, ID","County or equivalent",2007,79923,536,925,1510,585,-385,51,-436,-4
"38540",NA,16077,"Power County, ID","County or equivalent",2007,7648,-8,91,127,36,-100,24,-124,1
"38860",NA,NA,"Portland-South Portland-Biddeford, ME","Metropolitan Statistical Area",2007,512357,1178,1476,5633,4157,-359,322,-681,61
"38860",NA,23005,"Cumberland County, ME","County or equivalent",2007,274882,781,838,3089,2251,-99,263,-362,42
"38860",NA,23023,"Sagadahoc County, ME","County or equivalent",2007,36344,-77,95,417,322,-177,2,-179,5
"38860",NA,23031,"York County, ME","County or equivalent",2007,201131,474,543,2127,1584,-83,57,-140,14
"38900",NA,NA,"Portland-Vancouver-Beaverton, OR-WA","Metropolitan Statistical Area",2007,2166491,40016,15774,30326,14552,24651,7550,17101,-409
"38900",NA,41005,"Clackamas County, OR","County or equivalent",2007,375107,4516,1369,4106,2737,3231,713,2518,-84
"38900",NA,41009,"Columbia County, OR","County or equivalent",2007,48914,702,165,482,317,531,10,521,6
"38900",NA,41051,"Multnomah County, OR","County or equivalent",2007,699186,14493,5042,10373,5331,9348,3100,6248,103
"38900",NA,41067,"Washington County, OR","County or equivalent",2007,519794,8867,5377,8027,2650,3657,2374,1283,-167
"38900",NA,41071,"Yamhill County, OR","County or equivalent",2007,96299,2825,628,1382,754,2216,244,1972,-19
"38900",NA,53011,"Clark County, WA","County or equivalent",2007,416493,8422,3156,5851,2695,5514,1107,4407,-248
"38900",NA,53059,"Skamania County, WA","County or equivalent",2007,10698,191,37,105,68,154,2,152,0
"38940",NA,NA,"Port St. Lucie, FL","Metropolitan Statistical Area",2007,398880,11227,749,5024,4275,10242,731,9511,236
"38940",NA,12085,"Martin County, FL","County or equivalent",2007,138790,755,-290,1383,1673,1076,261,815,-31
"38940",NA,12111,"St. Lucie County, FL","County or equivalent",2007,260090,10472,1039,3641,2602,9166,470,8696,267
"39100",NA,NA,"Poughkeepsie-Newburgh-Middletown, NY","Metropolitan Statistical Area",2007,668629,3093,3815,8527,4712,-764,1096,-1860,42
"39100",NA,36027,"Dutchess County, NY","County or equivalent",2007,292224,327,889,3138,2249,-586,534,-1120,24
"39100",NA,36071,"Orange County, NY","County or equivalent",2007,376405,2766,2926,5389,2463,-178,562,-740,18
"39140",NA,NA,"Prescott, AZ","Metropolitan Statistical Area",2007,212179,5879,216,2502,2286,5703,257,5446,-40
"39140",NA,4025,"Yavapai County, AZ","County or equivalent",2007,212179,5879,216,2502,2286,5703,257,5446,-40
"39300",NA,NA,"Providence-New Bedford-Fall River, RI-MA","Metropolitan Statistical Area",2007,1598348,-5284,4789,18985,14196,-10252,3514,-13766,179
"39300",NA,25005,"Bristol County, MA","County or equivalent",2007,545212,571,1579,6457,4878,-1055,698,-1753,47
"39300",NA,44001,"Bristol County, RI","County or equivalent",2007,49941,-213,-105,411,516,-125,23,-148,17
"39300",NA,44003,"Kent County, RI","County or equivalent",2007,168321,-935,54,1721,1667,-1020,117,-1137,31
"39300",NA,44005,"Newport County, RI","County or equivalent",2007,81093,-2061,210,908,698,-2341,70,-2411,70
"39300",NA,44007,"Providence County, RI","County or equivalent",2007,627268,-2275,2940,8369,5429,-5216,2521,-7737,1
"39300",NA,44009,"Washington County, RI","County or equivalent",2007,126513,-371,111,1119,1008,-495,85,-580,13
"39340",NA,NA,"Provo-Orem, UT","Metropolitan Statistical Area",2007,522831,31672,10594,12447,1853,9511,1071,8440,11567
"39340",NA,49023,"Juab County, UT","County or equivalent",2007,9568,456,133,183,50,317,1,316,6
"39340",NA,49049,"Utah County, UT","County or equivalent",2007,513263,31216,10461,12264,1803,9194,1070,8124,11561
"39380",NA,NA,"Pueblo, CO","Metropolitan Statistical Area",2007,154678,2980,739,2174,1435,2180,136,2044,61
"39380",NA,8101,"Pueblo County, CO","County or equivalent",2007,154678,2980,739,2174,1435,2180,136,2044,61
"39460",NA,NA,"Punta Gorda, FL","Metropolitan Statistical Area",2007,152479,-325,-961,1195,2156,1280,138,1142,-644
"39460",NA,12015,"Charlotte County, FL","County or equivalent",2007,152479,-325,-961,1195,2156,1280,138,1142,-644
"39540",NA,NA,"Racine, WI","Metropolitan Statistical Area",2007,199018,935,1173,2694,1521,-712,209,-921,474
"39540",NA,55101,"Racine County, WI","County or equivalent",2007,199018,935,1173,2694,1521,-712,209,-921,474
"39580",NA,NA,"Raleigh-Cary, NC","Metropolitan Statistical Area",2007,1043961,46846,11189,16480,5291,35214,3741,31473,443
"39580",NA,37069,"Franklin County, NC","County or equivalent",2007,57052,1737,270,734,464,1440,101,1339,27
"39580",NA,37101,"Johnston County, NC","County or equivalent",2007,156880,6294,1446,2476,1030,4762,412,4350,86
"39580",NA,37183,"Wake County, NC","County or equivalent",2007,830029,38815,9473,13270,3797,29012,3228,25784,330
"39660",NA,NA,"Rapid City, SD","Metropolitan Statistical Area",2007,120287,1342,1210,2025,815,94,10,84,38
"39660",NA,46093,"Meade County, SD","County or equivalent",2007,24057,-226,182,376,194,-421,-12,-409,13
"39660",NA,46103,"Pennington County, SD","County or equivalent",2007,96230,1568,1028,1649,621,515,22,493,25
"39740",NA,NA,"Reading, PA","Metropolitan Statistical Area",2007,401479,3126,1604,5244,3640,1423,656,767,99
"39740",NA,42011,"Berks County, PA","County or equivalent",2007,401479,3126,1604,5244,3640,1423,656,767,99
"39820",NA,NA,"Redding, CA","Metropolitan Statistical Area",2007,179068,816,344,2264,1920,442,91,351,30
"39820",NA,6089,"Shasta County, CA","County or equivalent",2007,179068,816,344,2264,1920,442,91,351,30
"39900",NA,NA,"Reno-Sparks, NV","Metropolitan Statistical Area",2007,408887,7751,2929,6056,3127,4855,1361,3494,-33
"39900",NA,32029,"Storey County, NV","County or equivalent",2007,4177,101,12,23,11,94,2,92,-5
"39900",NA,32031,"Washoe County, NV","County or equivalent",2007,404710,7650,2917,6033,3116,4761,1359,3402,-28
"40060",NA,NA,"Richmond, VA","Metropolitan Statistical Area",2007,1211101,17226,6460,16269,9809,10963,1466,9497,-197
"40060",NA,51007,"Amelia County, VA","County or equivalent",2007,12639,251,29,152,123,219,1,218,3
"40060",NA,51033,"Caroline County, VA","County or equivalent",2007,27223,801,143,391,248,643,6,637,15
"40060",NA,51036,"Charles City County, VA","County or equivalent",2007,7130,14,25,70,45,-9,1,-10,-2
"40060",NA,51041,"Chesterfield County, VA","County or equivalent",2007,299022,5661,2304,3983,1679,3334,367,2967,23
"40060",NA,51049,"Cumberland County, VA","County or equivalent",2007,9587,150,62,117,55,95,8,87,-7
"40060",NA,51053,"Dinwiddie County, VA","County or equivalent",2007,25695,305,53,284,231,268,3,265,-16
"40060",NA,51075,"Goochland County, VA","County or equivalent",2007,20553,581,43,203,160,526,12,514,12
"40060",NA,51085,"Hanover County, VA","County or equivalent",2007,98862,870,349,1082,733,531,36,495,-10
"40060",NA,51087,"Henrico County, VA","County or equivalent",2007,289460,4273,1757,4165,2408,2606,700,1906,-90
"40060",NA,51097,"King and Queen County, VA","County or equivalent",2007,6864,33,13,79,66,21,-1,22,-1
"40060",NA,51101,"King William County, VA","County or equivalent",2007,15663,529,98,219,121,431,4,427,0
"40060",NA,51109,"Louisa County, VA","County or equivalent",2007,31881,873,92,381,289,787,4,783,-6
"40060",NA,51127,"New Kent County, VA","County or equivalent",2007,17243,601,75,189,114,519,0,519,7
"40060",NA,51145,"Powhatan County, VA","County or equivalent",2007,27599,307,123,274,151,183,1,182,1
"40060",NA,51149,"Prince George County, VA","County or equivalent",2007,35848,-93,197,346,149,-269,-44,-225,-21
"40060",NA,51183,"Sussex County, VA","County or equivalent",2007,12112,39,-5,122,127,40,6,34,4
"40060",NA,51570,"Colonial Heights city, VA","County or equivalent",2007,17756,-28,19,226,207,-43,10,-53,-4
"40060",NA,51670,"Hopewell city, VA","County or equivalent",2007,23066,339,150,382,232,182,10,172,7
"40060",NA,51730,"Petersburg city, VA","County or equivalent",2007,32907,209,120,576,456,80,11,69,9
"40060",NA,51760,"Richmond city, VA","County or equivalent",2007,199991,1511,813,3028,2215,819,331,488,-121
"40140",NA,NA,"Riverside-San Bernardino-Ontario, CA","Metropolitan Statistical Area",2007,4066573,84061,43460,70117,26657,40276,10561,29715,325
"40140",NA,6065,"Riverside County, CA","County or equivalent",2007,2064365,63549,20638,34912,14274,42761,5408,37353,150
"40140",NA,6071,"San Bernardino County, CA","County or equivalent",2007,2002208,20512,22822,35205,12383,-2485,5153,-7638,175
"40220",NA,NA,"Roanoke, VA","Metropolitan Statistical Area",2007,296355,2174,336,3555,3219,1901,257,1644,-63
"40220",NA,51023,"Botetourt County, VA","County or equivalent",2007,31981,119,-1,267,268,146,2,144,-26
"40220",NA,51045,"Craig County, VA","County or equivalent",2007,5132,44,9,53,44,35,1,34,0
"40220",NA,51067,"Franklin County, VA","County or equivalent",2007,51272,932,81,574,493,847,6,841,4
"40220",NA,51161,"Roanoke County, VA","County or equivalent",2007,90186,761,247,1145,898,491,86,405,23
"40220",NA,51770,"Roanoke city, VA","County or equivalent",2007,92663,255,57,1290,1233,259,147,112,-61
"40220",NA,51775,"Salem city, VA","County or equivalent",2007,25121,63,-57,226,283,123,15,108,-3
"40340",NA,NA,"Rochester, MN","Metropolitan Statistical Area",2007,180305,1944,1569,2732,1163,358,501,-143,17
"40340",NA,27039,"Dodge County, MN","County or equivalent",2007,19476,40,161,283,122,-121,7,-128,0
"40340",NA,27109,"Olmsted County, MN","County or equivalent",2007,139132,2052,1357,2202,845,687,475,212,8
"40340",NA,27157,"Wabasha County, MN","County or equivalent",2007,21697,-148,51,247,196,-208,19,-227,9
"40380",NA,NA,"Rochester, NY","Metropolitan Statistical Area",2007,1032488,-369,3234,12125,8891,-3893,1615,-5508,290
"40380",NA,36051,"Livingston County, NY","County or equivalent",2007,63169,-109,138,645,507,-257,6,-263,10
"40380",NA,36055,"Monroe County, NY","County or equivalent",2007,731780,-203,2437,8706,6269,-2890,1487,-4377,250
"40380",NA,36069,"Ontario County, NY","County or equivalent",2007,103740,406,238,1152,914,150,76,74,18
"40380",NA,36073,"Orleans County, NY","County or equivalent",2007,42308,-209,95,470,375,-310,12,-322,6
"40380",NA,36117,"Wayne County, NY","County or equivalent",2007,91491,-254,326,1152,826,-586,34,-620,6
"40420",NA,NA,"Rockford, IL","Metropolitan Statistical Area",2007,351260,6626,2108,4946,2838,4431,728,3703,87
"40420",NA,17007,"Boone County, IL","County or equivalent",2007,53250,1719,432,773,341,1271,110,1161,16
"40420",NA,17201,"Winnebago County, IL","County or equivalent",2007,298010,4907,1676,4173,2497,3160,618,2542,71
"40580",NA,NA,"Rocky Mount, NC","Metropolitan Statistical Area",2007,145333,958,558,2057,1499,448,152,296,-48
"40580",NA,37065,"Edgecombe County, NC","County or equivalent",2007,52628,-478,175,771,596,-620,63,-683,-33
"40580",NA,37127,"Nash County, NC","County or equivalent",2007,92705,1436,383,1286,903,1068,89,979,-15
"40660",NA,NA,"Rome, GA","Metropolitan Statistical Area",2007,95364,358,477,1479,1002,-99,196,-295,-20
"40660",NA,13115,"Floyd County, GA","County or equivalent",2007,95364,358,477,1479,1002,-99,196,-295,-20
"40900",NA,NA,"Sacramento--Arden-Arcade--Roseville, CA","Metropolitan Statistical Area",2007,2082186,26197,15703,30784,15081,10724,6967,3757,-230
"40900",NA,6017,"El Dorado County, CA","County or equivalent",2007,175199,328,829,2032,1203,-314,232,-546,-187
"40900",NA,6061,"Placer County, CA","County or equivalent",2007,332121,8363,1528,4106,2578,7144,387,6757,-309
"40900",NA,6067,"Sacramento County, CA","County or equivalent",2007,1380232,12495,11822,21945,10123,408,5195,-4787,265
"40900",NA,6113,"Yolo County, CA","County or equivalent",2007,194634,5011,1524,2701,1177,3486,1153,2333,1
"40980",NA,NA,"Saginaw-Saginaw Township North, MI","Metropolitan Statistical Area",2007,202272,-2590,453,2552,2099,-3171,111,-3282,128
"40980",NA,26145,"Saginaw County, MI","County or equivalent",2007,202272,-2590,453,2552,2099,-3171,111,-3282,128
"41060",NA,NA,"St. Cloud, MN","Metropolitan Statistical Area",2007,185543,2286,1446,2576,1130,833,123,710,7
"41060",NA,27009,"Benton County, MN","County or equivalent",2007,39476,505,285,597,312,241,18,223,-21
"41060",NA,27145,"Stearns County, MN","County or equivalent",2007,146067,1781,1161,1979,818,592,105,487,28
"41100",NA,NA,"St. George, UT","Metropolitan Statistical Area",2007,133447,6374,1998,2813,815,4571,127,4444,-195
"41100",NA,49053,"Washington County, UT","County or equivalent",2007,133447,6374,1998,2813,815,4571,127,4444,-195
"41140",NA,NA,"St. Joseph, MO-KS","Metropolitan Statistical Area",2007,125831,1554,549,1812,1263,646,26,620,359
"41140",NA,20043,"Doniphan County, KS","County or equivalent",2007,7767,34,28,95,67,12,-1,13,-6
"41140",NA,29003,"Andrew County, MO","County or equivalent",2007,16833,43,40,212,172,0,0,0,3
"41140",NA,29021,"Buchanan County, MO","County or equivalent",2007,89013,1541,486,1387,901,692,24,668,363
"41140",NA,29063,"DeKalb County, MO","County or equivalent",2007,12218,-64,-5,118,123,-58,3,-61,-1
"41180",NA,NA,"St. Louis, MO-IL","Metropolitan Statistical Area",2007,2805465,14705,13798,38067,24269,-3985,2916,-6901,4892
"41180",NA,17005,"Bond County, IL","County or equivalent",2007,18334,218,30,217,187,189,2,187,-1
"41180",NA,17013,"Calhoun County, IL","County or equivalent",2007,5137,13,-3,57,60,17,1,16,-1
"41180",NA,17027,"Clinton County, IL","County or equivalent",2007,36394,89,130,469,339,-42,5,-47,1
"41180",NA,17083,"Jersey County, IL","County or equivalent",2007,22400,69,0,247,247,73,2,71,-4
"41180",NA,17117,"Macoupin County, IL","County or equivalent",2007,48160,30,16,594,578,9,3,6,5
"41180",NA,17119,"Madison County, IL","County or equivalent",2007,267053,1069,855,3494,2639,168,64,104,46
"41180",NA,17133,"Monroe County, IL","County or equivalent",2007,32324,446,141,411,270,301,5,296,4
"41180",NA,17163,"St. Clair County, IL","County or equivalent",2007,261467,997,1348,3874,2526,-357,11,-368,6
"41180",NA,29071,"Franklin County, MO","County or equivalent",2007,99922,916,481,1367,886,435,6,429,0
"41180",NA,29099,"Jefferson County, MO","County or equivalent",2007,215764,2105,1473,3065,1592,601,61,540,31
"41180",NA,29113,"Lincoln County, MO","County or equivalent",2007,51432,1838,418,776,358,1422,6,1416,-2
"41180",NA,29183,"St. Charles County, MO","County or equivalent",2007,343207,7387,2838,4735,1897,4566,142,4424,-17
"41180",NA,29189,"St. Louis County, MO","County or equivalent",2007,993512,-3441,3610,12470,8860,-7136,1336,-8472,85
"41180",NA,29219,"Warren County, MO","County or equivalent",2007,30414,944,272,503,231,656,6,650,16
"41180",NA,29221,"Washington County, MO","County or equivalent",2007,24282,199,104,369,265,104,4,100,-9
"41180",NA,29510,"St. Louis city, MO","County or equivalent",2007,355663,1826,2085,5419,3334,-4991,1262,-6253,4732
"41420",NA,NA,"Salem, OR","Metropolitan Statistical Area",2007,385108,6509,3016,5933,2917,3565,1405,2160,-72
"41420",NA,41047,"Marion County, OR","County or equivalent",2007,310100,4138,2726,5108,2382,1416,1267,149,-4
"41420",NA,41053,"Polk County, OR","County or equivalent",2007,75008,2371,290,825,535,2149,138,2011,-68
"41500",NA,NA,"Salinas, CA","Metropolitan Statistical Area",2007,404646,724,5066,7426,2360,-4340,2965,-7305,-2
"41500",NA,6053,"Monterey County, CA","County or equivalent",2007,404646,724,5066,7426,2360,-4340,2965,-7305,-2
"41540",NA,NA,"Salisbury, MD","Metropolitan Statistical Area",2007,119365,1494,462,1636,1174,1085,133,952,-53
"41540",NA,24039,"Somerset County, MD","County or equivalent",2007,26147,372,9,275,266,359,20,339,4
"41540",NA,24045,"Wicomico County, MD","County or equivalent",2007,93218,1122,453,1361,908,726,113,613,-57
"41620",NA,NA,"Salt Lake City, UT","Metropolitan Statistical Area",2007,1095362,21108,15561,21084,5523,5656,4355,1301,-109
"41620",NA,49035,"Salt Lake County, UT","County or equivalent",2007,1005245,18210,14265,19422,5157,4046,4192,-146,-101
"41620",NA,49043,"Summit County, UT","County or equivalent",2007,35377,510,437,540,103,85,112,-27,-12
"41620",NA,49045,"Tooele County, UT","County or equivalent",2007,54740,2388,859,1122,263,1525,51,1474,4
"41660",NA,NA,"San Angelo, TX","Metropolitan Statistical Area",2007,108351,836,747,1719,972,81,40,41,8
"41660",NA,48235,"Irion County, TX","County or equivalent",2007,1722,-21,-2,7,9,-17,1,-18,-2
"41660",NA,48451,"Tom Green County, TX","County or equivalent",2007,106629,857,749,1712,963,98,39,59,10
"41700",NA,NA,"San Antonio, TX","Metropolitan Statistical Area",2007,1984921,52927,18431,32316,13885,34121,3211,30910,375
"41700",NA,48013,"Atascosa County, TX","County or equivalent",2007,43477,527,333,679,346,204,31,173,-10
"41700",NA,48019,"Bandera County, TX","County or equivalent",2007,20112,471,14,191,177,454,11,443,3
"41700",NA,48029,"Bexar County, TX","County or equivalent",2007,1590146,38784,16177,26990,10813,22253,2915,19338,354
"41700",NA,48091,"Comal County, TX","County or equivalent",2007,104751,4972,587,1414,827,4344,80,4264,41
"41700",NA,48187,"Guadalupe County, TX","County or equivalent",2007,112365,4929,768,1561,793,4131,131,4000,30
"41700",NA,48259,"Kendall County, TX","County or equivalent",2007,31171,1422,77,369,292,1395,28,1367,-50
"41700",NA,48325,"Medina County, TX","County or equivalent",2007,43753,595,271,609,338,316,12,304,8
"41700",NA,48493,"Wilson County, TX","County or equivalent",2007,39146,1227,204,503,299,1024,3,1021,-1
"41740",NA,NA,"San Diego-Carlsbad-San Marcos, CA","Metropolitan Statistical Area",2007,2959734,22711,27448,47001,19553,-4803,10750,-15553,66
"41740",NA,6073,"San Diego County, CA","County or equivalent",2007,2959734,22711,27448,47001,19553,-4803,10750,-15553,66
"41780",NA,NA,"Sandusky, OH","Metropolitan Statistical Area",2007,77162,-261,23,886,863,-305,17,-322,21
"41780",NA,39043,"Erie County, OH","County or equivalent",2007,77162,-261,23,886,863,-305,17,-322,21
"41860",NA,NA,"San Francisco-Oakland-Fremont, CA","Metropolitan Statistical Area",2007,4216125,38514,26169,55251,29082,6898,27434,-20536,5447
"41860",36084,NA,"Oakland-Fremont-Hayward, CA","Metropolitan Division",2007,2468333,19142,17883,34246,16363,1096,14837,-13741,163
"41860",36084,6001,"Alameda County, CA","County or equivalent",2007,1453646,10154,11431,20835,9404,-1348,10755,-12103,71
"41860",36084,6013,"Contra Costa County, CA","County or equivalent",2007,1014687,8988,6452,13411,6959,2444,4082,-1638,92
"41860",41884,NA,"San Francisco-San Mateo-Redwood City, CA","Metropolitan Division",2007,1747792,19372,8286,21005,12719,5802,12597,-6795,5284
"41860",41884,6041,"Marin County, CA","County or equivalent",2007,246932,1704,823,2652,1829,822,1072,-250,59
"41860",41884,6075,"San Francisco County, CA","County or equivalent",2007,799185,12818,2505,8687,6182,5074,6163,-1089,5239
"41860",41884,6081,"San Mateo County, CA","County or equivalent",2007,701675,4850,4958,9666,4708,-94,5362,-5456,-14
"41940",NA,NA,"San Jose-Sunnyvale-Santa Clara, CA","Metropolitan Statistical Area",2007,1786355,24097,18298,27671,9373,5979,17882,-11903,-180
"41940",NA,6069,"San Benito County, CA","County or equivalent",2007,54397,-51,595,847,252,-660,240,-900,14
"41940",NA,6085,"Santa Clara County, CA","County or equivalent",2007,1731958,24148,17703,26824,9121,6639,17642,-11003,-194
"42020",NA,NA,"San Luis Obispo-Paso Robles, CA","Metropolitan Statistical Area",2007,261766,2116,743,2868,2125,1298,431,867,75
"42020",NA,6079,"San Luis Obispo County, CA","County or equivalent",2007,261766,2116,743,2868,2125,1298,431,867,75
"42060",NA,NA,"Santa Barbara-Santa Maria-Goleta, CA","Metropolitan Statistical Area",2007,402092,1699,3324,6142,2818,-1579,1970,-3549,-46
"42060",NA,6083,"Santa Barbara County, CA","County or equivalent",2007,402092,1699,3324,6142,2818,-1579,1970,-3549,-46
"42100",NA,NA,"Santa Cruz-Watsonville, CA","Metropolitan Statistical Area",2007,250655,1012,1915,3517,1602,-947,1082,-2029,44
"42100",NA,6087,"Santa Cruz County, CA","County or equivalent",2007,250655,1012,1915,3517,1602,-947,1082,-2029,44
"42140",NA,NA,"Santa Fe, NM","Metropolitan Statistical Area",2007,142369,1721,700,1656,956,1048,537,511,-27
"42140",NA,35049,"Santa Fe County, NM","County or equivalent",2007,142369,1721,700,1656,956,1048,537,511,-27
"42220",NA,NA,"Santa Rosa-Petaluma, CA","Metropolitan Statistical Area",2007,462290,1343,2149,5879,3730,-926,1743,-2669,120
"42220",NA,6097,"Sonoma County, CA","County or equivalent",2007,462290,1343,2149,5879,3730,-926,1743,-2669,120
"42340",NA,NA,"Savannah, GA","Metropolitan Statistical Area",2007,329307,8122,2489,5223,2734,5533,291,5242,100
"42340",NA,13029,"Bryan County, GA","County or equivalent",2007,29991,1286,270,476,206,1001,-1,1002,15
"42340",NA,13051,"Chatham County, GA","County or equivalent",2007,248532,4685,1847,4071,2224,2772,285,2487,66
"42340",NA,13103,"Effingham County, GA","County or equivalent",2007,50784,2151,372,676,304,1760,7,1753,19
"42540",NA,NA,"Scranton--Wilkes-Barre, PA","Metropolitan Statistical Area",2007,549052,1021,-1156,5903,7059,2011,218,1793,166
"42540",NA,42069,"Lackawanna County, PA","County or equivalent",2007,209262,351,-339,2342,2681,624,92,532,66
"42540",NA,42079,"Luzerne County, PA","County or equivalent",2007,311982,691,-863,3236,4099,1448,123,1325,106
"42540",NA,42131,"Wyoming County, PA","County or equivalent",2007,27808,-21,46,325,279,-61,3,-64,-6
"42660",NA,NA,"Seattle-Tacoma-Bellevue, WA","Metropolitan Statistical Area",2007,3298225,44248,22192,43887,21695,21690,11409,10281,366
"42660",42644,NA,"Seattle-Bellevue-Everett, WA","Metropolitan Division",2007,2525120,34830,16840,32884,16044,17707,10361,7346,283
"42660",42644,53033,"King County, WA","County or equivalent",2007,1850714,23181,11795,23622,11827,11233,8790,2443,153
"42660",42644,53061,"Snohomish County, WA","County or equivalent",2007,674406,11649,5045,9262,4217,6474,1571,4903,130
"42660",45104,NA,"Tacoma, WA","Metropolitan Division",2007,773105,9418,5352,11003,5651,3983,1048,2935,83
"42660",45104,53053,"Pierce County, WA","County or equivalent",2007,773105,9418,5352,11003,5651,3983,1048,2935,83
"42680",NA,NA,"Sebastian-Vero Beach, FL","Metropolitan Statistical Area",2007,131446,2146,-255,1435,1690,2372,217,2155,29
"42680",NA,12061,"Indian River County, FL","County or equivalent",2007,131446,2146,-255,1435,1690,2372,217,2155,29
"43100",NA,NA,"Sheboygan, WI","Metropolitan Statistical Area",2007,114206,308,410,1442,1032,-110,125,-235,8
"43100",NA,55117,"Sheboygan County, WI","County or equivalent",2007,114206,308,410,1442,1032,-110,125,-235,8
"43300",NA,NA,"Sherman-Denison, TX","Metropolitan Statistical Area",2007,118066,1237,347,1613,1266,862,165,697,28
"43300",NA,48181,"Grayson County, TX","County or equivalent",2007,118066,1237,347,1613,1266,862,165,697,28
"43340",NA,NA,"Shreveport-Bossier City, LA","Metropolitan Statistical Area",2007,387500,587,2115,5933,3818,-1569,73,-1642,41
"43340",NA,22015,"Bossier Parish, LA","County or equivalent",2007,108746,1144,864,1743,879,279,0,279,1
"43340",NA,22017,"Caddo Parish, LA","County or equivalent",2007,252477,-783,1162,3809,2647,-1984,68,-2052,39
"43340",NA,22031,"De Soto Parish, LA","County or equivalent",2007,26277,226,89,381,292,136,5,131,1
"43580",NA,NA,"Sioux City, IA-NE-SD","Metropolitan Statistical Area",2007,142340,684,1031,2297,1266,-341,425,-766,-6
"43580",NA,19193,"Woodbury County, IA","County or equivalent",2007,101910,114,781,1694,913,-706,288,-994,39
"43580",NA,31043,"Dakota County, NE","County or equivalent",2007,20278,162,163,329,166,17,114,-97,-18
"43580",NA,31051,"Dixon County, NE","County or equivalent",2007,6219,66,11,86,75,78,5,73,-23
"43580",NA,46127,"Union County, SD","County or equivalent",2007,13933,342,76,188,112,270,18,252,-4
"43620",NA,NA,"Sioux Falls, SD","Metropolitan Statistical Area",2007,226993,5531,2189,3665,1476,3366,337,3029,-24
"43620",NA,46083,"Lincoln County, SD","County or equivalent",2007,37732,2033,586,796,210,1418,11,1407,29
"43620",NA,46087,"McCook County, SD","County or equivalent",2007,5747,26,8,71,63,17,-1,18,1
"43620",NA,46099,"Minnehaha County, SD","County or equivalent",2007,175142,3448,1595,2696,1101,1907,327,1580,-54
"43620",NA,46125,"Turner County, SD","County or equivalent",2007,8372,24,0,102,102,24,0,24,0
"43780",NA,NA,"South Bend-Mishawaka, IN-MI","Metropolitan Statistical Area",2007,316233,421,1633,4469,2836,-1163,481,-1644,-49
"43780",NA,18141,"St. Joseph County, IN","County or equivalent",2007,265757,545,1552,3928,2376,-1048,472,-1520,41
"43780",NA,26027,"Cass County, MI","County or equivalent",2007,50476,-124,81,541,460,-115,9,-124,-90
"43900",NA,NA,"Spartanburg, SC","Metropolitan Statistical Area",2007,275285,5739,1180,3833,2653,4579,346,4233,-20
"43900",NA,45083,"Spartanburg County, SC","County or equivalent",2007,275285,5739,1180,3833,2653,4579,346,4233,-20
"44060",NA,NA,"Spokane, WA","Metropolitan Statistical Area",2007,456004,9072,2410,6143,3733,6716,561,6155,-54
"44060",NA,53063,"Spokane County, WA","County or equivalent",2007,456004,9072,2410,6143,3733,6716,561,6155,-54
"44100",NA,NA,"Springfield, IL","Metropolitan Statistical Area",2007,206292,638,808,2723,1915,-207,73,-280,37
"44100",NA,17129,"Menard County, IL","County or equivalent",2007,12454,116,20,143,123,100,1,99,-4
"44100",NA,17167,"Sangamon County, IL","County or equivalent",2007,193838,522,788,2580,1792,-307,72,-379,41
"44140",NA,NA,"Springfield, MA","Metropolitan Statistical Area",2007,686941,226,1613,7825,6212,-1497,1866,-3363,110
"44140",NA,25011,"Franklin County, MA","County or equivalent",2007,71647,-46,86,699,613,-154,82,-236,22
"44140",NA,25013,"Hampden County, MA","County or equivalent",2007,460629,-98,1459,5862,4403,-1655,1521,-3176,98
"44140",NA,25015,"Hampshire County, MA","County or equivalent",2007,154665,370,68,1264,1196,312,263,49,-10
"44180",NA,NA,"Springfield, MO","Metropolitan Statistical Area",2007,419607,9484,2524,5982,3458,6901,160,6741,59
"44180",NA,29043,"Christian County, MO","County or equivalent",2007,72954,3266,599,1066,467,2662,2,2660,5
"44180",NA,29059,"Dallas County, MO","County or equivalent",2007,16815,366,53,231,178,307,1,306,6
"44180",NA,29077,"Greene County, MO","County or equivalent",2007,263793,4430,1429,3651,2222,2960,133,2827,41
"44180",NA,29167,"Polk County, MO","County or equivalent",2007,30162,519,147,449,302,367,19,348,5
"44180",NA,29225,"Webster County, MO","County or equivalent",2007,35883,903,296,585,289,605,5,600,2
"44220",NA,NA,"Springfield, OH","Metropolitan Statistical Area",2007,140293,-673,339,1904,1565,-1052,26,-1078,40
"44220",NA,39023,"Clark County, OH","County or equivalent",2007,140293,-673,339,1904,1565,-1052,26,-1078,40
"44300",NA,NA,"State College, PA","Metropolitan Statistical Area",2007,143768,-1,478,1385,907,-512,497,-1009,33
"44300",NA,42027,"Centre County, PA","County or equivalent",2007,143768,-1,478,1385,907,-512,497,-1009,33
"44700",NA,NA,"Stockton, CA","Metropolitan Statistical Area",2007,667886,5491,7118,11737,4619,-1713,2349,-4062,86
"44700",NA,6077,"San Joaquin County, CA","County or equivalent",2007,667886,5491,7118,11737,4619,-1713,2349,-4062,86
"44940",NA,NA,"Sumter, SC","Metropolitan Statistical Area",2007,104008,-93,621,1659,1038,-754,-4,-750,40
"44940",NA,45085,"Sumter County, SC","County or equivalent",2007,104008,-93,621,1659,1038,-754,-4,-750,40
"45060",NA,NA,"Syracuse, NY","Metropolitan Statistical Area",2007,643974,-898,2113,7731,5618,-2989,850,-3839,-22
"45060",NA,36053,"Madison County, NY","County or equivalent",2007,69862,232,187,757,570,56,19,37,-11
"45060",NA,36067,"Onondaga County, NY","County or equivalent",2007,452653,-994,1592,5568,3976,-2564,811,-3375,-22
"45060",NA,36075,"Oswego County, NY","County or equivalent",2007,121459,-136,334,1406,1072,-481,20,-501,11
"45220",NA,NA,"Tallahassee, FL","Metropolitan Statistical Area",2007,353425,6097,2198,4626,2428,3894,461,3433,5
"45220",NA,12039,"Gadsden County, FL","County or equivalent",2007,46756,664,245,750,505,432,52,380,-13
"45220",NA,12065,"Jefferson County, FL","County or equivalent",2007,14429,-101,16,168,152,-109,0,-109,-8
"45220",NA,12073,"Leon County, FL","County or equivalent",2007,262141,4524,1829,3371,1542,2657,403,2254,38
"45220",NA,12129,"Wakulla County, FL","County or equivalent",2007,30099,1010,108,337,229,914,6,908,-12
"45300",NA,NA,"Tampa-St. Petersburg-Clearwater, FL","Metropolitan Statistical Area",2007,2715273,28182,5010,33835,28825,23052,6935,16117,120
"45300",NA,12053,"Hernando County, FL","County or equivalent",2007,168809,5593,-733,1684,2417,6290,76,6214,36
"45300",NA,12057,"Hillsborough County, FL","County or equivalent",2007,1170518,12241,8328,17480,9152,4097,4046,51,-184
"45300",NA,12101,"Pasco County, FL","County or equivalent",2007,461502,16437,-213,5381,5594,16604,525,16079,46
"45300",NA,12103,"Pinellas County, FL","County or equivalent",2007,914444,-6089,-2372,9290,11662,-3939,2288,-6227,222
"45460",NA,NA,"Terre Haute, IN","Metropolitan Statistical Area",2007,170111,179,218,2086,1868,-13,98,-111,-26
"45460",NA,18021,"Clay County, IN","County or equivalent",2007,26632,-115,35,332,297,-155,8,-163,5
"45460",NA,18153,"Sullivan County, IN","County or equivalent",2007,21340,-19,-17,220,237,-7,0,-7,5
"45460",NA,18165,"Vermillion County, IN","County or equivalent",2007,16378,-58,-37,178,215,-17,3,-20,-4
"45460",NA,18167,"Vigo County, IN","County or equivalent",2007,105761,371,237,1356,1119,166,87,79,-32
"45500",NA,NA,"Texarkana, TX-Texarkana, AR","Metropolitan Statistical Area",2007,134224,382,614,1862,1248,-237,53,-290,5
"45500",NA,5091,"Miller County, AR","County or equivalent",2007,42785,72,388,676,288,-312,19,-331,-4
"45500",NA,48037,"Bowie County, TX","County or equivalent",2007,91439,310,226,1186,960,75,34,41,9
"45780",NA,NA,"Toledo, OH","Metropolitan Statistical Area",2007,650770,-977,2753,8810,6057,-3777,496,-4273,47
"45780",NA,39051,"Fulton County, OH","County or equivalent",2007,42482,-30,159,517,358,-189,8,-197,0
"45780",NA,39095,"Lucas County, OH","County or equivalent",2007,442408,-1500,2221,6483,4262,-3790,394,-4184,69
"45780",NA,39123,"Ottawa County, OH","County or equivalent",2007,41069,-131,-41,419,460,-80,1,-81,-10
"45780",NA,39173,"Wood County, OH","County or equivalent",2007,124811,684,414,1391,977,282,93,189,-12
"45820",NA,NA,"Topeka, KS","Metropolitan Statistical Area",2007,228295,994,1196,3305,2109,-174,166,-340,-28
"45820",NA,20085,"Jackson County, KS","County or equivalent",2007,13348,1,62,180,118,-62,-1,-61,1
"45820",NA,20087,"Jefferson County, KS","County or equivalent",2007,18436,7,40,225,185,-28,2,-30,-5
"45820",NA,20139,"Osage County, KS","County or equivalent",2007,16419,-186,9,187,178,-185,0,-185,-10
"45820",NA,20177,"Shawnee County, KS","County or equivalent",2007,173247,1041,1064,2626,1562,-9,166,-175,-14
"45820",NA,20197,"Wabaunsee County, KS","County or equivalent",2007,6845,131,21,87,66,110,-1,111,0
"45940",NA,NA,"Trenton-Ewing, NJ","Metropolitan Statistical Area",2007,363757,494,1867,4737,2870,-1309,1753,-3062,-64
"45940",NA,34021,"Mercer County, NJ","County or equivalent",2007,363757,494,1867,4737,2870,-1309,1753,-3062,-64
"46060",NA,NA,"Tucson, AZ","Metropolitan Statistical Area",2007,996593,22472,6477,14223,7746,11873,2393,9480,4122
"46060",NA,4019,"Pima County, AZ","County or equivalent",2007,996593,22472,6477,14223,7746,11873,2393,9480,4122
"46140",NA,NA,"Tulsa, OK","Metropolitan Statistical Area",2007,904345,13160,5770,14018,8248,7367,1391,5976,23
"46140",NA,40037,"Creek County, OK","County or equivalent",2007,68940,734,141,878,737,577,5,572,16
"46140",NA,40111,"Okmulgee County, OK","County or equivalent",2007,39344,225,96,553,457,122,9,113,7
"46140",NA,40113,"Osage County, OK","County or equivalent",2007,45433,386,125,481,356,296,12,284,-35
"46140",NA,40117,"Pawnee County, OK","County or equivalent",2007,16421,-6,28,202,174,-38,0,-38,4
"46140",NA,40131,"Rogers County, OK","County or equivalent",2007,82931,1719,351,1051,700,1335,27,1308,33
"46140",NA,40143,"Tulsa County, OK","County or equivalent",2007,584141,7975,4508,9944,5436,3430,1311,2119,37
"46140",NA,40145,"Wagoner County, OK","County or equivalent",2007,67135,2127,521,909,388,1645,27,1618,-39
"46220",NA,NA,"Tuscaloosa, AL","Metropolitan Statistical Area",2007,204498,2123,983,2733,1750,1136,185,951,4
"46220",NA,1063,"Greene County, AL","County or equivalent",2007,9204,51,22,124,102,35,1,34,-6
"46220",NA,1065,"Hale County, AL","County or equivalent",2007,18083,200,54,210,156,141,1,140,5
"46220",NA,1125,"Tuscaloosa County, AL","County or equivalent",2007,177211,1872,907,2399,1492,960,183,777,5
"46340",NA,NA,"Tyler, TX","Metropolitan Statistical Area",2007,197952,3650,1412,3133,1721,2223,430,1793,15
"46340",NA,48423,"Smith County, TX","County or equivalent",2007,197952,3650,1412,3133,1721,2223,430,1793,15
"46540",NA,NA,"Utica-Rome, NY","Metropolitan Statistical Area",2007,294058,13,147,3255,3108,-189,589,-778,55
"46540",NA,36043,"Herkimer County, NY","County or equivalent",2007,62388,-62,7,676,669,-54,13,-67,-15
"46540",NA,36065,"Oneida County, NY","County or equivalent",2007,231670,75,140,2579,2439,-135,576,-711,70
"46660",NA,NA,"Valdosta, GA","Metropolitan Statistical Area",2007,129962,1681,1069,2115,1046,661,72,589,-49
"46660",NA,13027,"Brooks County, GA","County or equivalent",2007,16324,51,12,191,179,40,8,32,-1
"46660",NA,13101,"Echols County, GA","County or equivalent",2007,4061,35,14,28,14,31,39,-8,-10
"46660",NA,13173,"Lanier County, GA","County or equivalent",2007,7938,296,47,104,57,247,2,245,2
"46660",NA,13185,"Lowndes County, GA","County or equivalent",2007,101639,1299,996,1792,796,343,23,320,-40
"46700",NA,NA,"Vallejo-Fairfield, CA","Metropolitan Statistical Area",2007,407042,-43,3005,5838,2833,-3153,1128,-4281,105
"46700",NA,6095,"Solano County, CA","County or equivalent",2007,407042,-43,3005,5838,2833,-3153,1128,-4281,105
"47020",NA,NA,"Victoria, TX","Metropolitan Statistical Area",2007,113522,1032,830,1796,966,191,155,36,11
"47020",NA,48057,"Calhoun County, TX","County or equivalent",2007,20257,-19,130,310,180,-142,67,-209,-7
"47020",NA,48175,"Goliad County, TX","County or equivalent",2007,7099,39,15,75,60,23,2,21,1
"47020",NA,48469,"Victoria County, TX","County or equivalent",2007,86166,1012,685,1411,726,310,86,224,17
"47220",NA,NA,"Vineland-Millville-Bridgeton, NJ","Metropolitan Statistical Area",2007,155407,1481,1214,2551,1337,245,418,-173,22
"47220",NA,34011,"Cumberland County, NJ","County or equivalent",2007,155407,1481,1214,2551,1337,245,418,-173,22
"47260",NA,NA,"Virginia Beach-Norfolk-Newport News, VA-NC","Metropolitan Statistical Area",2007,1659679,-1964,11949,24430,12481,-14434,122,-14556,521
"47260",NA,37053,"Currituck County, NC","County or equivalent",2007,23859,413,71,256,185,340,0,340,2
"47260",NA,51073,"Gloucester County, VA","County or equivalent",2007,38198,552,80,405,325,479,-3,482,-7
"47260",NA,51093,"Isle of Wight County, VA","County or equivalent",2007,34947,934,99,409,310,813,3,810,22
"47260",NA,51095,"James City County, VA","County or equivalent",2007,61094,1610,142,587,445,1444,37,1407,24
"47260",NA,51115,"Mathews County, VA","County or equivalent",2007,9038,33,-54,76,130,88,1,87,-1
"47260",NA,51181,"Surry County, VA","County or equivalent",2007,7084,84,32,75,43,50,0,50,2
"47260",NA,51199,"York County, VA","County or equivalent",2007,61086,219,234,575,341,-7,10,-17,-8
"47260",NA,51550,"Chesapeake city, VA","County or equivalent",2007,218830,460,1492,3009,1517,-1055,7,-1062,23
"47260",NA,51650,"Hampton city, VA","County or equivalent",2007,146466,-37,946,2069,1123,-987,9,-996,4
"47260",NA,51700,"Newport News city, VA","County or equivalent",2007,180810,-1002,1780,3176,1396,-2877,103,-2980,95
"47260",NA,51710,"Norfolk city, VA","County or equivalent",2007,235982,-2850,2061,4084,2023,-5040,-110,-4930,129
"47260",NA,51735,"Poquoson city, VA","County or equivalent",2007,11834,74,-5,99,104,75,2,73,4
"47260",NA,51740,"Portsmouth city, VA","County or equivalent",2007,101931,-746,728,1759,1031,-1516,-47,-1469,42
"47260",NA,51800,"Suffolk city, VA","County or equivalent",2007,81119,975,542,1214,672,452,5,447,-19
"47260",NA,51810,"Virginia Beach city, VA","County or equivalent",2007,435004,-2904,3718,6441,2723,-6845,86,-6931,223
"47260",NA,51830,"Williamsburg city, VA","County or equivalent",2007,12397,221,83,196,113,152,19,133,-14
"47300",NA,NA,"Visalia-Porterville, CA","Metropolitan Statistical Area",2007,419172,7124,5773,8574,2801,1351,1805,-454,0
"47300",NA,6107,"Tulare County, CA","County or equivalent",2007,419172,7124,5773,8574,2801,1351,1805,-454,0
"47380",NA,NA,"Waco, TX","Metropolitan Statistical Area",2007,227806,2091,1444,3473,2029,628,457,171,19
"47380",NA,48309,"McLennan County, TX","County or equivalent",2007,227806,2091,1444,3473,2029,628,457,171,19
"47580",NA,NA,"Warner Robins, GA","Metropolitan Statistical Area",2007,130972,2986,1121,2020,899,1832,28,1804,33
"47580",NA,13153,"Houston County, GA","County or equivalent",2007,130972,2986,1121,2020,899,1832,28,1804,33
"47900",NA,NA,"Washington-Arlington-Alexandria, DC-VA-MD-WV","Metropolitan Statistical Area",2007,5302295,42498,48847,79547,30700,-8093,27244,-35337,1744
"47900",13644,NA,"Bethesda-Frederick-Gaithersburg, MD","Metropolitan Division",2007,1165638,8076,9389,16336,6947,-3502,7269,-10771,2189
"47900",13644,24021,"Frederick County, MD","County or equivalent",2007,224147,2655,1611,3059,1448,1035,213,822,9
"47900",13644,24031,"Montgomery County, MD","County or equivalent",2007,941491,5421,7778,13277,5499,-4537,7056,-11593,2180
"47900",47894,NA,"Washington-Arlington-Alexandria, DC-VA-MD-WV","Metropolitan Division",2007,4136657,34422,39458,63211,23753,-4591,19975,-24566,-445
"47900",47894,11001,"District of Columbia, DC","County or equivalent",2007,587868,2449,3139,8450,5311,-540,2783,-3323,-150
"47900",47894,24009,"Calvert County, MD","County or equivalent",2007,88145,609,386,1011,625,259,30,229,-36
"47900",47894,24017,"Charles County, MD","County or equivalent",2007,140169,1005,1025,1899,874,9,31,-22,-29
"47900",47894,24033,"Prince George's County, MD","County or equivalent",2007,825318,-6284,7180,12488,5308,-13473,3360,-16833,9
"47900",47894,51013,"Arlington County, VA","County or equivalent",2007,203909,3120,1880,2844,964,1253,2349,-1096,-13
"47900",47894,51043,"Clarke County, VA","County or equivalent",2007,14341,103,17,142,125,85,10,75,1
"47900",47894,51059,"Fairfax County, VA","County or equivalent",2007,1004151,5663,9825,14306,4481,-4063,7776,-11839,-99
"47900",47894,51061,"Fauquier County, VA","County or equivalent",2007,66122,610,339,798,459,272,54,218,-1
"47900",47894,51107,"Loudoun County, VA","County or equivalent",2007,277346,12388,4351,5215,864,8088,664,7424,-51
"47900",47894,51153,"Prince William County, VA","County or equivalent",2007,359588,7753,5517,6899,1382,2295,865,1430,-59
"47900",47894,51177,"Spotsylvania County, VA","County or equivalent",2007,118887,1226,1110,1755,645,129,43,86,-13
"47900",47894,51179,"Stafford County, VA","County or equivalent",2007,120621,2322,1215,1729,514,1109,-1,1110,-2
"47900",47894,51187,"Warren County, VA","County or equivalent",2007,36257,491,222,521,299,258,6,252,11
"47900",47894,51510,"Alexandria city, VA","County or equivalent",2007,139848,1611,1804,2605,801,-209,1458,-1667,16
"47900",47894,51600,"Fairfax city, VA","County or equivalent",2007,23227,455,124,347,223,349,219,130,-18
"47900",47894,51610,"Falls Church city, VA","County or equivalent",2007,10906,95,61,132,71,41,62,-21,-7
"47900",47894,51630,"Fredericksburg city, VA","County or equivalent",2007,22387,383,235,433,198,183,35,148,-35
"47900",47894,51683,"Manassas city, VA","County or equivalent",2007,35359,-675,509,693,184,-1191,165,-1356,7
"47900",47894,51685,"Manassas Park city, VA","County or equivalent",2007,11420,-24,245,271,26,-275,51,-326,6
"47900",47894,54037,"Jefferson County, WV","County or equivalent",2007,50788,1122,274,673,399,830,15,815,18
"47940",NA,NA,"Waterloo-Cedar Falls, IA","Metropolitan Statistical Area",2007,163074,249,825,2224,1399,-566,302,-868,-10
"47940",NA,19013,"Black Hawk County, IA","County or equivalent",2007,127204,199,741,1784,1043,-529,296,-825,-13
"47940",NA,19017,"Bremer County, IA","County or equivalent",2007,23723,140,74,294,220,69,6,63,-3
"47940",NA,19075,"Grundy County, IA","County or equivalent",2007,12147,-90,10,146,136,-106,0,-106,6
"48140",NA,NA,"Wausau, WI","Metropolitan Statistical Area",2007,129783,980,806,1791,985,157,73,84,17
"48140",NA,55073,"Marathon County, WI","County or equivalent",2007,129783,980,806,1791,985,157,73,84,17
"48260",NA,NA,"Weirton-Steubenville, WV-OH","Metropolitan Statistical Area",2007,122551,-1301,-449,1251,1700,-857,16,-873,5
"48260",NA,39081,"Jefferson County, OH","County or equivalent",2007,68756,-592,-235,733,968,-386,16,-402,29
"48260",NA,54009,"Brooke County, WV","County or equivalent",2007,23637,-240,-104,219,323,-141,0,-141,5
"48260",NA,54029,"Hancock County, WV","County or equivalent",2007,30158,-469,-110,299,409,-330,0,-330,-29
"48300",NA,NA,"Wenatchee, WA","Metropolitan Statistical Area",2007,106729,1762,630,1525,895,1223,336,887,-91
"48300",NA,53007,"Chelan County, WA","County or equivalent",2007,70694,869,332,951,619,627,224,403,-90
"48300",NA,53017,"Douglas County, WA","County or equivalent",2007,36035,893,298,574,276,596,112,484,-1
"48540",NA,NA,"Wheeling, WV-OH","Metropolitan Statistical Area",2007,145764,-908,-353,1475,1828,-528,30,-558,-27
"48540",NA,39013,"Belmont County, OH","County or equivalent",2007,68292,-275,-185,714,899,-78,10,-88,-12
"48540",NA,54051,"Marshall County, WV","County or equivalent",2007,33112,-369,-61,304,365,-281,1,-282,-27
"48540",NA,54069,"Ohio County, WV","County or equivalent",2007,44360,-264,-107,457,564,-169,19,-188,12
"48620",NA,NA,"Wichita, KS","Metropolitan Statistical Area",2007,595321,7301,5004,9899,4895,2289,1039,1250,8
"48620",NA,20015,"Butler County, KS","County or equivalent",2007,62879,503,269,824,555,221,27,194,13
"48620",NA,20079,"Harvey County, KS","County or equivalent",2007,33471,164,98,467,369,62,37,25,4
"48620",NA,20173,"Sedgwick County, KS","County or equivalent",2007,475149,6914,4619,8317,3698,2279,975,1304,16
"48620",NA,20191,"Sumner County, KS","County or equivalent",2007,23822,-280,18,291,273,-273,0,-273,-25
"48660",NA,NA,"Wichita Falls, TX","Metropolitan Statistical Area",2007,147920,-1374,709,2105,1396,-2041,21,-2062,-42
"48660",NA,48009,"Archer County, TX","County or equivalent",2007,8954,-4,29,100,71,-30,0,-30,-3
"48660",NA,48077,"Clay County, TX","County or equivalent",2007,11111,-108,14,108,94,-104,-1,-103,-18
"48660",NA,48485,"Wichita County, TX","County or equivalent",2007,127855,-1262,666,1897,1231,-1907,22,-1929,-21
"48700",NA,NA,"Williamsport, PA","Metropolitan Statistical Area",2007,116835,-407,152,1359,1207,-572,9,-581,13
"48700",NA,42081,"Lycoming County, PA","County or equivalent",2007,116835,-407,152,1359,1207,-572,9,-581,13
"48900",NA,NA,"Wilmington, NC","Metropolitan Statistical Area",2007,338780,10191,1390,4237,2847,8645,335,8310,156
"48900",NA,37019,"Brunswick County, NC","County or equivalent",2007,98966,5092,249,1139,890,4722,78,4644,121
"48900",NA,37129,"New Hanover County, NC","County or equivalent",2007,190104,3166,982,2504,1522,2164,198,1966,20
"48900",NA,37141,"Pender County, NC","County or equivalent",2007,49710,1933,159,594,435,1759,59,1700,15
"49020",NA,NA,"Winchester, VA-WV","Metropolitan Statistical Area",2007,120907,2253,766,1740,974,1472,134,1338,15
"49020",NA,51069,"Frederick County, VA","County or equivalent",2007,72687,1994,568,1044,476,1403,36,1367,23
"49020",NA,51840,"Winchester city, VA","County or equivalent",2007,25678,-65,163,444,281,-211,96,-307,-17
"49020",NA,54027,"Hampshire County, WV","County or equivalent",2007,22542,324,35,252,217,280,2,278,9
"49180",NA,NA,"Winston-Salem, NC","Metropolitan Statistical Area",2007,461615,7893,2714,6614,3900,5114,1231,3883,65
"49180",NA,37059,"Davie County, NC","County or equivalent",2007,40364,781,93,456,363,676,56,620,12
"49180",NA,37067,"Forsyth County, NC","County or equivalent",2007,337639,6713,2457,5171,2714,4201,1081,3120,55
"49180",NA,37169,"Stokes County, NC","County or equivalent",2007,45937,238,58,493,435,181,30,151,-1
"49180",NA,37197,"Yadkin County, NC","County or equivalent",2007,37675,161,106,494,388,56,64,-8,-1
"49340",NA,NA,"Worcester, MA","Metropolitan Statistical Area",2007,782143,1507,3398,9928,6530,-1971,2221,-4192,80
"49340",NA,25027,"Worcester County, MA","County or equivalent",2007,782143,1507,3398,9928,6530,-1971,2221,-4192,80
"49420",NA,NA,"Yakima, WA","Metropolitan Statistical Area",2007,232021,1882,2558,4304,1746,-721,842,-1563,45
"49420",NA,53077,"Yakima County, WA","County or equivalent",2007,232021,1882,2558,4304,1746,-721,842,-1563,45
"49620",NA,NA,"York-Hanover, PA","Metropolitan Statistical Area",2007,420385,6412,1859,5299,3440,4401,274,4127,152
"49620",NA,42133,"York County, PA","County or equivalent",2007,420385,6412,1859,5299,3440,4401,274,4127,152
"49660",NA,NA,"Youngstown-Warren-Boardman, OH-PA","Metropolitan Statistical Area",2007,570517,-5704,-418,6374,6792,-5323,188,-5511,37
"49660",NA,39099,"Mahoning County, OH","County or equivalent",2007,240197,-3290,-284,2714,2998,-2995,119,-3114,-11
"49660",NA,39155,"Trumbull County, OH","County or equivalent",2007,213385,-1888,44,2464,2420,-1977,42,-2019,45
"49660",NA,42085,"Mercer County, PA","County or equivalent",2007,116935,-526,-178,1196,1374,-351,27,-378,3
"49700",NA,NA,"Yuba City, CA","Metropolitan Statistical Area",2007,163302,3501,1845,3055,1210,1651,536,1115,5
"49700",NA,6101,"Sutter County, CA","County or equivalent",2007,91552,1752,931,1646,715,810,399,411,11
"49700",NA,6115,"Yuba County, CA","County or equivalent",2007,71750,1749,914,1409,495,841,137,704,-6
"49740",NA,NA,"Yuma, AZ","Metropolitan Statistical Area",2007,189610,4497,2168,3324,1156,2293,781,1512,36
"49740",NA,4027,"Yuma County, AZ","County or equivalent",2007,189610,4497,2168,3324,1156,2293,781,1512,36
" ",NA,NA,"","",2007,NA,NA,NA,NA,NA,NA,NA,NA,NA
" ",NA,NA,"Micropolitan Statistical Area","",2007,NA,NA,NA,NA,NA,NA,NA,NA,NA
" ",NA,NA,"","",2007,NA,NA,NA,NA,NA,NA,NA,NA,NA
"10020",NA,NA,"Abbeville, LA","Micropolitan Statistical Area",2007,55668,297,334,837,503,-5,41,-46,-32
"10020",NA,22113,"Vermilion Parish, LA","County or equivalent",2007,55668,297,334,837,503,-5,41,-46,-32
"10100",NA,NA,"Aberdeen, SD","Micropolitan Statistical Area",2007,39124,259,154,556,402,97,9,88,8
"10100",NA,46013,"Brown County, SD","County or equivalent",2007,35128,267,175,524,349,84,8,76,8
"10100",NA,46045,"Edmunds County, SD","County or equivalent",2007,3996,-8,-21,32,53,13,1,12,0
"10140",NA,NA,"Aberdeen, WA","Micropolitan Statistical Area",2007,71181,454,138,897,759,305,68,237,11
"10140",NA,53027,"Grays Harbor County, WA","County or equivalent",2007,71181,454,138,897,759,305,68,237,11
"10220",NA,NA,"Ada, OK","Micropolitan Statistical Area",2007,36512,750,189,559,370,543,12,531,18
"10220",NA,40123,"Pontotoc County, OK","County or equivalent",2007,36512,750,189,559,370,543,12,531,18
"10300",NA,NA,"Adrian, MI","Micropolitan Statistical Area",2007,101345,32,372,1252,880,-361,34,-395,21
"10300",NA,26091,"Lenawee County, MI","County or equivalent",2007,101345,32,372,1252,880,-361,34,-395,21
"10460",NA,NA,"Alamogordo, NM","Micropolitan Statistical Area",2007,62768,229,336,847,511,-89,232,-321,-18
"10460",NA,35035,"Otero County, NM","County or equivalent",2007,62768,229,336,847,511,-89,232,-321,-18
"10540",NA,NA,"Albany-Lebanon, OR","Micropolitan Statistical Area",2007,113053,2209,455,1550,1095,1800,77,1723,-46
"10540",NA,41043,"Linn County, OR","County or equivalent",2007,113053,2209,455,1550,1095,1800,77,1723,-46
"10620",NA,NA,"Albemarle, NC","Micropolitan Statistical Area",2007,59153,590,178,754,576,396,62,334,16
"10620",NA,37167,"Stanly County, NC","County or equivalent",2007,59153,590,178,754,576,396,62,334,16
"10660",NA,NA,"Albert Lea, MN","Micropolitan Statistical Area",2007,31162,-156,31,396,365,-186,26,-212,-1
"10660",NA,27047,"Freeborn County, MN","County or equivalent",2007,31162,-156,31,396,365,-186,26,-212,-1
"10700",NA,NA,"Albertville, AL","Micropolitan Statistical Area",2007,87427,1180,522,1497,975,646,191,455,12
"10700",NA,1095,"Marshall County, AL","County or equivalent",2007,87427,1180,522,1497,975,646,191,455,12
"10760",NA,NA,"Alexander City, AL","Micropolitan Statistical Area",2007,51590,9,-26,597,623,48,4,44,-13
"10760",NA,1037,"Coosa County, AL","County or equivalent",2007,10838,-42,-10,110,120,-30,1,-31,-2
"10760",NA,1123,"Tallapoosa County, AL","County or equivalent",2007,40752,51,-16,487,503,78,3,75,-11
"10820",NA,NA,"Alexandria, MN","Micropolitan Statistical Area",2007,36005,503,99,439,340,405,3,402,-1
"10820",NA,27041,"Douglas County, MN","County or equivalent",2007,36005,503,99,439,340,405,3,402,-1
"10860",NA,NA,"Alice, TX","Micropolitan Statistical Area",2007,41115,414,356,732,376,61,12,49,-3
"10860",NA,48249,"Jim Wells County, TX","County or equivalent",2007,41115,414,356,732,376,61,12,49,-3
"10880",NA,NA,"Allegan, MI","Micropolitan Statistical Area",2007,112600,335,680,1535,855,-367,83,-450,22
"10880",NA,26005,"Allegan County, MI","County or equivalent",2007,112600,335,680,1535,855,-367,83,-450,22
"10940",NA,NA,"Alma, MI","Micropolitan Statistical Area",2007,42288,34,75,502,427,-47,11,-58,6
"10940",NA,26057,"Gratiot County, MI","County or equivalent",2007,42288,34,75,502,427,-47,11,-58,6
"10980",NA,NA,"Alpena, MI","Micropolitan Statistical Area",2007,29702,-112,-57,282,339,-47,8,-55,-8
"10980",NA,26007,"Alpena County, MI","County or equivalent",2007,29702,-112,-57,282,339,-47,8,-55,-8
"11060",NA,NA,"Altus, OK","Micropolitan Statistical Area",2007,25686,-508,213,473,260,-711,7,-718,-10
"11060",NA,40065,"Jackson County, OK","County or equivalent",2007,25686,-508,213,473,260,-711,7,-718,-10
"11140",NA,NA,"Americus, GA","Micropolitan Statistical Area",2007,36719,216,225,602,377,1,27,-26,-10
"11140",NA,13249,"Schley County, GA","County or equivalent",2007,4106,126,45,61,16,83,2,81,-2
"11140",NA,13261,"Sumter County, GA","County or equivalent",2007,32613,90,180,541,361,-82,25,-107,-8
"11220",NA,NA,"Amsterdam, NY","Micropolitan Statistical Area",2007,48650,-147,12,619,607,-179,37,-216,20
"11220",NA,36057,"Montgomery County, NY","County or equivalent",2007,48650,-147,12,619,607,-179,37,-216,20
"11380",NA,NA,"Andrews, TX","Micropolitan Statistical Area",2007,13120,279,136,247,111,147,12,135,-4
"11380",NA,48003,"Andrews County, TX","County or equivalent",2007,13120,279,136,247,111,147,12,135,-4
"11420",NA,NA,"Angola, IN","Micropolitan Statistical Area",2007,33366,-136,129,409,280,-258,18,-276,-7
"11420",NA,18151,"Steuben County, IN","County or equivalent",2007,33366,-136,129,409,280,-258,18,-276,-7
"11580",NA,NA,"Arcadia, FL","Micropolitan Statistical Area",2007,34279,47,218,481,263,-83,299,-382,-88
"11580",NA,12027,"DeSoto County, FL","County or equivalent",2007,34279,47,218,481,263,-83,299,-382,-88
"11620",NA,NA,"Ardmore, OK","Micropolitan Statistical Area",2007,56580,466,213,878,665,252,25,227,1
"11620",NA,40019,"Carter County, OK","County or equivalent",2007,47484,438,175,749,574,262,20,242,1
"11620",NA,40085,"Love County, OK","County or equivalent",2007,9096,28,38,129,91,-10,5,-15,0
"11660",NA,NA,"Arkadelphia, AR","Micropolitan Statistical Area",2007,23796,380,102,312,210,287,24,263,-9
"11660",NA,5019,"Clark County, AR","County or equivalent",2007,23796,380,102,312,210,287,24,263,-9
"11740",NA,NA,"Ashland, OH","Micropolitan Statistical Area",2007,54843,516,178,698,520,337,10,327,1
"11740",NA,39005,"Ashland County, OH","County or equivalent",2007,54843,516,178,698,520,337,10,327,1
"11780",NA,NA,"Ashtabula, OH","Micropolitan Statistical Area",2007,101151,-320,268,1350,1082,-604,50,-654,16
"11780",NA,39007,"Ashtabula County, OH","County or equivalent",2007,101151,-320,268,1350,1082,-604,50,-654,16
"11820",NA,NA,"Astoria, OR","Micropolitan Statistical Area",2007,37305,375,106,460,354,268,47,221,1
"11820",NA,41007,"Clatsop County, OR","County or equivalent",2007,37305,375,106,460,354,268,47,221,1
"11860",NA,NA,"Atchison, KS","Micropolitan Statistical Area",2007,16529,-85,37,223,186,-122,6,-128,0
"11860",NA,20005,"Atchison County, KS","County or equivalent",2007,16529,-85,37,223,186,-122,6,-128,0
"11900",NA,NA,"Athens, OH","Micropolitan Statistical Area",2007,63200,7,120,590,470,-118,132,-250,5
"11900",NA,39009,"Athens County, OH","County or equivalent",2007,63200,7,120,590,470,-118,132,-250,5
"11940",NA,NA,"Athens, TN","Micropolitan Statistical Area",2007,52051,477,23,596,573,459,27,432,-5
"11940",NA,47107,"McMinn County, TN","County or equivalent",2007,52051,477,23,596,573,459,27,432,-5
"11980",NA,NA,"Athens, TX","Micropolitan Statistical Area",2007,78713,-99,152,1019,867,-217,74,-291,-34
"11980",NA,48213,"Henderson County, TX","County or equivalent",2007,78713,-99,152,1019,867,-217,74,-291,-34
"12140",NA,NA,"Auburn, IN","Micropolitan Statistical Area",2007,41733,266,251,586,335,11,16,-5,4
"12140",NA,18033,"DeKalb County, IN","County or equivalent",2007,41733,266,251,586,335,11,16,-5,4
"12180",NA,NA,"Auburn, NY","Micropolitan Statistical Area",2007,80024,-315,77,868,791,-409,17,-426,17
"12180",NA,36011,"Cayuga County, NY","County or equivalent",2007,80024,-315,77,868,791,-409,17,-426,17
"12300",NA,NA,"Augusta-Waterville, ME","Micropolitan Statistical Area",2007,120686,198,165,1269,1104,37,30,7,-4
"12300",NA,23011,"Kennebec County, ME","County or equivalent",2007,120686,198,165,1269,1104,37,30,7,-4
"12380",NA,NA,"Austin, MN","Micropolitan Statistical Area",2007,37952,-107,193,572,379,-296,71,-367,-4
"12380",NA,27099,"Mower County, MN","County or equivalent",2007,37952,-107,193,572,379,-296,71,-367,-4
"12460",NA,NA,"Bainbridge, GA","Micropolitan Statistical Area",2007,28532,194,138,429,291,57,37,20,-1
"12460",NA,13087,"Decatur County, GA","County or equivalent",2007,28532,194,138,429,291,57,37,20,-1
"12660",NA,NA,"Baraboo, WI","Micropolitan Statistical Area",2007,58399,555,314,857,543,227,16,211,14
"12660",NA,55111,"Sauk County, WI","County or equivalent",2007,58399,555,314,857,543,227,16,211,14
"12740",NA,NA,"Barre, VT","Micropolitan Statistical Area",2007,58852,-78,166,634,468,-259,53,-312,15
"12740",NA,50023,"Washington County, VT","County or equivalent",2007,58852,-78,166,634,468,-259,53,-312,15
"12780",NA,NA,"Bartlesville, OK","Micropolitan Statistical Area",2007,49770,871,56,619,563,795,58,737,20
"12780",NA,40147,"Washington County, OK","County or equivalent",2007,49770,871,56,619,563,795,58,737,20
"12820",NA,NA,"Bastrop, LA","Micropolitan Statistical Area",2007,28760,-465,38,402,364,-515,2,-517,12
"12820",NA,22067,"Morehouse Parish, LA","County or equivalent",2007,28760,-465,38,402,364,-515,2,-517,12
"12860",NA,NA,"Batavia, NY","Micropolitan Statistical Area",2007,58133,-241,92,644,552,-345,20,-365,12
"12860",NA,36037,"Genesee County, NY","County or equivalent",2007,58133,-241,92,644,552,-345,20,-365,12
"12900",NA,NA,"Batesville, AR","Micropolitan Statistical Area",2007,34547,154,135,495,360,11,17,-6,8
"12900",NA,5063,"Independence County, AR","County or equivalent",2007,34547,154,135,495,360,11,17,-6,8
"13060",NA,NA,"Bay City, TX","Micropolitan Statistical Area",2007,36860,-133,209,553,344,-355,121,-476,13
"13060",NA,48321,"Matagorda County, TX","County or equivalent",2007,36860,-133,209,553,344,-355,121,-476,13
"13100",NA,NA,"Beatrice, NE","Micropolitan Statistical Area",2007,23161,32,-12,268,280,48,2,46,-4
"13100",NA,31067,"Gage County, NE","County or equivalent",2007,23161,32,-12,268,280,48,2,46,-4
"13180",NA,NA,"Beaver Dam, WI","Micropolitan Statistical Area",2007,87729,-122,133,996,863,-278,26,-304,23
"13180",NA,55027,"Dodge County, WI","County or equivalent",2007,87729,-122,133,996,863,-278,26,-304,23
"13220",NA,NA,"Beckley, WV","Micropolitan Statistical Area",2007,79067,418,-40,886,926,450,28,422,8
"13220",NA,54081,"Raleigh County, WV","County or equivalent",2007,79067,418,-40,886,926,450,28,422,8
"13260",NA,NA,"Bedford, IN","Micropolitan Statistical Area",2007,45985,119,20,530,510,86,10,76,13
"13260",NA,18093,"Lawrence County, IN","County or equivalent",2007,45985,119,20,530,510,86,10,76,13
"13300",NA,NA,"Beeville, TX","Micropolitan Statistical Area",2007,32654,185,212,421,209,-31,4,-35,4
"13300",NA,48025,"Bee County, TX","County or equivalent",2007,32654,185,212,421,209,-31,4,-35,4
"13340",NA,NA,"Bellefontaine, OH","Micropolitan Statistical Area",2007,46282,213,212,650,438,15,20,-5,-14
"13340",NA,39091,"Logan County, OH","County or equivalent",2007,46282,213,212,650,438,15,20,-5,-14
"13420",NA,NA,"Bemidji, MN","Micropolitan Statistical Area",2007,43429,328,360,716,356,-12,10,-22,-20
"13420",NA,27007,"Beltrami County, MN","County or equivalent",2007,43429,328,360,716,356,-12,10,-22,-20
"13500",NA,NA,"Bennettsville, SC","Micropolitan Statistical Area",2007,28975,32,16,361,345,14,0,14,2
"13500",NA,45069,"Marlboro County, SC","County or equivalent",2007,28975,32,16,361,345,14,0,14,2
"13540",NA,NA,"Bennington, VT","Micropolitan Statistical Area",2007,36408,-109,-14,393,407,-113,22,-135,18
"13540",NA,50003,"Bennington County, VT","County or equivalent",2007,36408,-109,-14,393,407,-113,22,-135,18
"13620",NA,NA,"Berlin, NH-VT","Micropolitan Statistical Area",2007,38837,-148,-116,360,476,-44,10,-54,12
"13620",NA,33007,"Coos County, NH","County or equivalent",2007,32345,-244,-105,307,412,-154,9,-163,15
"13620",NA,50009,"Essex County, VT","County or equivalent",2007,6492,96,-11,53,64,110,1,109,-3
"13660",NA,NA,"Big Rapids, MI","Micropolitan Statistical Area",2007,41728,-383,107,448,341,-483,33,-516,-7
"13660",NA,26107,"Mecosta County, MI","County or equivalent",2007,41728,-383,107,448,341,-483,33,-516,-7
"13700",NA,NA,"Big Spring, TX","Micropolitan Statistical Area",2007,32245,334,136,473,337,206,17,189,-8
"13700",NA,48227,"Howard County, TX","County or equivalent",2007,32245,334,136,473,337,206,17,189,-8
"13860",NA,NA,"Bishop, CA","Micropolitan Statistical Area",2007,17394,-140,54,248,194,-152,23,-175,-42
"13860",NA,6027,"Inyo County, CA","County or equivalent",2007,17394,-140,54,248,194,-152,23,-175,-42
"13940",NA,NA,"Blackfoot, ID","Micropolitan Statistical Area",2007,43359,330,496,789,293,-167,56,-223,1
"13940",NA,16011,"Bingham County, ID","County or equivalent",2007,43359,330,496,789,293,-167,56,-223,1
"14100",NA,NA,"Bloomsburg-Berwick, PA","Micropolitan Statistical Area",2007,82599,163,-40,865,905,195,25,170,8
"14100",NA,42037,"Columbia County, PA","County or equivalent",2007,64818,209,-14,656,670,214,20,194,9
"14100",NA,42093,"Montour County, PA","County or equivalent",2007,17781,-46,-26,209,235,-19,5,-24,-1
"14140",NA,NA,"Bluefield, WV-VA","Micropolitan Statistical Area",2007,105013,121,-161,1205,1366,283,20,263,-1
"14140",NA,51185,"Tazewell County, VA","County or equivalent",2007,43752,-131,-105,457,562,-18,10,-28,-8
"14140",NA,54055,"Mercer County, WV","County or equivalent",2007,61261,252,-56,748,804,301,10,291,7
"14180",NA,NA,"Blytheville, AR","Micropolitan Statistical Area",2007,46647,-121,284,798,514,-397,16,-413,-8
"14180",NA,5093,"Mississippi County, AR","County or equivalent",2007,46647,-121,284,798,514,-397,16,-413,-8
"14220",NA,NA,"Bogalusa, LA","Micropolitan Statistical Area",2007,44995,967,161,712,551,783,1,782,23
"14220",NA,22117,"Washington Parish, LA","County or equivalent",2007,44995,967,161,712,551,783,1,782,23
"14300",NA,NA,"Bonham, TX","Micropolitan Statistical Area",2007,32930,116,-20,415,435,140,18,122,-4
"14300",NA,48147,"Fannin County, TX","County or equivalent",2007,32930,116,-20,415,435,140,18,122,-4
"14340",NA,NA,"Boone, IA","Micropolitan Statistical Area",2007,26355,41,21,307,286,18,5,13,2
"14340",NA,19015,"Boone County, IA","County or equivalent",2007,26355,41,21,307,286,18,5,13,2
"14380",NA,NA,"Boone, NC","Micropolitan Statistical Area",2007,44473,335,77,369,292,258,39,219,0
"14380",NA,37189,"Watauga County, NC","County or equivalent",2007,44473,335,77,369,292,258,39,219,0
"14420",NA,NA,"Borger, TX","Micropolitan Statistical Area",2007,21736,-160,52,303,251,-192,38,-230,-20
"14420",NA,48233,"Hutchinson County, TX","County or equivalent",2007,21736,-160,52,303,251,-192,38,-230,-20
"14580",NA,NA,"Bozeman, MT","Micropolitan Statistical Area",2007,87243,2873,813,1244,431,2058,65,1993,2
"14580",NA,30031,"Gallatin County, MT","County or equivalent",2007,87243,2873,813,1244,431,2058,65,1993,2
"14620",NA,NA,"Bradford, PA","Micropolitan Statistical Area",2007,43738,-270,-50,471,521,-229,4,-233,9
"14620",NA,42083,"McKean County, PA","County or equivalent",2007,43738,-270,-50,471,521,-229,4,-233,9
"14660",NA,NA,"Brainerd, MN","Micropolitan Statistical Area",2007,90147,687,355,1178,823,350,10,340,-18
"14660",NA,27021,"Cass County, MN","County or equivalent",2007,28643,-137,91,365,274,-196,0,-196,-32
"14660",NA,27035,"Crow Wing County, MN","County or equivalent",2007,61504,824,264,813,549,546,10,536,14
"14700",NA,NA,"Branson, MO","Micropolitan Statistical Area",2007,77168,1864,238,1011,773,1609,26,1583,17
"14700",NA,29209,"Stone County, MO","County or equivalent",2007,31491,341,-11,340,351,370,3,367,-18
"14700",NA,29213,"Taney County, MO","County or equivalent",2007,45677,1523,249,671,422,1239,23,1216,35
"14780",NA,NA,"Brenham, TX","Micropolitan Statistical Area",2007,31936,165,88,438,350,93,52,41,-16
"14780",NA,48477,"Washington County, TX","County or equivalent",2007,31936,165,88,438,350,93,52,41,-16
"14820",NA,NA,"Brevard, NC","Micropolitan Statistical Area",2007,29953,295,-57,296,353,333,26,307,19
"14820",NA,37175,"Transylvania County, NC","County or equivalent",2007,29953,295,-57,296,353,333,26,307,19
"14940",NA,NA,"Brigham City, UT","Micropolitan Statistical Area",2007,47793,1098,621,906,285,485,40,445,-8
"14940",NA,49003,"Box Elder County, UT","County or equivalent",2007,47793,1098,621,906,285,485,40,445,-8
"15020",NA,NA,"Brookhaven, MS","Micropolitan Statistical Area",2007,34549,308,203,565,362,120,5,115,-15
"15020",NA,28085,"Lincoln County, MS","County or equivalent",2007,34549,308,203,565,362,120,5,115,-15
"15060",NA,NA,"Brookings, OR","Micropolitan Statistical Area",2007,21751,-195,-178,133,311,-13,8,-21,-4
"15060",NA,41015,"Curry County, OR","County or equivalent",2007,21751,-195,-178,133,311,-13,8,-21,-4
"15100",NA,NA,"Brookings, SD","Micropolitan Statistical Area",2007,29329,304,171,360,189,134,30,104,-1
"15100",NA,46011,"Brookings County, SD","County or equivalent",2007,29329,304,171,360,189,134,30,104,-1
"15140",NA,NA,"Brownsville, TN","Micropolitan Statistical Area",2007,19129,-127,71,276,205,-206,16,-222,8
"15140",NA,47075,"Haywood County, TN","County or equivalent",2007,19129,-127,71,276,205,-206,16,-222,8
"15220",NA,NA,"Brownwood, TX","Micropolitan Statistical Area",2007,38261,-217,30,495,465,-258,17,-275,11
"15220",NA,48049,"Brown County, TX","County or equivalent",2007,38261,-217,30,495,465,-258,17,-275,11
"15340",NA,NA,"Bucyrus, OH","Micropolitan Statistical Area",2007,44104,-366,-9,498,507,-344,2,-346,-13
"15340",NA,39033,"Crawford County, OH","County or equivalent",2007,44104,-366,-9,498,507,-344,2,-346,-13
"15420",NA,NA,"Burley, ID","Micropolitan Statistical Area",2007,39424,208,340,719,379,-134,102,-236,2
"15420",NA,16031,"Cassia County, ID","County or equivalent",2007,20915,190,192,395,203,-1,42,-43,-1
"15420",NA,16067,"Minidoka County, ID","County or equivalent",2007,18509,18,148,324,176,-133,60,-193,3
"15460",NA,NA,"Burlington, IA-IL","Micropolitan Statistical Area",2007,48148,74,147,637,490,-68,26,-94,-5
"15460",NA,17071,"Henderson County, IL","County or equivalent",2007,7561,-54,-22,62,84,-33,1,-34,1
"15460",NA,19057,"Des Moines County, IA","County or equivalent",2007,40587,128,169,575,406,-35,25,-60,-6
"15580",NA,NA,"Butte-Silver Bow, MT","Micropolitan Statistical Area",2007,32602,-42,13,405,392,-65,6,-71,10
"15580",NA,30093,"Silver Bow County, MT","County or equivalent",2007,32602,-42,13,405,392,-65,6,-71,10
"15620",NA,NA,"Cadillac, MI","Micropolitan Statistical Area",2007,46719,49,171,608,437,-108,8,-116,-14
"15620",NA,26113,"Missaukee County, MI","County or equivalent",2007,14980,-16,34,176,142,-50,0,-50,0
"15620",NA,26165,"Wexford County, MI","County or equivalent",2007,31739,65,137,432,295,-58,8,-66,-14
"15660",NA,NA,"Calhoun, GA","Micropolitan Statistical Area",2007,51820,1077,479,899,420,596,157,439,2
"15660",NA,13129,"Gordon County, GA","County or equivalent",2007,51820,1077,479,899,420,596,157,439,2
"15700",NA,NA,"Cambridge, MD","Micropolitan Statistical Area",2007,31845,487,13,405,392,468,10,458,6
"15700",NA,24019,"Dorchester County, MD","County or equivalent",2007,31845,487,13,405,392,468,10,458,6
"15740",NA,NA,"Cambridge, OH","Micropolitan Statistical Area",2007,40375,-34,77,520,443,-100,3,-103,-11
"15740",NA,39059,"Guernsey County, OH","County or equivalent",2007,40375,-34,77,520,443,-100,3,-103,-11
"15780",NA,NA,"Camden, AR","Micropolitan Statistical Area",2007,31568,-309,22,428,406,-347,13,-360,16
"15780",NA,5013,"Calhoun County, AR","County or equivalent",2007,5522,-31,24,67,43,-55,6,-61,0
"15780",NA,5103,"Ouachita County, AR","County or equivalent",2007,26046,-278,-2,361,363,-292,7,-299,16
"15820",NA,NA,"Campbellsville, KY","Micropolitan Statistical Area",2007,23909,129,22,293,271,109,5,104,-2
"15820",NA,21217,"Taylor County, KY","County or equivalent",2007,23909,129,22,293,271,109,5,104,-2
"15860",NA,NA,"Canon City, CO","Micropolitan Statistical Area",2007,47331,168,-34,433,467,200,14,186,2
"15860",NA,8043,"Fremont County, CO","County or equivalent",2007,47331,168,-34,433,467,200,14,186,2
"15900",NA,NA,"Canton, IL","Micropolitan Statistical Area",2007,36811,-136,-87,414,501,-61,0,-61,12
"15900",NA,17057,"Fulton County, IL","County or equivalent",2007,36811,-136,-87,414,501,-61,0,-61,12
"16020",NA,NA,"Cape Girardeau-Jackson, MO-IL","Micropolitan Statistical Area",2007,93006,369,318,1211,893,76,35,41,-25
"16020",NA,17003,"Alexander County, IL","County or equivalent",2007,8250,-163,-10,108,118,-158,1,-159,5
"16020",NA,29017,"Bollinger County, MO","County or equivalent",2007,12114,2,34,150,116,-20,0,-20,-12
"16020",NA,29031,"Cape Girardeau County, MO","County or equivalent",2007,72642,530,294,953,659,254,34,220,-18
"16060",NA,NA,"Carbondale, IL","Micropolitan Statistical Area",2007,58233,-772,211,697,486,-1006,206,-1212,23
"16060",NA,17077,"Jackson County, IL","County or equivalent",2007,58233,-772,211,697,486,-1006,206,-1212,23
"16100",NA,NA,"Carlsbad-Artesia, NM","Micropolitan Statistical Area",2007,50960,322,223,737,514,122,33,89,-23
"16100",NA,35015,"Eddy County, NM","County or equivalent",2007,50960,322,223,737,514,122,33,89,-23
"16260",NA,NA,"Cedar City, UT","Micropolitan Statistical Area",2007,43453,1707,728,982,254,1002,48,954,-23
"16260",NA,49021,"Iron County, UT","County or equivalent",2007,43453,1707,728,982,254,1002,48,954,-23
"16340",NA,NA,"Cedartown, GA","Micropolitan Statistical Area",2007,41382,549,311,756,445,239,107,132,-1
"16340",NA,13233,"Polk County, GA","County or equivalent",2007,41382,549,311,756,445,239,107,132,-1
"16380",NA,NA,"Celina, OH","Micropolitan Statistical Area",2007,40799,35,182,576,394,-157,9,-166,10
"16380",NA,39107,"Mercer County, OH","County or equivalent",2007,40799,35,182,576,394,-157,9,-166,10
"16420",NA,NA,"Central City, KY","Micropolitan Statistical Area",2007,31313,-27,5,388,383,-36,0,-36,4
"16420",NA,21177,"Muhlenberg County, KY","County or equivalent",2007,31313,-27,5,388,383,-36,0,-36,4
"16460",NA,NA,"Centralia, IL","Micropolitan Statistical Area",2007,39589,-158,46,516,470,-215,-1,-214,11
"16460",NA,17121,"Marion County, IL","County or equivalent",2007,39589,-158,46,516,470,-215,-1,-214,11
"16500",NA,NA,"Centralia, WA","Micropolitan Statistical Area",2007,73513,851,186,950,764,671,88,583,-6
"16500",NA,53041,"Lewis County, WA","County or equivalent",2007,73513,851,186,950,764,671,88,583,-6
"16540",NA,NA,"Chambersburg, PA","Micropolitan Statistical Area",2007,141643,1960,529,1888,1359,1428,102,1326,3
"16540",NA,42055,"Franklin County, PA","County or equivalent",2007,141643,1960,529,1888,1359,1428,102,1326,3
"16660",NA,NA,"Charleston-Mattoon, IL","Micropolitan Statistical Area",2007,63110,-96,107,712,605,-200,27,-227,-3
"16660",NA,17029,"Coles County, IL","County or equivalent",2007,52283,-38,106,586,480,-141,25,-166,-3
"16660",NA,17035,"Cumberland County, IL","County or equivalent",2007,10827,-58,1,126,125,-59,2,-61,0
"16900",NA,NA,"Chester, SC","Micropolitan Statistical Area",2007,32574,-68,102,468,366,-164,9,-173,-6
"16900",NA,45023,"Chester County, SC","County or equivalent",2007,32574,-68,102,468,366,-164,9,-173,-6
"17060",NA,NA,"Chillicothe, OH","Micropolitan Statistical Area",2007,75799,559,199,929,730,350,18,332,10
"17060",NA,39141,"Ross County, OH","County or equivalent",2007,75799,559,199,929,730,350,18,332,10
"17180",NA,NA,"City of The Dalles, OR","Micropolitan Statistical Area",2007,23705,153,5,293,288,148,25,123,0
"17180",NA,41065,"Wasco County, OR","County or equivalent",2007,23705,153,5,293,288,148,25,123,0
"17200",NA,NA,"Claremont, NH","Micropolitan Statistical Area",2007,42576,54,91,489,398,-8,15,-23,-29
"17200",NA,33019,"Sullivan County, NH","County or equivalent",2007,42576,54,91,489,398,-8,15,-23,-29
"17220",NA,NA,"Clarksburg, WV","Micropolitan Statistical Area",2007,91597,-44,8,1075,1067,-58,23,-81,6
"17220",NA,54017,"Doddridge County, WV","County or equivalent",2007,7244,26,-13,59,72,40,0,40,-1
"17220",NA,54033,"Harrison County, WV","County or equivalent",2007,68254,-70,29,854,825,-109,22,-131,10
"17220",NA,54091,"Taylor County, WV","County or equivalent",2007,16099,0,-8,162,170,11,1,10,-3
"17260",NA,NA,"Clarksdale, MS","Micropolitan Statistical Area",2007,27642,-329,207,527,320,-546,8,-554,10
"17260",NA,28027,"Coahoma County, MS","County or equivalent",2007,27642,-329,207,527,320,-546,8,-554,10
"17340",NA,NA,"Clearlake, CA","Micropolitan Statistical Area",2007,64498,-164,5,751,746,-152,80,-232,-17
"17340",NA,6033,"Lake County, CA","County or equivalent",2007,64498,-164,5,751,746,-152,80,-232,-17
"17380",NA,NA,"Cleveland, MS","Micropolitan Statistical Area",2007,37493,-166,207,664,457,-369,5,-374,-4
"17380",NA,28011,"Bolivar County, MS","County or equivalent",2007,37493,-166,207,664,457,-369,5,-374,-4
"17500",NA,NA,"Clewiston, FL","Micropolitan Statistical Area",2007,39246,268,478,746,268,-222,308,-530,12
"17500",NA,12051,"Hendry County, FL","County or equivalent",2007,39246,268,478,746,268,-222,308,-530,12
"17540",NA,NA,"Clinton, IA","Micropolitan Statistical Area",2007,49056,-127,154,654,500,-288,28,-316,7
"17540",NA,19045,"Clinton County, IA","County or equivalent",2007,49056,-127,154,654,500,-288,28,-316,7
"17580",NA,NA,"Clovis, NM","Micropolitan Statistical Area",2007,45007,-531,537,904,367,-1100,30,-1130,32
"17580",NA,35009,"Curry County, NM","County or equivalent",2007,45007,-531,537,904,367,-1100,30,-1130,32
"17700",NA,NA,"Coffeyville, KS","Micropolitan Statistical Area",2007,34460,146,66,512,446,71,16,55,9
"17700",NA,20125,"Montgomery County, KS","County or equivalent",2007,34460,146,66,512,446,71,16,55,9
"17740",NA,NA,"Coldwater, MI","Micropolitan Statistical Area",2007,46167,-50,239,658,419,-261,55,-316,-28
"17740",NA,26023,"Branch County, MI","County or equivalent",2007,46167,-50,239,658,419,-261,55,-316,-28
"17940",NA,NA,"Columbia, TN","Micropolitan Statistical Area",2007,79793,2414,390,1138,748,2040,84,1956,-16
"17940",NA,47119,"Maury County, TN","County or equivalent",2007,79793,2414,390,1138,748,2040,84,1956,-16
"18060",NA,NA,"Columbus, MS","Micropolitan Statistical Area",2007,59466,-46,398,925,527,-459,3,-462,15
"18060",NA,28087,"Lowndes County, MS","County or equivalent",2007,59466,-46,398,925,527,-459,3,-462,15
"18100",NA,NA,"Columbus, NE","Micropolitan Statistical Area",2007,31800,444,228,484,256,278,47,231,-62
"18100",NA,31141,"Platte County, NE","County or equivalent",2007,31800,444,228,484,256,278,47,231,-62
"18180",NA,NA,"Concord, NH","Micropolitan Statistical Area",2007,148073,532,394,1594,1200,134,122,12,4
"18180",NA,33013,"Merrimack County, NH","County or equivalent",2007,148073,532,394,1594,1200,134,122,12,4
"18220",NA,NA,"Connersville, IN","Micropolitan Statistical Area",2007,24250,-113,16,312,296,-136,2,-138,7
"18220",NA,18041,"Fayette County, IN","County or equivalent",2007,24250,-113,16,312,296,-136,2,-138,7
"18260",NA,NA,"Cookeville, TN","Micropolitan Statistical Area",2007,101501,1331,240,1331,1091,1132,119,1013,-41
"18260",NA,47087,"Jackson County, TN","County or equivalent",2007,10789,-29,-41,107,148,21,4,17,-9
"18260",NA,47133,"Overton County, TN","County or equivalent",2007,20954,233,-2,260,262,225,-1,226,10
"18260",NA,47141,"Putnam County, TN","County or equivalent",2007,69758,1127,283,964,681,886,116,770,-42
"18300",NA,NA,"Coos Bay, OR","Micropolitan Statistical Area",2007,63447,-228,-125,662,787,-129,30,-159,26
"18300",NA,41011,"Coos County, OR","County or equivalent",2007,63447,-228,-125,662,787,-129,30,-159,26
"18340",NA,NA,"Corbin, KY","Micropolitan Statistical Area",2007,38324,378,48,497,449,360,6,354,-30
"18340",NA,21235,"Whitley County, KY","County or equivalent",2007,38324,378,48,497,449,360,6,354,-30
"18380",NA,NA,"Cordele, GA","Micropolitan Statistical Area",2007,22127,250,138,365,227,109,27,82,3
"18380",NA,13081,"Crisp County, GA","County or equivalent",2007,22127,250,138,365,227,109,27,82,3
"18420",NA,NA,"Corinth, MS","Micropolitan Statistical Area",2007,35576,243,118,518,400,117,11,106,8
"18420",NA,28003,"Alcorn County, MS","County or equivalent",2007,35576,243,118,518,400,117,11,106,8
"18460",NA,NA,"Cornelia, GA","Micropolitan Statistical Area",2007,42129,1333,281,648,367,1051,102,949,1
"18460",NA,13137,"Habersham County, GA","County or equivalent",2007,42129,1333,281,648,367,1051,102,949,1
"18500",NA,NA,"Corning, NY","Micropolitan Statistical Area",2007,96620,-224,137,1126,989,-370,34,-404,9
"18500",NA,36101,"Steuben County, NY","County or equivalent",2007,96620,-224,137,1126,989,-370,34,-404,9
"18620",NA,NA,"Corsicana, TX","Micropolitan Statistical Area",2007,49059,145,252,752,500,-95,185,-280,-12
"18620",NA,48349,"Navarro County, TX","County or equivalent",2007,49059,145,252,752,500,-95,185,-280,-12
"18660",NA,NA,"Cortland, NY","Micropolitan Statistical Area",2007,48415,41,106,527,421,-60,25,-85,-5
"18660",NA,36023,"Cortland County, NY","County or equivalent",2007,48415,41,106,527,421,-60,25,-85,-5
"18740",NA,NA,"Coshocton, OH","Micropolitan Statistical Area",2007,36257,-238,85,460,375,-321,21,-342,-2
"18740",NA,39031,"Coshocton County, OH","County or equivalent",2007,36257,-238,85,460,375,-321,21,-342,-2
"18820",NA,NA,"Crawfordsville, IN","Micropolitan Statistical Area",2007,37751,126,77,457,380,48,37,11,1
"18820",NA,18107,"Montgomery County, IN","County or equivalent",2007,37751,126,77,457,380,48,37,11,1
"18860",NA,NA,"Crescent City, CA","Micropolitan Statistical Area",2007,28933,356,81,353,272,286,46,240,-11
"18860",NA,6015,"Del Norte County, CA","County or equivalent",2007,28933,356,81,353,272,286,46,240,-11
"18900",NA,NA,"Crossville, TN","Micropolitan Statistical Area",2007,52932,948,-99,541,640,1002,7,995,45
"18900",NA,47035,"Cumberland County, TN","County or equivalent",2007,52932,948,-99,541,640,1002,7,995,45
"18940",NA,NA,"Crowley, LA","Micropolitan Statistical Area",2007,59803,155,285,946,661,-132,5,-137,2
"18940",NA,22001,"Acadia Parish, LA","County or equivalent",2007,59803,155,285,946,661,-132,5,-137,2
"18980",NA,NA,"Cullman, AL","Micropolitan Statistical Area",2007,80407,710,64,1001,937,633,65,568,13
"18980",NA,1043,"Cullman County, AL","County or equivalent",2007,80407,710,64,1001,937,633,65,568,13
"19020",NA,NA,"Culpeper, VA","Micropolitan Statistical Area",2007,45594,1497,348,696,348,1159,51,1108,-10
"19020",NA,51047,"Culpeper County, VA","County or equivalent",2007,45594,1497,348,696,348,1159,51,1108,-10
"19220",NA,NA,"Danville, KY","Micropolitan Statistical Area",2007,53868,370,134,672,538,246,40,206,-10
"19220",NA,21021,"Boyle County, KY","County or equivalent",2007,28661,232,52,333,281,195,31,164,-15
"19220",NA,21137,"Lincoln County, KY","County or equivalent",2007,25207,138,82,339,257,51,9,42,5
"19300",NA,NA,"Daphne-Fairhope-Foley, AL","Micropolitan Statistical Area",2007,171748,3594,546,2199,1653,3049,117,2932,-1
"19300",NA,1003,"Baldwin County, AL","County or equivalent",2007,171748,3594,546,2199,1653,3049,117,2932,-1
"19540",NA,NA,"Decatur, IN","Micropolitan Statistical Area",2007,33762,30,367,643,276,-330,9,-339,-7
"19540",NA,18001,"Adams County, IN","County or equivalent",2007,33762,30,367,643,276,-330,9,-339,-7
"19580",NA,NA,"Defiance, OH","Micropolitan Statistical Area",2007,38613,-104,174,529,355,-293,12,-305,15
"19580",NA,39039,"Defiance County, OH","County or equivalent",2007,38613,-104,174,529,355,-293,12,-305,15
"19620",NA,NA,"Del Rio, TX","Micropolitan Statistical Area",2007,47737,527,626,955,329,-112,148,-260,13
"19620",NA,48465,"Val Verde County, TX","County or equivalent",2007,47737,527,626,955,329,-112,148,-260,13
"19700",NA,NA,"Deming, NM","Micropolitan Statistical Area",2007,26805,378,148,435,287,241,120,121,-11
"19700",NA,35029,"Luna County, NM","County or equivalent",2007,26805,378,148,435,287,241,120,121,-11
"19760",NA,NA,"De Ridder, LA","Micropolitan Statistical Area",2007,34773,90,185,508,323,-69,2,-71,-26
"19760",NA,22011,"Beauregard Parish, LA","County or equivalent",2007,34773,90,185,508,323,-69,2,-71,-26
"19860",NA,NA,"Dickinson, ND","Micropolitan Statistical Area",2007,23224,341,96,296,200,242,10,232,3
"19860",NA,38007,"Billings County, ND","County or equivalent",2007,796,23,9,10,1,15,1,14,-1
"19860",NA,38089,"Stark County, ND","County or equivalent",2007,22428,318,87,286,199,227,9,218,4
"19900",NA,NA,"Dillon, SC","Micropolitan Statistical Area",2007,30668,-14,126,483,357,-140,11,-151,0
"19900",NA,45033,"Dillon County, SC","County or equivalent",2007,30668,-14,126,483,357,-140,11,-151,0
"19940",NA,NA,"Dixon, IL","Micropolitan Statistical Area",2007,35089,165,57,418,361,106,11,95,2
"19940",NA,17103,"Lee County, IL","County or equivalent",2007,35089,165,57,418,361,106,11,95,2
"19980",NA,NA,"Dodge City, KS","Micropolitan Statistical Area",2007,33077,326,451,659,208,-132,323,-455,7
"19980",NA,20057,"Ford County, KS","County or equivalent",2007,33077,326,451,659,208,-132,323,-455,7
"20060",NA,NA,"Douglas, GA","Micropolitan Statistical Area",2007,48318,530,451,844,393,91,141,-50,-12
"20060",NA,13003,"Atkinson County, GA","County or equivalent",2007,8156,134,123,169,46,22,36,-14,-11
"20060",NA,13069,"Coffee County, GA","County or equivalent",2007,40162,396,328,675,347,69,105,-36,-1
"20140",NA,NA,"Dublin, GA","Micropolitan Statistical Area",2007,56885,826,245,840,595,604,24,580,-23
"20140",NA,13167,"Johnson County, GA","County or equivalent",2007,9515,507,25,120,95,479,1,478,3
"20140",NA,13175,"Laurens County, GA","County or equivalent",2007,47370,319,220,720,500,125,23,102,-26
"20180",NA,NA,"DuBois, PA","Micropolitan Statistical Area",2007,83005,269,-169,790,959,406,7,399,32
"20180",NA,42033,"Clearfield County, PA","County or equivalent",2007,83005,269,-169,790,959,406,7,399,32
"20300",NA,NA,"Dumas, TX","Micropolitan Statistical Area",2007,19910,-65,288,428,140,-355,108,-463,2
"20300",NA,48341,"Moore County, TX","County or equivalent",2007,19910,-65,288,428,140,-355,108,-463,2
"20340",NA,NA,"Duncan, OK","Micropolitan Statistical Area",2007,43255,491,47,581,534,430,1,429,14
"20340",NA,40137,"Stephens County, OK","County or equivalent",2007,43255,491,47,581,534,430,1,429,14
"20380",NA,NA,"Dunn, NC","Micropolitan Statistical Area",2007,108542,3241,852,1627,775,2361,159,2202,28
"20380",NA,37085,"Harnett County, NC","County or equivalent",2007,108542,3241,852,1627,775,2361,159,2202,28
"20420",NA,NA,"Durango, CO","Micropolitan Statistical Area",2007,49520,739,323,594,271,427,28,399,-11
"20420",NA,8067,"La Plata County, CO","County or equivalent",2007,49520,739,323,594,271,427,28,399,-11
"20460",NA,NA,"Durant, OK","Micropolitan Statistical Area",2007,39298,518,120,568,448,385,37,348,13
"20460",NA,40013,"Bryan County, OK","County or equivalent",2007,39298,518,120,568,448,385,37,348,13
"20540",NA,NA,"Dyersburg, TN","Micropolitan Statistical Area",2007,37642,11,117,515,398,-109,23,-132,3
"20540",NA,47045,"Dyer County, TN","County or equivalent",2007,37642,11,117,515,398,-109,23,-132,3
"20580",NA,NA,"Eagle Pass, TX","Micropolitan Statistical Area",2007,51342,479,764,1056,292,-299,228,-527,14
"20580",NA,48323,"Maverick County, TX","County or equivalent",2007,51342,479,764,1056,292,-299,228,-527,14
"20620",NA,NA,"East Liverpool-Salem, OH","Micropolitan Statistical Area",2007,108587,-604,21,1229,1208,-660,13,-673,35
"20620",NA,39029,"Columbiana County, OH","County or equivalent",2007,108587,-604,21,1229,1208,-660,13,-673,35
"20660",NA,NA,"Easton, MD","Micropolitan Statistical Area",2007,36132,97,-72,373,445,182,29,153,-13
"20660",NA,24041,"Talbot County, MD","County or equivalent",2007,36132,97,-72,373,445,182,29,153,-13
"20700",NA,NA,"East Stroudsburg, PA","Micropolitan Statistical Area",2007,164467,1751,433,1639,1206,1344,106,1238,-26
"20700",NA,42089,"Monroe County, PA","County or equivalent",2007,164467,1751,433,1639,1206,1344,106,1238,-26
"20780",NA,NA,"Edwards, CO","Micropolitan Statistical Area",2007,58732,1698,905,1005,100,832,526,306,-39
"20780",NA,8037,"Eagle County, CO","County or equivalent",2007,50891,1491,817,882,65,706,451,255,-32
"20780",NA,8065,"Lake County, CO","County or equivalent",2007,7841,207,88,123,35,126,75,51,-7
"20820",NA,NA,"Effingham, IL","Micropolitan Statistical Area",2007,34174,-105,122,466,344,-233,12,-245,6
"20820",NA,17049,"Effingham County, IL","County or equivalent",2007,34174,-105,122,466,344,-233,12,-245,6
"20900",NA,NA,"El Campo, TX","Micropolitan Statistical Area",2007,40731,-150,301,681,380,-447,96,-543,-4
"20900",NA,48481,"Wharton County, TX","County or equivalent",2007,40731,-150,301,681,380,-447,96,-543,-4
"20980",NA,NA,"El Dorado, AR","Micropolitan Statistical Area",2007,43165,-337,64,635,571,-422,26,-448,21
"20980",NA,5139,"Union County, AR","County or equivalent",2007,43165,-337,64,635,571,-422,26,-448,21
"21020",NA,NA,"Elizabeth City, NC","Micropolitan Statistical Area",2007,62633,1868,300,854,554,1555,13,1542,13
"21020",NA,37029,"Camden County, NC","County or equivalent",2007,9461,273,45,115,70,223,-2,225,5
"21020",NA,37139,"Pasquotank County, NC","County or equivalent",2007,40680,1209,244,603,359,960,16,944,5
"21020",NA,37143,"Perquimans County, NC","County or equivalent",2007,12492,386,11,136,125,372,-1,373,3
"21120",NA,NA,"Elk City, OK","Micropolitan Statistical Area",2007,20793,1482,115,373,258,1344,7,1337,23
"21120",NA,40009,"Beckham County, OK","County or equivalent",2007,20793,1482,115,373,258,1344,7,1337,23
"21220",NA,NA,"Elko, NV","Micropolitan Statistical Area",2007,48410,1306,491,767,276,818,117,701,-3
"21220",NA,32007,"Elko County, NV","County or equivalent",2007,46847,1208,470,741,271,741,112,629,-3
"21220",NA,32011,"Eureka County, NV","County or equivalent",2007,1563,98,21,26,5,77,5,72,0
"21260",NA,NA,"Ellensburg, WA","Micropolitan Statistical Area",2007,38163,319,138,398,260,178,49,129,3
"21260",NA,53037,"Kittitas County, WA","County or equivalent",2007,38163,319,138,398,260,178,49,129,3
"21380",NA,NA,"Emporia, KS","Micropolitan Statistical Area",2007,38696,116,240,563,323,-100,144,-244,-24
"21380",NA,20017,"Chase County, KS","County or equivalent",2007,2850,-115,-4,27,31,-106,1,-107,-5
"21380",NA,20111,"Lyon County, KS","County or equivalent",2007,35846,231,244,536,292,6,143,-137,-19
"21420",NA,NA,"Enid, OK","Micropolitan Statistical Area",2007,57504,305,339,1002,663,-26,19,-45,-8
"21420",NA,40047,"Garfield County, OK","County or equivalent",2007,57504,305,339,1002,663,-26,19,-45,-8
"21460",NA,NA,"Enterprise-Ozark, AL","Micropolitan Statistical Area",2007,94899,1318,472,1372,900,846,15,831,0
"21460",NA,1031,"Coffee County, AL","County or equivalent",2007,46753,1165,162,636,474,988,24,964,15
"21460",NA,1045,"Dale County, AL","County or equivalent",2007,48146,153,310,736,426,-142,-9,-133,-15
"21540",NA,NA,"Escanaba, MI","Micropolitan Statistical Area",2007,37319,-375,54,411,357,-426,6,-432,-3
"21540",NA,26041,"Delta County, MI","County or equivalent",2007,37319,-375,54,411,357,-426,6,-432,-3
"21580",NA,NA,"Espanola, NM","Micropolitan Statistical Area",2007,40707,55,388,739,351,-348,56,-404,15
"21580",NA,35039,"Rio Arriba County, NM","County or equivalent",2007,40707,55,388,739,351,-348,56,-404,15
"21640",NA,NA,"Eufaula, AL-GA","Micropolitan Statistical Area",2007,32113,54,117,434,317,-239,31,-270,176
"21640",NA,1005,"Barbour County, AL","County or equivalent",2007,29460,40,97,396,299,-236,30,-266,179
"21640",NA,13239,"Quitman County, GA","County or equivalent",2007,2653,14,20,38,18,-3,1,-4,-3
"21700",NA,NA,"Eureka-Arcata-Fortuna, CA","Micropolitan Statistical Area",2007,128614,-463,442,1654,1212,-937,98,-1035,32
"21700",NA,6023,"Humboldt County, CA","County or equivalent",2007,128614,-463,442,1654,1212,-937,98,-1035,32
"21740",NA,NA,"Evanston, WY","Micropolitan Statistical Area",2007,20155,467,208,340,132,265,9,256,-6
"21740",NA,56041,"Uinta County, WY","County or equivalent",2007,20155,467,208,340,132,265,9,256,-6
"21860",NA,NA,"Fairmont, MN","Micropolitan Statistical Area",2007,20442,-55,-20,233,253,-37,4,-41,2
"21860",NA,27091,"Martin County, MN","County or equivalent",2007,20442,-55,-20,233,253,-37,4,-41,2
"21900",NA,NA,"Fairmont, WV","Micropolitan Statistical Area",2007,56653,229,-36,629,665,249,9,240,16
"21900",NA,54049,"Marion County, WV","County or equivalent",2007,56653,229,-36,629,665,249,9,240,16
"21980",NA,NA,"Fallon, NV","Micropolitan Statistical Area",2007,24784,166,113,363,250,73,12,61,-20
"21980",NA,32001,"Churchill County, NV","County or equivalent",2007,24784,166,113,363,250,73,12,61,-20
"22060",NA,NA,"Faribault-Northfield, MN","Micropolitan Statistical Area",2007,61753,450,400,850,450,46,114,-68,4
"22060",NA,27131,"Rice County, MN","County or equivalent",2007,61753,450,400,850,450,46,114,-68,4
"22100",NA,NA,"Farmington, MO","Micropolitan Statistical Area",2007,62762,686,218,867,649,461,13,448,7
"22100",NA,29187,"St. Francois County, MO","County or equivalent",2007,62762,686,218,867,649,461,13,448,7
"22260",NA,NA,"Fergus Falls, MN","Micropolitan Statistical Area",2007,56869,-254,9,627,618,-284,39,-323,21
"22260",NA,27111,"Otter Tail County, MN","County or equivalent",2007,56869,-254,9,627,618,-284,39,-323,21
"22280",NA,NA,"Fernley, NV","Micropolitan Statistical Area",2007,52363,2079,296,748,452,1794,40,1754,-11
"22280",NA,32019,"Lyon County, NV","County or equivalent",2007,52363,2079,296,748,452,1794,40,1754,-11
"22300",NA,NA,"Findlay, OH","Micropolitan Statistical Area",2007,74265,548,346,983,637,195,65,130,7
"22300",NA,39063,"Hancock County, OH","County or equivalent",2007,74265,548,346,983,637,195,65,130,7
"22340",NA,NA,"Fitzgerald, GA","Micropolitan Statistical Area",2007,27563,-108,157,454,297,-269,40,-309,4
"22340",NA,13017,"Ben Hill County, GA","County or equivalent",2007,17659,198,140,338,198,65,24,41,-7
"22340",NA,13155,"Irwin County, GA","County or equivalent",2007,9904,-306,17,116,99,-334,16,-350,11
"22580",NA,NA,"Forest City, NC","Micropolitan Statistical Area",2007,62928,19,16,813,797,0,20,-20,3
"22580",NA,37161,"Rutherford County, NC","County or equivalent",2007,62928,19,16,813,797,0,20,-20,3
"22620",NA,NA,"Forrest City, AR","Micropolitan Statistical Area",2007,26877,-258,89,398,309,-349,0,-349,2
"22620",NA,5123,"St. Francis County, AR","County or equivalent",2007,26877,-258,89,398,309,-349,0,-349,2
"22700",NA,NA,"Fort Dodge, IA","Micropolitan Statistical Area",2007,38606,-29,65,509,444,-105,21,-126,11
"22700",NA,19187,"Webster County, IA","County or equivalent",2007,38606,-29,65,509,444,-105,21,-126,11
"22780",NA,NA,"Fort Leonard Wood, MO","Micropolitan Statistical Area",2007,44300,558,472,741,269,97,-120,217,-11
"22780",NA,29169,"Pulaski County, MO","County or equivalent",2007,44300,558,472,741,269,97,-120,217,-11
"22800",NA,NA,"Fort Madison-Keokuk, IA-MO","Micropolitan Statistical Area",2007,42918,-143,48,537,489,-197,14,-211,6
"22800",NA,19111,"Lee County, IA","County or equivalent",2007,35706,-171,20,445,425,-195,14,-209,4
"22800",NA,29045,"Clark County, MO","County or equivalent",2007,7212,28,28,92,64,-2,0,-2,2
"22820",NA,NA,"Fort Morgan, CO","Micropolitan Statistical Area",2007,27757,-21,180,411,231,-207,139,-346,6
"22820",NA,8087,"Morgan County, CO","County or equivalent",2007,27757,-21,180,411,231,-207,139,-346,6
"22840",NA,NA,"Fort Payne, AL","Micropolitan Statistical Area",2007,67824,713,297,982,685,401,132,269,15
"22840",NA,1049,"DeKalb County, AL","County or equivalent",2007,67824,713,297,982,685,401,132,269,15
"22860",NA,NA,"Fort Polk South, LA","Micropolitan Statistical Area",2007,47527,-926,598,917,319,-1561,-61,-1500,37
"22860",NA,22115,"Vernon Parish, LA","County or equivalent",2007,47527,-926,598,917,319,-1561,-61,-1500,37
"22980",NA,NA,"Fort Valley, GA","Micropolitan Statistical Area",2007,26188,1084,200,437,237,871,49,822,13
"22980",NA,13225,"Peach County, GA","County or equivalent",2007,26188,1084,200,437,237,871,49,822,13
"23140",NA,NA,"Frankfort, IN","Micropolitan Statistical Area",2007,33762,-58,154,506,352,-227,129,-356,15
"23140",NA,18023,"Clinton County, IN","County or equivalent",2007,33762,-58,154,506,352,-227,129,-356,15
"23180",NA,NA,"Frankfort, KY","Micropolitan Statistical Area",2007,69659,532,264,880,616,257,50,207,11
"23180",NA,21005,"Anderson County, KY","County or equivalent",2007,21241,499,92,262,170,397,4,393,10
"23180",NA,21073,"Franklin County, KY","County or equivalent",2007,48418,33,172,618,446,-140,46,-186,1
"23240",NA,NA,"Fredericksburg, TX","Micropolitan Statistical Area",2007,23381,237,-23,258,281,243,28,215,17
"23240",NA,48171,"Gillespie County, TX","County or equivalent",2007,23381,237,-23,258,281,243,28,215,17
"23300",NA,NA,"Freeport, IL","Micropolitan Statistical Area",2007,46581,-345,98,602,504,-442,49,-491,-1
"23300",NA,17177,"Stephenson County, IL","County or equivalent",2007,46581,-345,98,602,504,-442,49,-491,-1
"23340",NA,NA,"Fremont, NE","Micropolitan Statistical Area",2007,35911,55,97,507,410,-37,23,-60,-5
"23340",NA,31053,"Dodge County, NE","County or equivalent",2007,35911,55,97,507,410,-37,23,-60,-5
"23380",NA,NA,"Fremont, OH","Micropolitan Statistical Area",2007,60927,-183,194,813,619,-390,10,-400,13
"23380",NA,39143,"Sandusky County, OH","County or equivalent",2007,60927,-183,194,813,619,-390,10,-400,13
"23500",NA,NA,"Gaffney, SC","Micropolitan Statistical Area",2007,53933,181,130,684,554,55,25,30,-4
"23500",NA,45021,"Cherokee County, SC","County or equivalent",2007,53933,181,130,684,554,55,25,30,-4
"23620",NA,NA,"Gainesville, TX","Micropolitan Statistical Area",2007,38359,61,210,590,380,-150,96,-246,1
"23620",NA,48097,"Cooke County, TX","County or equivalent",2007,38359,61,210,590,380,-150,96,-246,1
"23660",NA,NA,"Galesburg, IL","Micropolitan Statistical Area",2007,69648,-308,-102,799,901,-220,14,-234,14
"23660",NA,17095,"Knox County, IL","County or equivalent",2007,51973,-326,-90,584,674,-257,10,-267,21
"23660",NA,17187,"Warren County, IL","County or equivalent",2007,17675,18,-12,215,227,37,4,33,-7
"23700",NA,NA,"Gallup, NM","Micropolitan Statistical Area",2007,69979,-478,902,1375,473,-1421,35,-1456,41
"23700",NA,35031,"McKinley County, NM","County or equivalent",2007,69979,-478,902,1375,473,-1421,35,-1456,41
"23780",NA,NA,"Garden City, KS","Micropolitan Statistical Area",2007,40782,106,578,761,183,-824,312,-1136,352
"23780",NA,20055,"Finney County, KS","County or equivalent",2007,40782,106,578,761,183,-824,312,-1136,352
"23820",NA,NA,"Gardnerville Ranchos, NV","Micropolitan Statistical Area",2007,45305,-174,52,415,363,-164,33,-197,-62
"23820",NA,32005,"Douglas County, NV","County or equivalent",2007,45305,-174,52,415,363,-164,33,-197,-62
"23860",NA,NA,"Georgetown, SC","Micropolitan Statistical Area",2007,60388,476,126,741,615,397,43,354,-47
"23860",NA,45043,"Georgetown County, SC","County or equivalent",2007,60388,476,126,741,615,397,43,354,-47
"23900",NA,NA,"Gettysburg, PA","Micropolitan Statistical Area",2007,100519,661,196,1133,937,474,101,373,-9
"23900",NA,42001,"Adams County, PA","County or equivalent",2007,100519,661,196,1133,937,474,101,373,-9
"23940",NA,NA,"Gillette, WY","Micropolitan Statistical Area",2007,40433,1977,513,705,192,1441,13,1428,23
"23940",NA,56005,"Campbell County, WY","County or equivalent",2007,40433,1977,513,705,192,1441,13,1428,23
"23980",NA,NA,"Glasgow, KY","Micropolitan Statistical Area",2007,51328,676,102,670,568,598,19,579,-24
"23980",NA,21009,"Barren County, KY","County or equivalent",2007,41090,564,100,546,446,484,18,466,-20
"23980",NA,21169,"Metcalfe County, KY","County or equivalent",2007,10238,112,2,124,122,114,1,113,-4
"24100",NA,NA,"Gloversville, NY","Micropolitan Statistical Area",2007,54959,74,16,586,570,53,24,29,5
"24100",NA,36035,"Fulton County, NY","County or equivalent",2007,54959,74,16,586,570,53,24,29,5
"24180",NA,NA,"Granbury, TX","Micropolitan Statistical Area",2007,56777,1154,54,667,613,1075,48,1027,25
"24180",NA,48221,"Hood County, TX","County or equivalent",2007,49039,1024,22,565,543,970,42,928,32
"24180",NA,48425,"Somervell County, TX","County or equivalent",2007,7738,130,32,102,70,105,6,99,-7
"24260",NA,NA,"Grand Island, NE","Micropolitan Statistical Area",2007,69634,515,463,1125,662,64,192,-128,-12
"24260",NA,31079,"Hall County, NE","County or equivalent",2007,55394,549,449,970,521,107,189,-82,-7
"24260",NA,31093,"Howard County, NE","County or equivalent",2007,6575,57,19,76,57,45,1,44,-7
"24260",NA,31121,"Merrick County, NE","County or equivalent",2007,7665,-91,-5,79,84,-88,2,-90,2
"24380",NA,NA,"Grants, NM","Micropolitan Statistical Area",2007,27230,254,276,458,182,-13,9,-22,-9
"24380",NA,35006,"Cibola County, NM","County or equivalent",2007,27230,254,276,458,182,-13,9,-22,-9
"24420",NA,NA,"Grants Pass, OR","Micropolitan Statistical Area",2007,80928,215,-154,900,1054,377,17,360,-8
"24420",NA,41033,"Josephine County, OR","County or equivalent",2007,80928,215,-154,900,1054,377,17,360,-8
"24460",NA,NA,"Great Bend, KS","Micropolitan Statistical Area",2007,27765,-4,100,403,303,-115,56,-171,11
"24460",NA,20009,"Barton County, KS","County or equivalent",2007,27765,-4,100,403,303,-115,56,-171,11
"24620",NA,NA,"Greeneville, TN","Micropolitan Statistical Area",2007,65846,483,-77,721,798,535,38,497,25
"24620",NA,47059,"Greene County, TN","County or equivalent",2007,65846,483,-77,721,798,535,38,497,25
"24700",NA,NA,"Greensburg, IN","Micropolitan Statistical Area",2007,24937,-30,135,370,235,-146,29,-175,-19
"24700",NA,18031,"Decatur County, IN","County or equivalent",2007,24937,-30,135,370,235,-146,29,-175,-19
"24740",NA,NA,"Greenville, MS","Micropolitan Statistical Area",2007,55639,-830,442,1014,572,-1305,18,-1323,33
"24740",NA,28151,"Washington County, MS","County or equivalent",2007,55639,-830,442,1014,572,-1305,18,-1323,33
"24820",NA,NA,"Greenville, OH","Micropolitan Statistical Area",2007,52176,-125,101,679,578,-239,2,-241,13
"24820",NA,39037,"Darke County, OH","County or equivalent",2007,52176,-125,101,679,578,-239,2,-241,13
"24900",NA,NA,"Greenwood, MS","Micropolitan Statistical Area",2007,45476,95,330,764,434,-234,15,-249,-1
"24900",NA,28015,"Carroll County, MS","County or equivalent",2007,10303,112,61,139,78,59,4,55,-8
"24900",NA,28083,"Leflore County, MS","County or equivalent",2007,35173,-17,269,625,356,-293,11,-304,7
"24940",NA,NA,"Greenwood, SC","Micropolitan Statistical Area",2007,68173,292,224,947,723,80,121,-41,-12
"24940",NA,45047,"Greenwood County, SC","County or equivalent",2007,68173,292,224,947,723,80,121,-41,-12
"24980",NA,NA,"Grenada, MS","Micropolitan Statistical Area",2007,23045,77,89,344,255,-12,10,-22,0
"24980",NA,28043,"Grenada County, MS","County or equivalent",2007,23045,77,89,344,255,-12,10,-22,0
"25100",NA,NA,"Guymon, OK","Micropolitan Statistical Area",2007,19890,40,285,410,125,-236,174,-410,-9
"25100",NA,40139,"Texas County, OK","County or equivalent",2007,19890,40,285,410,125,-236,174,-410,-9
"25220",NA,NA,"Hammond, LA","Micropolitan Statistical Area",2007,115455,2414,895,1964,1069,1492,21,1471,27
"25220",NA,22105,"Tangipahoa Parish, LA","County or equivalent",2007,115455,2414,895,1964,1069,1492,21,1471,27
"25300",NA,NA,"Hannibal, MO","Micropolitan Statistical Area",2007,38003,-2,179,571,392,-185,4,-189,4
"25300",NA,29127,"Marion County, MO","County or equivalent",2007,28157,-60,109,448,339,-174,2,-176,5
"25300",NA,29173,"Ralls County, MO","County or equivalent",2007,9846,58,70,123,53,-11,2,-13,-1
"25340",NA,NA,"Harriman, TN","Micropolitan Statistical Area",2007,53306,266,-144,516,660,386,14,372,24
"25340",NA,47145,"Roane County, TN","County or equivalent",2007,53306,266,-144,516,660,386,14,372,24
"25380",NA,NA,"Harrisburg, IL","Micropolitan Statistical Area",2007,26049,76,-65,317,382,137,5,132,4
"25380",NA,17165,"Saline County, IL","County or equivalent",2007,26049,76,-65,317,382,137,5,132,4
"25460",NA,NA,"Harrison, AR","Micropolitan Statistical Area",2007,44979,692,91,554,463,581,7,574,20
"25460",NA,5009,"Boone County, AR","County or equivalent",2007,36644,722,94,469,375,608,7,601,20
"25460",NA,5101,"Newton County, AR","County or equivalent",2007,8335,-30,-3,85,88,-27,0,-27,0
"25580",NA,NA,"Hastings, NE","Micropolitan Statistical Area",2007,39204,-67,167,523,356,-241,80,-321,7
"25580",NA,31001,"Adams County, NE","County or equivalent",2007,32869,-3,159,446,287,-170,79,-249,8
"25580",NA,31035,"Clay County, NE","County or equivalent",2007,6335,-64,8,77,69,-71,1,-72,-1
"25660",NA,NA,"Havre, MT","Micropolitan Statistical Area",2007,16536,105,132,267,135,-20,-1,-19,-7
"25660",NA,30041,"Hill County, MT","County or equivalent",2007,16536,105,132,267,135,-20,-1,-19,-7
"25700",NA,NA,"Hays, KS","Micropolitan Statistical Area",2007,27421,107,155,381,226,-42,25,-67,-6
"25700",NA,20051,"Ellis County, KS","County or equivalent",2007,27421,107,155,381,226,-42,25,-67,-6
"25720",NA,NA,"Heber, UT","Micropolitan Statistical Area",2007,20442,581,337,421,84,273,29,244,-29
"25720",NA,49051,"Wasatch County, UT","County or equivalent",2007,20442,581,337,421,84,273,29,244,-29
"25740",NA,NA,"Helena, MT","Micropolitan Statistical Area",2007,71019,1264,365,903,538,882,18,864,17
"25740",NA,30043,"Jefferson County, MT","County or equivalent",2007,11090,233,40,107,67,192,-1,193,1
"25740",NA,30049,"Lewis and Clark County, MT","County or equivalent",2007,59929,1031,325,796,471,690,19,671,16
"25760",NA,NA,"Helena-West Helena, AR","Micropolitan Statistical Area",2007,22000,-550,118,405,287,-658,6,-664,-10
"25760",NA,5107,"Phillips County, AR","County or equivalent",2007,22000,-550,118,405,287,-658,6,-664,-10
"25780",NA,NA,"Henderson, NC","Micropolitan Statistical Area",2007,42892,-88,307,758,451,-412,85,-497,17
"25780",NA,37181,"Vance County, NC","County or equivalent",2007,42892,-88,307,758,451,-412,85,-497,17
"25820",NA,NA,"Hereford, TX","Micropolitan Statistical Area",2007,18394,99,242,372,130,-138,43,-181,-5
"25820",NA,48117,"Deaf Smith County, TX","County or equivalent",2007,18394,99,242,372,130,-138,43,-181,-5
"25900",NA,NA,"Hilo, HI","Micropolitan Statistical Area",2007,172547,3486,1200,2574,1374,2235,315,1920,51
"25900",NA,15001,"Hawaii County, HI","County or equivalent",2007,172547,3486,1200,2574,1374,2235,315,1920,51
"25940",NA,NA,"Hilton Head Island-Beaufort, SC","Micropolitan Statistical Area",2007,168622,4041,1358,2761,1403,2738,294,2444,-55
"25940",NA,45013,"Beaufort County, SC","County or equivalent",2007,146722,3631,1205,2419,1214,2470,219,2251,-44
"25940",NA,45053,"Jasper County, SC","County or equivalent",2007,21900,410,153,342,189,268,75,193,-11
"26020",NA,NA,"Hobbs, NM","Micropolitan Statistical Area",2007,57992,1199,608,1110,502,576,71,505,15
"26020",NA,35025,"Lea County, NM","County or equivalent",2007,57992,1199,608,1110,502,576,71,505,15
"26140",NA,NA,"Homosassa Springs, FL","Micropolitan Statistical Area",2007,139944,3089,-1137,1143,2280,4110,56,4054,116
"26140",NA,12017,"Citrus County, FL","County or equivalent",2007,139944,3089,-1137,1143,2280,4110,56,4054,116
"26220",NA,NA,"Hood River, OR","Micropolitan Statistical Area",2007,21200,80,139,305,166,-62,83,-145,3
"26220",NA,41027,"Hood River County, OR","County or equivalent",2007,21200,80,139,305,166,-62,83,-145,3
"26260",NA,NA,"Hope, AR","Micropolitan Statistical Area",2007,32474,-11,188,514,326,-201,95,-296,2
"26260",NA,5057,"Hempstead County, AR","County or equivalent",2007,23143,81,163,390,227,-86,85,-171,4
"26260",NA,5099,"Nevada County, AR","County or equivalent",2007,9331,-92,25,124,99,-115,10,-125,-2
"26340",NA,NA,"Houghton, MI","Micropolitan Statistical Area",2007,37140,-63,76,445,369,-137,41,-178,-2
"26340",NA,26061,"Houghton County, MI","County or equivalent",2007,34968,-82,55,408,353,-138,40,-178,1
"26340",NA,26083,"Keweenaw County, MI","County or equivalent",2007,2172,19,21,37,16,1,1,0,-3
"26460",NA,NA,"Hudson, NY","Micropolitan Statistical Area",2007,62225,-244,-49,596,645,-207,43,-250,12
"26460",NA,36021,"Columbia County, NY","County or equivalent",2007,62225,-244,-49,596,645,-207,43,-250,12
"26480",NA,NA,"Humboldt, TN","Micropolitan Statistical Area",2007,48511,473,-9,678,687,481,14,467,1
"26480",NA,47053,"Gibson County, TN","County or equivalent",2007,48511,473,-9,678,687,481,14,467,1
"26500",NA,NA,"Huntingdon, PA","Micropolitan Statistical Area",2007,45527,87,21,453,432,63,0,63,3
"26500",NA,42061,"Huntingdon County, PA","County or equivalent",2007,45527,87,21,453,432,63,0,63,3
"26540",NA,NA,"Huntington, IN","Micropolitan Statistical Area",2007,37729,-130,94,470,376,-225,8,-233,1
"26540",NA,18069,"Huntington County, IN","County or equivalent",2007,37729,-130,94,470,376,-225,8,-233,1
"26660",NA,NA,"Huntsville, TX","Micropolitan Statistical Area",2007,63930,7,248,661,413,-244,80,-324,3
"26660",NA,48471,"Walker County, TX","County or equivalent",2007,63930,7,248,661,413,-244,80,-324,3
"26700",NA,NA,"Huron, SD","Micropolitan Statistical Area",2007,15706,254,48,244,196,206,5,201,0
"26700",NA,46005,"Beadle County, SD","County or equivalent",2007,15706,254,48,244,196,206,5,201,0
"26740",NA,NA,"Hutchinson, KS","Micropolitan Statistical Area",2007,63090,-194,207,873,666,-430,33,-463,29
"26740",NA,20155,"Reno County, KS","County or equivalent",2007,63090,-194,207,873,666,-430,33,-463,29
"26780",NA,NA,"Hutchinson, MN","Micropolitan Statistical Area",2007,37107,283,273,574,301,12,20,-8,-2
"26780",NA,27085,"McLeod County, MN","County or equivalent",2007,37107,283,273,574,301,12,20,-8,-2
"26860",NA,NA,"Indiana, PA","Micropolitan Statistical Area",2007,87570,-222,15,901,886,-250,38,-288,13
"26860",NA,42063,"Indiana County, PA","County or equivalent",2007,87570,-222,15,901,886,-250,38,-288,13
"26940",NA,NA,"Indianola, MS","Micropolitan Statistical Area",2007,31000,-69,174,530,356,-249,11,-260,6
"26940",NA,28133,"Sunflower County, MS","County or equivalent",2007,31000,-69,174,530,356,-249,11,-260,6
"27020",NA,NA,"Iron Mountain, MI-WI","Micropolitan Statistical Area",2007,31680,-174,7,315,308,-175,5,-180,-6
"27020",NA,26043,"Dickinson County, MI","County or equivalent",2007,26936,-78,13,284,271,-95,4,-99,4
"27020",NA,55037,"Florence County, WI","County or equivalent",2007,4744,-96,-6,31,37,-80,1,-81,-10
"27220",NA,NA,"Jackson, WY-ID","Micropolitan Statistical Area",2007,28252,906,384,452,68,527,98,429,-5
"27220",NA,16081,"Teton County, ID","County or equivalent",2007,8294,536,142,162,20,389,27,362,5
"27220",NA,56039,"Teton County, WY","County or equivalent",2007,19958,370,242,290,48,138,71,67,-10
"27300",NA,NA,"Jacksonville, IL","Micropolitan Statistical Area",2007,40580,-117,13,465,452,-139,8,-147,9
"27300",NA,17137,"Morgan County, IL","County or equivalent",2007,35365,-82,2,406,404,-95,8,-103,11
"27300",NA,17171,"Scott County, IL","County or equivalent",2007,5215,-35,11,59,48,-44,0,-44,-2
"27380",NA,NA,"Jacksonville, TX","Micropolitan Statistical Area",2007,48056,287,279,741,462,20,140,-120,-12
"27380",NA,48073,"Cherokee County, TX","County or equivalent",2007,48056,287,279,741,462,20,140,-120,-12
"27420",NA,NA,"Jamestown, ND","Micropolitan Statistical Area",2007,20457,-279,-8,220,228,-279,4,-283,8
"27420",NA,38093,"Stutsman County, ND","County or equivalent",2007,20457,-279,-8,220,228,-279,4,-283,8
"27460",NA,NA,"Jamestown-Dunkirk-Fredonia, NY","Micropolitan Statistical Area",2007,133953,-383,121,1548,1427,-516,81,-597,12
"27460",NA,36013,"Chautauqua County, NY","County or equivalent",2007,133953,-383,121,1548,1427,-516,81,-597,12
"27540",NA,NA,"Jasper, IN","Micropolitan Statistical Area",2007,53753,169,233,755,522,-51,40,-91,-13
"27540",NA,18037,"Dubois County, IN","County or equivalent",2007,41164,199,224,600,376,-16,39,-55,-9
"27540",NA,18125,"Pike County, IN","County or equivalent",2007,12589,-30,9,155,146,-35,1,-36,-4
"27660",NA,NA,"Jennings, LA","Micropolitan Statistical Area",2007,31136,-68,151,472,321,-229,3,-232,10
"27660",NA,22053,"Jefferson Davis Parish, LA","County or equivalent",2007,31136,-68,151,472,321,-229,3,-232,10
"27700",NA,NA,"Jesup, GA","Micropolitan Statistical Area",2007,28989,457,162,442,280,289,15,274,6
"27700",NA,13305,"Wayne County, GA","County or equivalent",2007,28989,457,162,442,280,289,15,274,6
"27940",NA,NA,"Juneau, AK","Micropolitan Statistical Area",2007,30530,-147,255,402,147,-411,31,-442,9
"27940",NA,2110,"Juneau City and Borough, AK","County or equivalent",2007,30530,-147,255,402,147,-411,31,-442,9
"27980",NA,NA,"Kahului-Wailuku, HI","Micropolitan Statistical Area",2007,141405,1405,1183,2149,966,208,415,-207,14
"27980",NA,15009,"Maui County, HI","County or equivalent",2007,141405,1405,1183,2149,966,208,415,-207,14
"28060",NA,NA,"Kalispell, MT","Micropolitan Statistical Area",2007,86766,2217,483,1206,723,1702,28,1674,32
"28060",NA,30029,"Flathead County, MT","County or equivalent",2007,86766,2217,483,1206,723,1702,28,1674,32
"28180",NA,NA,"Kapaa, HI","Micropolitan Statistical Area",2007,62761,811,387,856,469,405,97,308,19
"28180",NA,15007,"Kauai County, HI","County or equivalent",2007,62761,811,387,856,469,405,97,308,19
"28260",NA,NA,"Kearney, NE","Micropolitan Statistical Area",2007,51522,462,398,787,389,83,25,58,-19
"28260",NA,31019,"Buffalo County, NE","County or equivalent",2007,44939,425,379,709,330,65,25,40,-19
"28260",NA,31099,"Kearney County, NE","County or equivalent",2007,6583,37,19,78,59,18,0,18,0
"28300",NA,NA,"Keene, NH","Micropolitan Statistical Area",2007,77304,44,113,772,659,-72,27,-99,3
"28300",NA,33005,"Cheshire County, NH","County or equivalent",2007,77304,44,113,772,659,-72,27,-99,3
"28340",NA,NA,"Kendallville, IN","Micropolitan Statistical Area",2007,47451,43,369,762,393,-337,123,-460,11
"28340",NA,18113,"Noble County, IN","County or equivalent",2007,47451,43,369,762,393,-337,123,-460,11
"28380",NA,NA,"Kennett, MO","Micropolitan Statistical Area",2007,31609,-177,83,492,409,-268,11,-279,8
"28380",NA,29069,"Dunklin County, MO","County or equivalent",2007,31609,-177,83,492,409,-268,11,-279,8
"28500",NA,NA,"Kerrville, TX","Micropolitan Statistical Area",2007,47665,619,-88,589,677,731,62,669,-24
"28500",NA,48265,"Kerr County, TX","County or equivalent",2007,47665,619,-88,589,677,731,62,669,-24
"28540",NA,NA,"Ketchikan, AK","Micropolitan Statistical Area",2007,13162,-153,132,184,52,-285,9,-294,0
"28540",NA,2130,"Ketchikan Gateway Borough, AK","County or equivalent",2007,13162,-153,132,184,52,-285,9,-294,0
"28580",NA,NA,"Key West, FL","Micropolitan Statistical Area",2007,72910,-1171,46,691,645,-1117,293,-1410,-100
"28580",NA,12087,"Monroe County, FL","County or equivalent",2007,72910,-1171,46,691,645,-1117,293,-1410,-100
"28620",NA,NA,"Kill Devil Hills, NC","Micropolitan Statistical Area",2007,33693,-61,200,451,251,-203,25,-228,-58
"28620",NA,37055,"Dare County, NC","County or equivalent",2007,33693,-61,200,451,251,-203,25,-228,-58
"28780",NA,NA,"Kingsville, TX","Micropolitan Statistical Area",2007,31028,125,289,512,223,-143,38,-181,-21
"28780",NA,48261,"Kenedy County, TX","County or equivalent",2007,394,-11,6,6,0,-17,1,-18,0
"28780",NA,48273,"Kleberg County, TX","County or equivalent",2007,30634,136,283,506,223,-126,37,-163,-21
"28820",NA,NA,"Kinston, NC","Micropolitan Statistical Area",2007,56685,-324,115,788,673,-453,64,-517,14
"28820",NA,37107,"Lenoir County, NC","County or equivalent",2007,56685,-324,115,788,673,-453,64,-517,14
"28860",NA,NA,"Kirksville, MO","Micropolitan Statistical Area",2007,28704,16,115,369,254,-108,22,-130,9
"28860",NA,29001,"Adair County, MO","County or equivalent",2007,24616,-4,113,319,206,-125,20,-145,8
"28860",NA,29197,"Schuyler County, MO","County or equivalent",2007,4088,20,2,50,48,17,2,15,1
"28900",NA,NA,"Klamath Falls, OR","Micropolitan Statistical Area",2007,66408,512,197,873,676,295,42,253,20
"28900",NA,41035,"Klamath County, OR","County or equivalent",2007,66408,512,197,873,676,295,42,253,20
"28980",NA,NA,"Kodiak, AK","Micropolitan Statistical Area",2007,12981,-11,191,222,31,-196,49,-245,-6
"28980",NA,2150,"Kodiak Island Borough, AK","County or equivalent",2007,12981,-11,191,222,31,-196,49,-245,-6
"29060",NA,NA,"Laconia, NH","Micropolitan Statistical Area",2007,61065,103,15,616,601,74,38,36,14
"29060",NA,33001,"Belknap County, NH","County or equivalent",2007,61065,103,15,616,601,74,38,36,14
"29220",NA,NA,"La Follette, TN","Micropolitan Statistical Area",2007,40679,135,-54,488,542,176,20,156,13
"29220",NA,47013,"Campbell County, TN","County or equivalent",2007,40679,135,-54,488,542,176,20,156,13
"29260",NA,NA,"La Grande, OR","Micropolitan Statistical Area",2007,24737,301,110,325,215,182,23,159,9
"29260",NA,41061,"Union County, OR","County or equivalent",2007,24737,301,110,325,215,182,23,159,9
"29300",NA,NA,"LaGrange, GA","Micropolitan Statistical Area",2007,63382,741,345,1007,662,403,59,344,-7
"29300",NA,13285,"Troup County, GA","County or equivalent",2007,63382,741,345,1007,662,403,59,344,-7
"29380",NA,NA,"Lake City, FL","Micropolitan Statistical Area",2007,67868,1122,178,863,685,991,30,961,-47
"29380",NA,12023,"Columbia County, FL","County or equivalent",2007,67868,1122,178,863,685,991,30,961,-47
"29500",NA,NA,"Lamesa, TX","Micropolitan Statistical Area",2007,13761,-181,84,199,115,-257,18,-275,-8
"29500",NA,48115,"Dawson County, TX","County or equivalent",2007,13761,-181,84,199,115,-257,18,-275,-8
"29580",NA,NA,"Lancaster, SC","Micropolitan Statistical Area",2007,73538,1815,303,951,648,1478,48,1430,34
"29580",NA,45057,"Lancaster County, SC","County or equivalent",2007,73538,1815,303,951,648,1478,48,1430,34
"29660",NA,NA,"Laramie, WY","Micropolitan Statistical Area",2007,32288,-325,230,404,174,-555,52,-607,0
"29660",NA,56001,"Albany County, WY","County or equivalent",2007,32288,-325,230,404,174,-555,52,-607,0
"29780",NA,NA,"Las Vegas, NM","Micropolitan Statistical Area",2007,28629,-154,87,367,280,-245,5,-250,4
"29780",NA,35047,"San Miguel County, NM","County or equivalent",2007,28629,-154,87,367,280,-245,5,-250,4
"29860",NA,NA,"Laurel, MS","Micropolitan Statistical Area",2007,84752,685,587,1490,903,119,114,5,-21
"29860",NA,28061,"Jasper County, MS","County or equivalent",2007,18057,97,104,290,186,0,2,-2,-7
"29860",NA,28067,"Jones County, MS","County or equivalent",2007,66695,588,483,1200,717,119,112,7,-14
"29900",NA,NA,"Laurinburg, NC","Micropolitan Statistical Area",2007,36341,88,195,571,376,-109,19,-128,2
"29900",NA,37165,"Scotland County, NC","County or equivalent",2007,36341,88,195,571,376,-109,19,-128,2
"29980",NA,NA,"Lawrenceburg, TN","Micropolitan Statistical Area",2007,40881,288,111,566,455,166,7,159,11
"29980",NA,47099,"Lawrence County, TN","County or equivalent",2007,40881,288,111,566,455,166,7,159,11
"30060",NA,NA,"Lebanon, MO","Micropolitan Statistical Area",2007,35346,459,154,520,366,303,4,299,2
"30060",NA,29105,"Laclede County, MO","County or equivalent",2007,35346,459,154,520,366,303,4,299,2
"30100",NA,NA,"Lebanon, NH-VT","Micropolitan Statistical Area",2007,171065,-165,150,1680,1530,-275,107,-382,-40
"30100",NA,33009,"Grafton County, NH","County or equivalent",2007,85331,145,83,819,736,81,80,1,-19
"30100",NA,50017,"Orange County, VT","County or equivalent",2007,28956,-100,62,294,232,-163,1,-164,1
"30100",NA,50027,"Windsor County, VT","County or equivalent",2007,56778,-210,5,567,562,-193,26,-219,-22
"30220",NA,NA,"Levelland, TX","Micropolitan Statistical Area",2007,22186,-154,185,361,176,-318,18,-336,-21
"30220",NA,48219,"Hockley County, TX","County or equivalent",2007,22186,-154,185,361,176,-318,18,-336,-21
"30260",NA,NA,"Lewisburg, PA","Micropolitan Statistical Area",2007,43476,-34,19,402,383,-58,15,-73,5
"30260",NA,42119,"Union County, PA","County or equivalent",2007,43476,-34,19,402,383,-58,15,-73,5
"30280",NA,NA,"Lewisburg, TN","Micropolitan Statistical Area",2007,29142,572,118,390,272,442,26,416,12
"30280",NA,47117,"Marshall County, TN","County or equivalent",2007,29142,572,118,390,272,442,26,416,12
"30380",NA,NA,"Lewistown, PA","Micropolitan Statistical Area",2007,46054,80,72,638,566,-7,2,-9,15
"30380",NA,42087,"Mifflin County, PA","County or equivalent",2007,46054,80,72,638,566,-7,2,-9,15
"30420",NA,NA,"Lexington, NE","Micropolitan Statistical Area",2007,26531,20,253,477,224,-241,156,-397,8
"30420",NA,31047,"Dawson County, NE","County or equivalent",2007,24556,0,242,452,210,-255,155,-410,13
"30420",NA,31073,"Gosper County, NE","County or equivalent",2007,1975,20,11,25,14,14,1,13,-5
"30500",NA,NA,"Lexington Park, MD","Micropolitan Statistical Area",2007,100262,1752,879,1559,680,877,12,865,-4
"30500",NA,24037,"St. Mary's County, MD","County or equivalent",2007,100262,1752,879,1559,680,877,12,865,-4
"30580",NA,NA,"Liberal, KS","Micropolitan Statistical Area",2007,22889,277,444,558,114,-155,256,-411,-12
"30580",NA,20175,"Seward County, KS","County or equivalent",2007,22889,277,444,558,114,-155,256,-411,-12
"30660",NA,NA,"Lincoln, IL","Micropolitan Statistical Area",2007,29817,-98,19,332,313,-122,6,-128,5
"30660",NA,17107,"Logan County, IL","County or equivalent",2007,29817,-98,19,332,313,-122,6,-128,5
"30740",NA,NA,"Lincolnton, NC","Micropolitan Statistical Area",2007,72768,1804,283,899,616,1505,211,1294,16
"30740",NA,37109,"Lincoln County, NC","County or equivalent",2007,72768,1804,283,899,616,1505,211,1294,16
"30820",NA,NA,"Lock Haven, PA","Micropolitan Statistical Area",2007,37110,-151,41,421,380,-192,8,-200,0
"30820",NA,42035,"Clinton County, PA","County or equivalent",2007,37110,-151,41,421,380,-192,8,-200,0
"30900",NA,NA,"Logansport, IN","Micropolitan Statistical Area",2007,39040,-256,146,546,400,-412,71,-483,10
"30900",NA,18017,"Cass County, IN","County or equivalent",2007,39040,-256,146,546,400,-412,71,-483,10
"30940",NA,NA,"London, KY","Micropolitan Statistical Area",2007,57335,605,213,749,536,385,22,363,7
"30940",NA,21125,"Laurel County, KY","County or equivalent",2007,57335,605,213,749,536,385,22,363,7
"31060",NA,NA,"Los Alamos, NM","Micropolitan Statistical Area",2007,18497,-176,69,164,95,-246,52,-298,1
"31060",NA,35028,"Los Alamos County, NM","County or equivalent",2007,18497,-176,69,164,95,-246,52,-298,1
"31260",NA,NA,"Lufkin, TX","Micropolitan Statistical Area",2007,82570,463,558,1321,763,-112,124,-236,17
"31260",NA,48005,"Angelina County, TX","County or equivalent",2007,82570,463,558,1321,763,-112,124,-236,17
"31300",NA,NA,"Lumberton, NC","Micropolitan Statistical Area",2007,128066,1368,1085,2272,1187,294,349,-55,-11
"31300",NA,37155,"Robeson County, NC","County or equivalent",2007,128066,1368,1085,2272,1187,294,349,-55,-11
"31380",NA,NA,"Macomb, IL","Micropolitan Statistical Area",2007,33017,78,14,292,278,67,54,13,-3
"31380",NA,17109,"McDonough County, IL","County or equivalent",2007,33017,78,14,292,278,67,54,13,-3
"31500",NA,NA,"Madison, IN","Micropolitan Statistical Area",2007,32591,39,56,384,328,-7,6,-13,-10
"31500",NA,18077,"Jefferson County, IN","County or equivalent",2007,32591,39,56,384,328,-7,6,-13,-10
"31580",NA,NA,"Madisonville, KY","Micropolitan Statistical Area",2007,46247,-33,56,610,554,-103,9,-112,14
"31580",NA,21107,"Hopkins County, KY","County or equivalent",2007,46247,-33,56,610,554,-103,9,-112,14
"31620",NA,NA,"Magnolia, AR","Micropolitan Statistical Area",2007,24361,-234,83,330,247,-317,9,-326,0
"31620",NA,5027,"Columbia County, AR","County or equivalent",2007,24361,-234,83,330,247,-317,9,-326,0
"31660",NA,NA,"Malone, NY","Micropolitan Statistical Area",2007,50449,99,72,511,439,27,6,21,0
"31660",NA,36033,"Franklin County, NY","County or equivalent",2007,50449,99,72,511,439,27,6,21,0
"31740",NA,NA,"Manhattan, KS","Micropolitan Statistical Area",2007,118233,1287,1574,2198,624,-913,107,-1020,626
"31740",NA,20061,"Geary County, KS","County or equivalent",2007,29539,528,564,731,167,-652,7,-659,616
"31740",NA,20149,"Pottawatomie County, KS","County or equivalent",2007,19416,529,192,369,177,330,-1,331,7
"31740",NA,20161,"Riley County, KS","County or equivalent",2007,69278,230,818,1098,280,-591,101,-692,3
"31820",NA,NA,"Manitowoc, WI","Micropolitan Statistical Area",2007,80768,-81,110,915,805,-208,61,-269,17
"31820",NA,55071,"Manitowoc County, WI","County or equivalent",2007,80768,-81,110,915,805,-208,61,-269,17
"31860",NA,NA,"Mankato-North Mankato, MN","Micropolitan Statistical Area",2007,91665,901,554,1217,663,376,90,286,-29
"31860",NA,27013,"Blue Earth County, MN","County or equivalent",2007,59910,582,337,787,450,246,61,185,-1
"31860",NA,27103,"Nicollet County, MN","County or equivalent",2007,31755,319,217,430,213,130,29,101,-28
"31940",NA,NA,"Marinette, WI-MI","Micropolitan Statistical Area",2007,66645,-274,-43,695,738,-248,12,-260,17
"31940",NA,26109,"Menominee County, MI","County or equivalent",2007,24198,-138,-5,250,255,-134,6,-140,1
"31940",NA,55075,"Marinette County, WI","County or equivalent",2007,42447,-136,-38,445,483,-114,6,-120,16
"31980",NA,NA,"Marion, IN","Micropolitan Statistical Area",2007,68787,-654,53,824,771,-695,9,-704,-12
"31980",NA,18053,"Grant County, IN","County or equivalent",2007,68787,-654,53,824,771,-695,9,-704,-12
"32020",NA,NA,"Marion, OH","Micropolitan Statistical Area",2007,65536,16,165,805,640,-159,10,-169,10
"32020",NA,39101,"Marion County, OH","County or equivalent",2007,65536,16,165,805,640,-159,10,-169,10
"32060",NA,NA,"Marion-Herrin, IL","Micropolitan Statistical Area",2007,64169,657,76,815,739,566,12,554,15
"32060",NA,17199,"Williamson County, IL","County or equivalent",2007,64169,657,76,815,739,566,12,554,15
"32100",NA,NA,"Marquette, MI","Micropolitan Statistical Area",2007,65317,77,81,653,572,-18,16,-34,14
"32100",NA,26103,"Marquette County, MI","County or equivalent",2007,65317,77,81,653,572,-18,16,-34,14
"32140",NA,NA,"Marshall, MN","Micropolitan Statistical Area",2007,24684,-21,160,387,227,-185,35,-220,4
"32140",NA,27083,"Lyon County, MN","County or equivalent",2007,24684,-21,160,387,227,-185,35,-220,4
"32180",NA,NA,"Marshall, MO","Micropolitan Statistical Area",2007,22614,-81,29,299,270,-103,35,-138,-7
"32180",NA,29195,"Saline County, MO","County or equivalent",2007,22614,-81,29,299,270,-103,35,-138,-7
"32220",NA,NA,"Marshall, TX","Micropolitan Statistical Area",2007,63211,7,268,845,577,-224,71,-295,-37
"32220",NA,48203,"Harrison County, TX","County or equivalent",2007,63211,7,268,845,577,-224,71,-295,-37
"32260",NA,NA,"Marshalltown, IA","Micropolitan Statistical Area",2007,39214,280,206,627,421,96,103,-7,-22
"32260",NA,19127,"Marshall County, IA","County or equivalent",2007,39214,280,206,627,421,96,103,-7,-22
"32270",NA,NA,"Marshfield-Wisconsin Rapids, WI","Micropolitan Statistical Area",2007,73796,-193,181,903,722,-407,44,-451,33
"32270",NA,55141,"Wood County, WI","County or equivalent",2007,73796,-193,181,903,722,-407,44,-451,33
"32280",NA,NA,"Martin, TN","Micropolitan Statistical Area",2007,33174,-93,-16,340,356,-78,38,-116,1
"32280",NA,47183,"Weakley County, TN","County or equivalent",2007,33174,-93,-16,340,356,-78,38,-116,1
"32300",NA,NA,"Martinsville, VA","Micropolitan Statistical Area",2007,70006,-264,-75,819,894,-179,145,-324,-10
"32300",NA,51089,"Henry County, VA","County or equivalent",2007,55461,-122,-8,663,671,-112,114,-226,-2
"32300",NA,51690,"Martinsville city, VA","County or equivalent",2007,14545,-142,-67,156,223,-67,31,-98,-8
"32340",NA,NA,"Maryville, MO","Micropolitan Statistical Area",2007,22059,59,46,244,198,16,13,3,-3
"32340",NA,29147,"Nodaway County, MO","County or equivalent",2007,22059,59,46,244,198,16,13,3,-3
"32380",NA,NA,"Mason City, IA","Micropolitan Statistical Area",2007,51661,-120,48,603,555,-170,21,-191,2
"32380",NA,19033,"Cerro Gordo County, IA","County or equivalent",2007,44004,-124,43,520,477,-171,19,-190,4
"32380",NA,19195,"Worth County, IA","County or equivalent",2007,7657,4,5,83,78,1,2,-1,-2
"32460",NA,NA,"Mayfield, KY","Micropolitan Statistical Area",2007,37484,232,61,508,447,188,53,135,-17
"32460",NA,21083,"Graves County, KY","County or equivalent",2007,37484,232,61,508,447,188,53,135,-17
"32500",NA,NA,"Maysville, KY","Micropolitan Statistical Area",2007,31095,130,93,438,345,51,12,39,-14
"32500",NA,21135,"Lewis County, KY","County or equivalent",2007,13868,20,43,195,152,-16,1,-17,-7
"32500",NA,21161,"Mason County, KY","County or equivalent",2007,17227,110,50,243,193,67,11,56,-7
"32540",NA,NA,"McAlester, OK","Micropolitan Statistical Area",2007,44636,308,35,567,532,263,13,250,10
"32540",NA,40121,"Pittsburg County, OK","County or equivalent",2007,44636,308,35,567,532,263,13,250,10
"32620",NA,NA,"McComb, MS","Micropolitan Statistical Area",2007,53181,-198,314,931,617,-507,1,-508,-5
"32620",NA,28005,"Amite County, MS","County or equivalent",2007,13333,-126,45,194,149,-155,0,-155,-16
"32620",NA,28113,"Pike County, MS","County or equivalent",2007,39848,-72,269,737,468,-352,1,-353,11
"32660",NA,NA,"McMinnville, TN","Micropolitan Statistical Area",2007,39646,247,113,547,434,130,89,41,4
"32660",NA,47177,"Warren County, TN","County or equivalent",2007,39646,247,113,547,434,130,89,41,4
"32700",NA,NA,"McPherson, KS","Micropolitan Statistical Area",2007,29150,118,-16,353,369,154,3,151,-20
"32700",NA,20113,"McPherson County, KS","County or equivalent",2007,29150,118,-16,353,369,154,3,151,-20
"32740",NA,NA,"Meadville, PA","Micropolitan Statistical Area",2007,88735,-101,58,1023,965,-176,3,-179,17
"32740",NA,42039,"Crawford County, PA","County or equivalent",2007,88735,-101,58,1023,965,-176,3,-179,17
"32860",NA,NA,"Menomonie, WI","Micropolitan Statistical Area",2007,42542,283,208,501,293,77,25,52,-2
"32860",NA,55033,"Dunn County, WI","County or equivalent",2007,42542,283,208,501,293,77,25,52,-2
"32940",NA,NA,"Meridian, MS","Micropolitan Statistical Area",2007,105353,934,527,1679,1152,398,-7,405,9
"32940",NA,28023,"Clarke County, MS","County or equivalent",2007,17354,-105,69,249,180,-159,0,-159,-15
"32940",NA,28069,"Kemper County, MS","County or equivalent",2007,10082,-42,75,148,73,-115,2,-117,-2
"32940",NA,28075,"Lauderdale County, MS","County or equivalent",2007,77917,1081,383,1282,899,672,-9,681,26
"32980",NA,NA,"Merrill, WI","Micropolitan Statistical Area",2007,29619,-85,42,335,293,-123,14,-137,-4
"32980",NA,55069,"Lincoln County, WI","County or equivalent",2007,29619,-85,42,335,293,-123,14,-137,-4
"33020",NA,NA,"Mexico, MO","Micropolitan Statistical Area",2007,25829,-159,99,398,299,-260,1,-261,2
"33020",NA,29007,"Audrain County, MO","County or equivalent",2007,25829,-159,99,398,299,-260,1,-261,2
"33060",NA,NA,"Miami, OK","Micropolitan Statistical Area",2007,32325,-472,78,494,416,-575,19,-594,25
"33060",NA,40115,"Ottawa County, OK","County or equivalent",2007,32325,-472,78,494,416,-575,19,-594,25
"33180",NA,NA,"Middlesborough, KY","Micropolitan Statistical Area",2007,28993,-114,-1,398,399,-116,10,-126,3
"33180",NA,21013,"Bell County, KY","County or equivalent",2007,28993,-114,-1,398,399,-116,10,-126,3
"33220",NA,NA,"Midland, MI","Micropolitan Statistical Area",2007,82593,-243,263,917,654,-512,103,-615,6
"33220",NA,26111,"Midland County, MI","County or equivalent",2007,82593,-243,263,917,654,-512,103,-615,6
"33300",NA,NA,"Milledgeville, GA","Micropolitan Statistical Area",2007,55917,903,193,697,504,712,17,695,-2
"33300",NA,13009,"Baldwin County, GA","County or equivalent",2007,46359,768,174,588,414,588,18,570,6
"33300",NA,13141,"Hancock County, GA","County or equivalent",2007,9558,135,19,109,90,124,-1,125,-8
"33380",NA,NA,"Minden, LA","Micropolitan Statistical Area",2007,40870,-52,-26,533,559,-28,6,-34,2
"33380",NA,22119,"Webster Parish, LA","County or equivalent",2007,40870,-52,-26,533,559,-28,6,-34,2
"33420",NA,NA,"Mineral Wells, TX","Micropolitan Statistical Area",2007,27268,-242,113,427,314,-334,34,-368,-21
"33420",NA,48363,"Palo Pinto County, TX","County or equivalent",2007,27268,-242,113,427,314,-334,34,-368,-21
"33500",NA,NA,"Minot, ND","Micropolitan Statistical Area",2007,63457,-306,540,1080,540,-844,-38,-806,-2
"33500",NA,38049,"McHenry County, ND","County or equivalent",2007,5211,-152,4,54,50,-143,-1,-142,-13
"33500",NA,38075,"Renville County, ND","County or equivalent",2007,2299,-73,-10,20,30,-64,-1,-63,1
"33500",NA,38101,"Ward County, ND","County or equivalent",2007,55947,-81,546,1006,460,-637,-36,-601,10
"33580",NA,NA,"Mitchell, SD","Micropolitan Statistical Area",2007,22586,-24,145,352,207,-168,8,-176,-1
"33580",NA,46035,"Davison County, SD","County or equivalent",2007,18987,-52,108,301,193,-168,7,-175,8
"33580",NA,46061,"Hanson County, SD","County or equivalent",2007,3599,28,37,51,14,0,1,-1,-9
"33620",NA,NA,"Moberly, MO","Micropolitan Statistical Area",2007,25635,141,120,349,229,17,15,2,4
"33620",NA,29175,"Randolph County, MO","County or equivalent",2007,25635,141,120,349,229,17,15,2,4
"33820",NA,NA,"Monroe, WI","Micropolitan Statistical Area",2007,35718,378,173,478,305,215,10,205,-10
"33820",NA,55045,"Green County, WI","County or equivalent",2007,35718,378,173,478,305,215,10,205,-10
"33940",NA,NA,"Montrose, CO","Micropolitan Statistical Area",2007,39446,1395,160,530,370,1248,37,1211,-13
"33940",NA,8085,"Montrose County, CO","County or equivalent",2007,39446,1395,160,530,370,1248,37,1211,-13
"33980",NA,NA,"Morehead City, NC","Micropolitan Statistical Area",2007,63154,-48,22,674,652,-7,14,-21,-63
"33980",NA,37031,"Carteret County, NC","County or equivalent",2007,63154,-48,22,674,652,-7,14,-21,-63
"34020",NA,NA,"Morgan City, LA","Micropolitan Statistical Area",2007,51286,-328,227,807,580,-570,26,-596,15
"34020",NA,22101,"St. Mary Parish, LA","County or equivalent",2007,51286,-328,227,807,580,-570,26,-596,15
"34140",NA,NA,"Moscow, ID","Micropolitan Statistical Area",2007,35748,-329,173,407,234,-519,56,-575,17
"34140",NA,16057,"Latah County, ID","County or equivalent",2007,35748,-329,173,407,234,-519,56,-575,17
"34180",NA,NA,"Moses Lake, WA","Micropolitan Statistical Area",2007,82361,1516,948,1538,590,577,514,63,-9
"34180",NA,53025,"Grant County, WA","County or equivalent",2007,82361,1516,948,1538,590,577,514,63,-9
"34220",NA,NA,"Moultrie, GA","Micropolitan Statistical Area",2007,44658,580,295,732,437,289,161,128,-4
"34220",NA,13071,"Colquitt County, GA","County or equivalent",2007,44658,580,295,732,437,289,161,128,-4
"34260",NA,NA,"Mountain Home, AR","Micropolitan Statistical Area",2007,41872,773,-235,407,642,1007,0,1007,1
"34260",NA,5005,"Baxter County, AR","County or equivalent",2007,41872,773,-235,407,642,1007,0,1007,1
"34300",NA,NA,"Mountain Home, ID","Micropolitan Statistical Area",2007,28864,544,377,544,167,176,13,163,-9
"34300",NA,16039,"Elmore County, ID","County or equivalent",2007,28864,544,377,544,167,176,13,163,-9
"34340",NA,NA,"Mount Airy, NC","Micropolitan Statistical Area",2007,72172,193,146,954,808,39,163,-124,8
"34340",NA,37171,"Surry County, NC","County or equivalent",2007,72172,193,146,954,808,39,163,-124,8
"34380",NA,NA,"Mount Pleasant, MI","Micropolitan Statistical Area",2007,66790,93,353,760,407,-270,69,-339,10
"34380",NA,26073,"Isabella County, MI","County or equivalent",2007,66790,93,353,760,407,-270,69,-339,10
"34420",NA,NA,"Mount Pleasant, TX","Micropolitan Statistical Area",2007,29211,586,391,615,224,194,172,22,1
"34420",NA,48449,"Titus County, TX","County or equivalent",2007,29211,586,391,615,224,194,172,22,1
"34460",NA,NA,"Mount Sterling, KY","Micropolitan Statistical Area",2007,43531,365,191,646,455,187,1,186,-13
"34460",NA,21011,"Bath County, KY","County or equivalent",2007,11574,-61,19,154,135,-80,-1,-79,0
"34460",NA,21165,"Menifee County, KY","County or equivalent",2007,6745,-4,5,74,69,-8,-1,-7,-1
"34460",NA,21173,"Montgomery County, KY","County or equivalent",2007,25212,430,167,418,251,275,3,272,-12
"34500",NA,NA,"Mount Vernon, IL","Micropolitan Statistical Area",2007,48310,-117,59,570,511,-192,8,-200,16
"34500",NA,17065,"Hamilton County, IL","County or equivalent",2007,8224,-74,-11,85,96,-68,1,-69,5
"34500",NA,17081,"Jefferson County, IL","County or equivalent",2007,40086,-43,70,485,415,-124,7,-131,11
"34540",NA,NA,"Mount Vernon, OH","Micropolitan Statistical Area",2007,58890,522,197,772,575,319,6,313,6
"34540",NA,39083,"Knox County, OH","County or equivalent",2007,58890,522,197,772,575,319,6,313,6
"34660",NA,NA,"Murray, KY","Micropolitan Statistical Area",2007,36116,167,34,389,355,134,53,81,-1
"34660",NA,21035,"Calloway County, KY","County or equivalent",2007,36116,167,34,389,355,134,53,81,-1
"34700",NA,NA,"Muscatine, IA","Micropolitan Statistical Area",2007,54103,147,338,791,453,-174,78,-252,-17
"34700",NA,19115,"Louisa County, IA","County or equivalent",2007,11768,2,29,150,121,-20,20,-40,-7
"34700",NA,19139,"Muscatine County, IA","County or equivalent",2007,42335,145,309,641,332,-154,58,-212,-10
"34780",NA,NA,"Muskogee, OK","Micropolitan Statistical Area",2007,71012,401,261,1085,824,161,53,108,-21
"34780",NA,40101,"Muskogee County, OK","County or equivalent",2007,71012,401,261,1085,824,161,53,108,-21
"34860",NA,NA,"Nacogdoches, TX","Micropolitan Statistical Area",2007,62221,597,486,1022,536,108,153,-45,3
"34860",NA,48347,"Nacogdoches County, TX","County or equivalent",2007,62221,597,486,1022,536,108,153,-45,3
"35020",NA,NA,"Natchez, MS-LA","Micropolitan Statistical Area",2007,50719,-636,111,744,633,-758,5,-763,11
"35020",NA,22029,"Concordia Parish, LA","County or equivalent",2007,19047,-146,63,294,231,-214,0,-214,5
"35020",NA,28001,"Adams County, MS","County or equivalent",2007,31672,-490,48,450,402,-544,5,-549,6
"35060",NA,NA,"Natchitoches, LA","Micropolitan Statistical Area",2007,39487,75,220,601,381,-154,22,-176,9
"35060",NA,22069,"Natchitoches Parish, LA","County or equivalent",2007,39487,75,220,601,381,-154,22,-176,9
"35100",NA,NA,"New Bern, NC","Micropolitan Statistical Area",2007,118893,245,694,1837,1143,-468,-43,-425,19
"35100",NA,37049,"Craven County, NC","County or equivalent",2007,96302,195,723,1631,908,-547,-52,-495,19
"35100",NA,37103,"Jones County, NC","County or equivalent",2007,10088,76,-7,97,104,80,6,74,3
"35100",NA,37137,"Pamlico County, NC","County or equivalent",2007,12503,-26,-22,109,131,-1,3,-4,-3
"35140",NA,NA,"Newberry, SC","Micropolitan Statistical Area",2007,37599,301,137,546,409,165,85,80,-1
"35140",NA,45071,"Newberry County, SC","County or equivalent",2007,37599,301,137,546,409,165,85,80,-1
"35220",NA,NA,"New Castle, IN","Micropolitan Statistical Area",2007,46991,-439,-59,499,558,-387,1,-388,7
"35220",NA,18065,"Henry County, IN","County or equivalent",2007,46991,-439,-59,499,558,-387,1,-388,7
"35260",NA,NA,"New Castle, PA","Micropolitan Statistical Area",2007,90716,-530,-131,971,1102,-403,12,-415,4
"35260",NA,42073,"Lawrence County, PA","County or equivalent",2007,90716,-530,-131,971,1102,-403,12,-415,4
"35340",NA,NA,"New Iberia, LA","Micropolitan Statistical Area",2007,74943,328,506,1211,705,-171,29,-200,-7
"35340",NA,22045,"Iberia Parish, LA","County or equivalent",2007,74943,328,506,1211,705,-171,29,-200,-7
"35420",NA,NA,"New Philadelphia-Dover, OH","Micropolitan Statistical Area",2007,91263,178,260,1202,942,-105,20,-125,23
"35420",NA,39157,"Tuscarawas County, OH","County or equivalent",2007,91263,178,260,1202,942,-105,20,-125,23
"35460",NA,NA,"Newport, TN","Micropolitan Statistical Area",2007,35317,314,7,439,432,317,6,311,-10
"35460",NA,47029,"Cocke County, TN","County or equivalent",2007,35317,314,7,439,432,317,6,311,-10
"35500",NA,NA,"Newton, IA","Micropolitan Statistical Area",2007,36647,-169,69,414,345,-227,17,-244,-11
"35500",NA,19099,"Jasper County, IA","County or equivalent",2007,36647,-169,69,414,345,-227,17,-244,-11
"35580",NA,NA,"New Ulm, MN","Micropolitan Statistical Area",2007,25967,-102,54,326,272,-157,4,-161,1
"35580",NA,27015,"Brown County, MN","County or equivalent",2007,25967,-102,54,326,272,-157,4,-161,1
"35700",NA,NA,"Nogales, AZ","Micropolitan Statistical Area",2007,42475,637,508,757,249,133,204,-71,-4
"35700",NA,4023,"Santa Cruz County, AZ","County or equivalent",2007,42475,637,508,757,249,133,204,-71,-4
"35740",NA,NA,"Norfolk, NE","Micropolitan Statistical Area",2007,47684,-1303,233,695,462,-1570,59,-1629,34
"35740",NA,31119,"Madison County, NE","County or equivalent",2007,34040,-1128,181,528,347,-1336,52,-1388,27
"35740",NA,31139,"Pierce County, NE","County or equivalent",2007,7261,-105,10,77,67,-120,2,-122,5
"35740",NA,31167,"Stanton County, NE","County or equivalent",2007,6383,-70,42,90,48,-114,5,-119,2
"35820",NA,NA,"North Platte, NE","Micropolitan Statistical Area",2007,36685,12,187,547,360,-174,17,-191,-1
"35820",NA,31111,"Lincoln County, NE","County or equivalent",2007,35435,-8,171,527,356,-178,15,-193,-1
"35820",NA,31113,"Logan County, NE","County or equivalent",2007,746,-1,12,13,1,-14,1,-15,1
"35820",NA,31117,"McPherson County, NE","County or equivalent",2007,504,21,4,7,3,18,1,17,-1
"35860",NA,NA,"North Vernon, IN","Micropolitan Statistical Area",2007,28077,146,153,408,255,-9,6,-15,2
"35860",NA,18079,"Jennings County, IN","County or equivalent",2007,28077,146,153,408,255,-9,6,-15,2
"35900",NA,NA,"North Wilkesboro, NC","Micropolitan Statistical Area",2007,66695,225,183,836,653,75,130,-55,-33
"35900",NA,37193,"Wilkes County, NC","County or equivalent",2007,66695,225,183,836,653,75,130,-55,-33
"35940",NA,NA,"Norwalk, OH","Micropolitan Statistical Area",2007,59715,-72,334,864,530,-400,43,-443,-6
"35940",NA,39077,"Huron County, OH","County or equivalent",2007,59715,-72,334,864,530,-400,43,-443,-6
"36020",NA,NA,"Oak Harbor, WA","Micropolitan Statistical Area",2007,80975,228,260,936,676,180,-53,233,-212
"36020",NA,53029,"Island County, WA","County or equivalent",2007,80975,228,260,936,676,180,-53,233,-212
"36060",NA,NA,"Oak Hill, WV","Micropolitan Statistical Area",2007,46275,-22,-5,567,572,-13,8,-21,-4
"36060",NA,54019,"Fayette County, WV","County or equivalent",2007,46275,-22,-5,567,572,-13,8,-21,-4
"36180",NA,NA,"Ocean Pines, MD","Micropolitan Statistical Area",2007,49270,201,-69,502,571,279,46,233,-9
"36180",NA,24047,"Worcester County, MD","County or equivalent",2007,49270,201,-69,502,571,279,46,233,-9
"36300",NA,NA,"Ogdensburg-Massena, NY","Micropolitan Statistical Area",2007,109772,-134,217,1279,1062,-352,60,-412,1
"36300",NA,36089,"St. Lawrence County, NY","County or equivalent",2007,109772,-134,217,1279,1062,-352,60,-412,1
"36340",NA,NA,"Oil City, PA","Micropolitan Statistical Area",2007,54755,-388,1,643,642,-378,7,-385,-11
"36340",NA,42121,"Venango County, PA","County or equivalent",2007,54755,-388,1,643,642,-378,7,-385,-11
"36380",NA,NA,"Okeechobee, FL","Micropolitan Statistical Area",2007,40093,250,170,603,433,77,151,-74,3
"36380",NA,12093,"Okeechobee County, FL","County or equivalent",2007,40093,250,170,603,433,77,151,-74,3
"36460",NA,NA,"Olean, NY","Micropolitan Statistical Area",2007,80183,-479,205,1043,838,-684,8,-692,0
"36460",NA,36009,"Cattaraugus County, NY","County or equivalent",2007,80183,-479,205,1043,838,-684,8,-692,0
"36580",NA,NA,"Oneonta, NY","Micropolitan Statistical Area",2007,62235,-110,-23,580,603,-93,11,-104,6
"36580",NA,36077,"Otsego County, NY","County or equivalent",2007,62235,-110,-23,580,603,-93,11,-104,6
"36620",NA,NA,"Ontario, OR-ID","Micropolitan Statistical Area",2007,53702,733,377,799,422,363,91,272,-7
"36620",NA,16075,"Payette County, ID","County or equivalent",2007,22689,598,155,342,187,441,13,428,2
"36620",NA,41045,"Malheur County, OR","County or equivalent",2007,31013,135,222,457,235,-78,78,-156,-9
"36660",NA,NA,"Opelousas-Eunice, LA","Micropolitan Statistical Area",2007,91365,626,508,1446,938,114,11,103,4
"36660",NA,22097,"St. Landry Parish, LA","County or equivalent",2007,91365,626,508,1446,938,114,11,103,4
"36700",NA,NA,"Orangeburg, SC","Micropolitan Statistical Area",2007,90357,631,313,1341,1028,297,18,279,21
"36700",NA,45075,"Orangeburg County, SC","County or equivalent",2007,90357,631,313,1341,1028,297,18,279,21
"36820",NA,NA,"Oskaloosa, IA","Micropolitan Statistical Area",2007,22253,100,98,313,215,0,18,-18,2
"36820",NA,19123,"Mahaska County, IA","County or equivalent",2007,22253,100,98,313,215,0,18,-18,2
"36860",NA,NA,"Ottawa-Streator, IL","Micropolitan Statistical Area",2007,152997,521,198,1904,1706,281,83,198,42
"36860",NA,17011,"Bureau County, IL","County or equivalent",2007,34922,-10,12,403,391,-32,10,-42,10
"36860",NA,17099,"LaSalle County, IL","County or equivalent",2007,112068,443,179,1443,1264,234,71,163,30
"36860",NA,17155,"Putnam County, IL","County or equivalent",2007,6007,88,7,58,51,79,2,77,2
"36900",NA,NA,"Ottumwa, IA","Micropolitan Statistical Area",2007,35459,-259,129,508,379,-409,28,-437,21
"36900",NA,19179,"Wapello County, IA","County or equivalent",2007,35459,-259,129,508,379,-409,28,-437,21
"36940",NA,NA,"Owatonna, MN","Micropolitan Statistical Area",2007,36229,287,243,535,292,45,69,-24,-1
"36940",NA,27147,"Steele County, MN","County or equivalent",2007,36229,287,243,535,292,45,69,-24,-1
"37020",NA,NA,"Owosso, MI","Micropolitan Statistical Area",2007,71662,-482,298,873,575,-787,5,-792,7
"37020",NA,26155,"Shiawassee County, MI","County or equivalent",2007,71662,-482,298,873,575,-787,5,-792,7
"37060",NA,NA,"Oxford, MS","Micropolitan Statistical Area",2007,43153,437,210,546,336,239,46,193,-12
"37060",NA,28071,"Lafayette County, MS","County or equivalent",2007,43153,437,210,546,336,239,46,193,-12
"37140",NA,NA,"Paducah, KY-IL","Micropolitan Statistical Area",2007,97642,229,13,1189,1176,209,11,198,7
"37140",NA,17127,"Massac County, IL","County or equivalent",2007,15078,-10,-3,196,199,-11,1,-12,4
"37140",NA,21007,"Ballard County, KY","County or equivalent",2007,8239,31,-35,75,110,71,2,69,-5
"37140",NA,21139,"Livingston County, KY","County or equivalent",2007,9618,-28,-14,106,120,-13,0,-13,-1
"37140",NA,21145,"McCracken County, KY","County or equivalent",2007,64707,236,65,812,747,162,8,154,9
"37220",NA,NA,"Pahrump, NV","Micropolitan Statistical Area",2007,44022,1753,-108,459,567,1850,40,1810,11
"37220",NA,32023,"Nye County, NV","County or equivalent",2007,44022,1753,-108,459,567,1850,40,1810,11
"37260",NA,NA,"Palatka, FL","Micropolitan Statistical Area",2007,73658,344,169,1091,922,159,63,96,16
"37260",NA,12107,"Putnam County, FL","County or equivalent",2007,73658,344,169,1091,922,159,63,96,16
"37300",NA,NA,"Palestine, TX","Micropolitan Statistical Area",2007,56716,362,108,677,569,271,43,228,-17
"37300",NA,48001,"Anderson County, TX","County or equivalent",2007,56716,362,108,677,569,271,43,228,-17
"37420",NA,NA,"Pampa, TX","Micropolitan Statistical Area",2007,22831,321,75,336,261,247,38,209,-1
"37420",NA,48179,"Gray County, TX","County or equivalent",2007,21996,291,65,321,256,226,37,189,0
"37420",NA,48393,"Roberts County, TX","County or equivalent",2007,835,30,10,15,5,21,1,20,-1
"37500",NA,NA,"Paragould, AR","Micropolitan Statistical Area",2007,40352,460,162,565,403,284,8,276,14
"37500",NA,5055,"Greene County, AR","County or equivalent",2007,40352,460,162,565,403,284,8,276,14
"37540",NA,NA,"Paris, TN","Micropolitan Statistical Area",2007,31575,89,-97,354,451,180,8,172,6
"37540",NA,47079,"Henry County, TN","County or equivalent",2007,31575,89,-97,354,451,180,8,172,6
"37580",NA,NA,"Paris, TX","Micropolitan Statistical Area",2007,49090,36,74,638,564,-49,49,-98,11
"37580",NA,48277,"Lamar County, TX","County or equivalent",2007,49090,36,74,638,564,-49,49,-98,11
"37660",NA,NA,"Parsons, KS","Micropolitan Statistical Area",2007,21984,27,64,333,269,-41,2,-43,4
"37660",NA,20099,"Labette County, KS","County or equivalent",2007,21984,27,64,333,269,-41,2,-43,4
"37740",NA,NA,"Payson, AZ","Micropolitan Statistical Area",2007,51937,502,97,680,583,414,36,378,-9
"37740",NA,4007,"Gila County, AZ","County or equivalent",2007,51937,502,97,680,583,414,36,378,-9
"37780",NA,NA,"Pecos, TX","Micropolitan Statistical Area",2007,11169,49,100,185,85,-35,20,-55,-16
"37780",NA,48389,"Reeves County, TX","County or equivalent",2007,11169,49,100,185,85,-35,20,-55,-16
"37800",NA,NA,"Pella, IA","Micropolitan Statistical Area",2007,32489,-239,145,447,302,-360,7,-367,-24
"37800",NA,19125,"Marion County, IA","County or equivalent",2007,32489,-239,145,447,302,-360,7,-367,-24
"37820",NA,NA,"Pendleton-Hermiston, OR","Micropolitan Statistical Area",2007,84357,52,749,1249,500,-683,178,-861,-14
"37820",NA,41049,"Morrow County, OR","County or equivalent",2007,11120,-191,101,154,53,-292,34,-326,0
"37820",NA,41059,"Umatilla County, OR","County or equivalent",2007,73237,243,648,1095,447,-391,144,-535,-14
"37940",NA,NA,"Peru, IN","Micropolitan Statistical Area",2007,36642,-290,85,432,347,-378,3,-381,3
"37940",NA,18103,"Miami County, IN","County or equivalent",2007,36642,-290,85,432,347,-378,3,-381,3
"38020",NA,NA,"Phoenix Lake-Cedar Ridge, CA","Micropolitan Statistical Area",2007,55727,-377,-110,493,603,-251,13,-264,-16
"38020",NA,6109,"Tuolumne County, CA","County or equivalent",2007,55727,-377,-110,493,603,-251,13,-264,-16
"38100",NA,NA,"Picayune, MS","Micropolitan Statistical Area",2007,57007,770,276,824,548,554,6,548,-60
"38100",NA,28109,"Pearl River County, MS","County or equivalent",2007,57007,770,276,824,548,554,6,548,-60
"38180",NA,NA,"Pierre, SD","Micropolitan Statistical Area",2007,19650,147,137,291,154,17,11,6,-7
"38180",NA,46065,"Hughes County, SD","County or equivalent",2007,16877,124,107,249,142,18,10,8,-1
"38180",NA,46117,"Stanley County, SD","County or equivalent",2007,2773,23,30,42,12,-1,1,-2,-6
"38200",NA,NA,"Pierre Part, LA","Micropolitan Statistical Area",2007,22958,-57,115,290,175,-155,4,-159,-17
"38200",NA,22007,"Assumption Parish, LA","County or equivalent",2007,22958,-57,115,290,175,-155,4,-159,-17
"38260",NA,NA,"Pittsburg, KS","Micropolitan Statistical Area",2007,38732,105,95,542,447,11,67,-56,-1
"38260",NA,20037,"Crawford County, KS","County or equivalent",2007,38732,105,95,542,447,11,67,-56,-1
"38380",NA,NA,"Plainview, TX","Micropolitan Statistical Area",2007,35573,-149,375,647,272,-519,66,-585,-5
"38380",NA,48189,"Hale County, TX","County or equivalent",2007,35573,-149,375,647,272,-519,66,-585,-5
"38420",NA,NA,"Platteville, WI","Micropolitan Statistical Area",2007,49124,391,73,603,530,311,7,304,7
"38420",NA,55043,"Grant County, WI","County or equivalent",2007,49124,391,73,603,530,311,7,304,7
"38460",NA,NA,"Plattsburgh, NY","Micropolitan Statistical Area",2007,82060,98,188,814,626,-98,41,-139,8
"38460",NA,36019,"Clinton County, NY","County or equivalent",2007,82060,98,188,814,626,-98,41,-139,8
"38500",NA,NA,"Plymouth, IN","Micropolitan Statistical Area",2007,46546,-27,240,640,400,-279,110,-389,12
"38500",NA,18099,"Marshall County, IN","County or equivalent",2007,46546,-27,240,640,400,-279,110,-389,12
"38580",NA,NA,"Point Pleasant, WV-OH","Micropolitan Statistical Area",2007,56347,-38,42,697,655,-73,2,-75,-7
"38580",NA,39053,"Gallia County, OH","County or equivalent",2007,30816,-27,57,401,344,-85,2,-87,1
"38580",NA,54053,"Mason County, WV","County or equivalent",2007,25531,-11,-15,296,311,12,0,12,-8
"38620",NA,NA,"Ponca City, OK","Micropolitan Statistical Area",2007,45711,95,120,712,592,-19,38,-57,-6
"38620",NA,40071,"Kay County, OK","County or equivalent",2007,45711,95,120,712,592,-19,38,-57,-6
"38700",NA,NA,"Pontiac, IL","Micropolitan Statistical Area",2007,37838,-86,119,533,414,-193,11,-204,-12
"38700",NA,17105,"Livingston County, IL","County or equivalent",2007,37838,-86,119,533,414,-193,11,-204,-12
"38740",NA,NA,"Poplar Bluff, MO","Micropolitan Statistical Area",2007,41230,-163,83,594,511,-245,12,-257,-1
"38740",NA,29023,"Butler County, MO","County or equivalent",2007,41230,-163,83,594,511,-245,12,-257,-1
"38780",NA,NA,"Portales, NM","Micropolitan Statistical Area",2007,19126,248,208,358,150,42,13,29,-2
"38780",NA,35041,"Roosevelt County, NM","County or equivalent",2007,19126,248,208,358,150,42,13,29,-2
"38820",NA,NA,"Port Angeles, WA","Micropolitan Statistical Area",2007,70317,738,-191,669,860,941,43,898,-12
"38820",NA,53009,"Clallam County, WA","County or equivalent",2007,70317,738,-191,669,860,941,43,898,-12
"39020",NA,NA,"Portsmouth, OH","Micropolitan Statistical Area",2007,76449,272,111,1024,913,160,12,148,1
"39020",NA,39145,"Scioto County, OH","County or equivalent",2007,76449,272,111,1024,913,160,12,148,1
"39060",NA,NA,"Pottsville, PA","Micropolitan Statistical Area",2007,147115,164,-541,1455,1996,669,14,655,36
"39060",NA,42107,"Schuylkill County, PA","County or equivalent",2007,147115,164,-541,1455,1996,669,14,655,36
"39220",NA,NA,"Price, UT","Micropolitan Statistical Area",2007,19608,420,143,341,198,273,10,263,4
"39220",NA,49007,"Carbon County, UT","County or equivalent",2007,19608,420,143,341,198,273,10,263,4
"39260",NA,NA,"Prineville, OR","Micropolitan Statistical Area",2007,22857,358,71,268,197,278,19,259,9
"39260",NA,41013,"Crook County, OR","County or equivalent",2007,22857,358,71,268,197,278,19,259,9
"39420",NA,NA,"Pullman, WA","Micropolitan Statistical Area",2007,40766,-453,194,414,220,-664,175,-839,17
"39420",NA,53075,"Whitman County, WA","County or equivalent",2007,40766,-453,194,414,220,-664,175,-839,17
"39500",NA,NA,"Quincy, IL-MO","Micropolitan Statistical Area",2007,76807,-196,56,980,924,-262,15,-277,10
"39500",NA,17001,"Adams County, IL","County or equivalent",2007,66776,-148,50,857,807,-210,14,-224,12
"39500",NA,29111,"Lewis County, MO","County or equivalent",2007,10031,-48,6,123,117,-52,1,-53,-2
"39700",NA,NA,"Raymondville, TX","Micropolitan Statistical Area",2007,20437,19,279,402,123,-264,34,-298,4
"39700",NA,48489,"Willacy County, TX","County or equivalent",2007,20437,19,279,402,123,-264,34,-298,4
"39780",NA,NA,"Red Bluff, CA","Micropolitan Statistical Area",2007,60956,548,264,855,591,294,67,227,-10
"39780",NA,6103,"Tehama County, CA","County or equivalent",2007,60956,548,264,855,591,294,67,227,-10
"39860",NA,NA,"Red Wing, MN","Micropolitan Statistical Area",2007,45733,307,167,597,430,135,12,123,5
"39860",NA,27049,"Goodhue County, MN","County or equivalent",2007,45733,307,167,597,430,135,12,123,5
"39940",NA,NA,"Rexburg, ID","Micropolitan Statistical Area",2007,49475,597,971,1172,201,-363,51,-414,-11
"39940",NA,16043,"Fremont County, ID","County or equivalent",2007,12501,119,159,230,71,-25,26,-51,-15
"39940",NA,16065,"Madison County, ID","County or equivalent",2007,36974,478,812,942,130,-338,25,-363,4
"39980",NA,NA,"Richmond, IN","Micropolitan Statistical Area",2007,68136,-379,70,875,805,-477,37,-514,28
"39980",NA,18177,"Wayne County, IN","County or equivalent",2007,68136,-379,70,875,805,-477,37,-514,28
"40080",NA,NA,"Richmond-Berea, KY","Micropolitan Statistical Area",2007,97669,901,437,1260,823,485,40,445,-21
"40080",NA,21151,"Madison County, KY","County or equivalent",2007,81011,825,439,1069,630,407,41,366,-21
"40080",NA,21203,"Rockcastle County, KY","County or equivalent",2007,16658,76,-2,191,193,78,-1,79,0
"40100",NA,NA,"Rio Grande City-Roma, TX","Micropolitan Statistical Area",2007,61335,898,1133,1464,331,-218,369,-587,-17
"40100",NA,48427,"Starr County, TX","County or equivalent",2007,61335,898,1133,1464,331,-218,369,-587,-17
"40180",NA,NA,"Riverton, WY","Micropolitan Statistical Area",2007,37461,691,254,642,388,427,4,423,10
"40180",NA,56013,"Fremont County, WY","County or equivalent",2007,37461,691,254,642,388,427,4,423,10
"40260",NA,NA,"Roanoke Rapids, NC","Micropolitan Statistical Area",2007,75728,-269,73,991,918,-338,26,-364,-4
"40260",NA,37083,"Halifax County, NC","County or equivalent",2007,54972,-197,76,729,653,-272,22,-294,-1
"40260",NA,37131,"Northampton County, NC","County or equivalent",2007,20756,-72,-3,262,265,-66,4,-70,-3
"40300",NA,NA,"Rochelle, IL","Micropolitan Statistical Area",2007,54894,342,182,656,474,152,81,71,8
"40300",NA,17141,"Ogle County, IL","County or equivalent",2007,54894,342,182,656,474,152,81,71,8
"40460",NA,NA,"Rockingham, NC","Micropolitan Statistical Area",2007,45923,109,188,699,511,-77,43,-120,-2
"40460",NA,37153,"Richmond County, NC","County or equivalent",2007,45923,109,188,699,511,-77,43,-120,-2
"40500",NA,NA,"Rockland, ME","Micropolitan Statistical Area",2007,40723,-82,-8,426,434,-90,8,-98,16
"40500",NA,23013,"Knox County, ME","County or equivalent",2007,40723,-82,-8,426,434,-90,8,-98,16
"40540",NA,NA,"Rock Springs, WY","Micropolitan Statistical Area",2007,39376,1375,486,729,243,885,13,872,4
"40540",NA,56037,"Sweetwater County, WY","County or equivalent",2007,39376,1375,486,729,243,885,13,872,4
"40620",NA,NA,"Rolla, MO","Micropolitan Statistical Area",2007,42443,43,162,563,401,-120,83,-203,1
"40620",NA,29161,"Phelps County, MO","County or equivalent",2007,42443,43,162,563,401,-120,83,-203,1
"40700",NA,NA,"Roseburg, OR","Micropolitan Statistical Area",2007,104000,223,21,1191,1170,204,25,179,-2
"40700",NA,41019,"Douglas County, OR","County or equivalent",2007,104000,223,21,1191,1170,204,25,179,-2
"40740",NA,NA,"Roswell, NM","Micropolitan Statistical Area",2007,62460,962,390,1012,622,552,119,433,20
"40740",NA,35005,"Chaves County, NM","County or equivalent",2007,62460,962,390,1012,622,552,119,433,20
"40760",NA,NA,"Ruidoso, NM","Micropolitan Statistical Area",2007,20702,-100,69,228,159,-149,24,-173,-20
"40760",NA,35027,"Lincoln County, NM","County or equivalent",2007,20702,-100,69,228,159,-149,24,-173,-20
"40780",NA,NA,"Russellville, AR","Micropolitan Statistical Area",2007,80901,941,527,1216,689,395,109,286,19
"40780",NA,5115,"Pope County, AR","County or equivalent",2007,59204,825,367,846,479,447,21,426,11
"40780",NA,5149,"Yell County, AR","County or equivalent",2007,21697,116,160,370,210,-52,88,-140,8
"40820",NA,NA,"Ruston, LA","Micropolitan Statistical Area",2007,57660,-153,254,762,508,-420,33,-453,13
"40820",NA,22049,"Jackson Parish, LA","County or equivalent",2007,15102,-137,27,199,172,-172,0,-172,8
"40820",NA,22061,"Lincoln Parish, LA","County or equivalent",2007,42558,-16,227,563,336,-248,33,-281,5
"40860",NA,NA,"Rutland, VT","Micropolitan Statistical Area",2007,63454,-80,-24,601,625,-51,5,-56,-5
"40860",NA,50021,"Rutland County, VT","County or equivalent",2007,63454,-80,-24,601,625,-51,5,-56,-5
"40940",NA,NA,"Safford, AZ","Micropolitan Statistical Area",2007,42716,1896,378,707,329,1503,16,1487,15
"40940",NA,4009,"Graham County, AZ","County or equivalent",2007,34977,1605,300,581,281,1280,10,1270,25
"40940",NA,4011,"Greenlee County, AZ","County or equivalent",2007,7739,291,78,126,48,223,6,217,-10
"41220",NA,NA,"St. Marys, GA","Micropolitan Statistical Area",2007,47109,1730,609,868,259,1110,-65,1175,11
"41220",NA,13039,"Camden County, GA","County or equivalent",2007,47109,1730,609,868,259,1110,-65,1175,11
"41260",NA,NA,"St. Marys, PA","Micropolitan Statistical Area",2007,32584,-250,-30,318,348,-201,5,-206,-19
"41260",NA,42047,"Elk County, PA","County or equivalent",2007,32584,-250,-30,318,348,-201,5,-206,-19
"41460",NA,NA,"Salina, KS","Micropolitan Statistical Area",2007,60465,374,278,892,614,114,65,49,-18
"41460",NA,20143,"Ottawa County, KS","County or equivalent",2007,6003,25,4,76,72,20,0,20,1
"41460",NA,20169,"Saline County, KS","County or equivalent",2007,54462,349,274,816,542,94,65,29,-19
"41580",NA,NA,"Salisbury, NC","Micropolitan Statistical Area",2007,137038,1857,472,1839,1367,1340,285,1055,45
"41580",NA,37159,"Rowan County, NC","County or equivalent",2007,137038,1857,472,1839,1367,1340,285,1055,45
"41820",NA,NA,"Sanford, NC","Micropolitan Statistical Area",2007,57815,1086,485,961,476,604,244,360,-3
"41820",NA,37105,"Lee County, NC","County or equivalent",2007,57815,1086,485,961,476,604,244,360,-3
"42300",NA,NA,"Sault Ste. Marie, MI","Micropolitan Statistical Area",2007,38930,301,97,408,311,199,10,189,5
"42300",NA,26033,"Chippewa County, MI","County or equivalent",2007,38930,301,97,408,311,199,10,189,5
"42380",NA,NA,"Sayre, PA","Micropolitan Statistical Area",2007,61414,-99,113,778,665,-236,4,-240,24
"42380",NA,42015,"Bradford County, PA","County or equivalent",2007,61414,-99,113,778,665,-236,4,-240,24
"42420",NA,NA,"Scottsbluff, NE","Micropolitan Statistical Area",2007,37032,137,90,545,455,50,42,8,-3
"42420",NA,31007,"Banner County, NE","County or equivalent",2007,732,-10,5,7,2,-16,1,-17,1
"42420",NA,31157,"Scotts Bluff County, NE","County or equivalent",2007,36300,147,85,538,453,66,41,25,-4
"42460",NA,NA,"Scottsboro, AL","Micropolitan Statistical Area",2007,52942,-61,-15,611,626,-47,7,-54,1
"42460",NA,1071,"Jackson County, AL","County or equivalent",2007,52942,-61,-15,611,626,-47,7,-54,1
"42500",NA,NA,"Scottsburg, IN","Micropolitan Statistical Area",2007,23694,63,43,312,269,23,1,22,-3
"42500",NA,18143,"Scott County, IN","County or equivalent",2007,23694,63,43,312,269,23,1,22,-3
"42580",NA,NA,"Seaford, DE","Micropolitan Statistical Area",2007,183840,4188,756,2491,1735,3323,240,3083,109
"42580",NA,10005,"Sussex County, DE","County or equivalent",2007,183840,4188,756,2491,1735,3323,240,3083,109
"42620",NA,NA,"Searcy, AR","Micropolitan Statistical Area",2007,73507,957,347,1049,702,620,38,582,-10
"42620",NA,5145,"White County, AR","County or equivalent",2007,73507,957,347,1049,702,620,38,582,-10
"42700",NA,NA,"Sebring, FL","Micropolitan Statistical Area",2007,99020,1733,-258,1131,1389,2024,328,1696,-33
"42700",NA,12055,"Highlands County, FL","County or equivalent",2007,99020,1733,-258,1131,1389,2024,328,1696,-33
"42740",NA,NA,"Sedalia, MO","Micropolitan Statistical Area",2007,40748,274,271,652,381,1,51,-50,2
"42740",NA,29159,"Pettis County, MO","County or equivalent",2007,40748,274,271,652,381,1,51,-50,2
"42780",NA,NA,"Selinsgrove, PA","Micropolitan Statistical Area",2007,38149,100,155,477,322,-19,2,-21,-36
"42780",NA,42109,"Snyder County, PA","County or equivalent",2007,38149,100,155,477,322,-19,2,-21,-36
"42820",NA,NA,"Selma, AL","Micropolitan Statistical Area",2007,42991,-219,101,667,566,-334,1,-335,14
"42820",NA,1047,"Dallas County, AL","County or equivalent",2007,42991,-219,101,667,566,-334,1,-335,14
"42860",NA,NA,"Seneca, SC","Micropolitan Statistical Area",2007,70660,783,156,892,736,593,56,537,34
"42860",NA,45073,"Oconee County, SC","County or equivalent",2007,70660,783,156,892,736,593,56,537,34
"42900",NA,NA,"Seneca Falls, NY","Micropolitan Statistical Area",2007,34241,61,35,370,335,38,17,21,-12
"42900",NA,36099,"Seneca County, NY","County or equivalent",2007,34241,61,35,370,335,38,17,21,-12
"42940",NA,NA,"Sevierville, TN","Micropolitan Statistical Area",2007,83513,1886,313,1072,759,1547,41,1506,26
"42940",NA,47155,"Sevier County, TN","County or equivalent",2007,83513,1886,313,1072,759,1547,41,1506,26
"42980",NA,NA,"Seymour, IN","Micropolitan Statistical Area",2007,42024,109,172,595,423,-56,69,-125,-7
"42980",NA,18071,"Jackson County, IN","County or equivalent",2007,42024,109,172,595,423,-56,69,-125,-7
"43060",NA,NA,"Shawnee, OK","Micropolitan Statistical Area",2007,69226,1063,313,968,655,721,17,704,29
"43060",NA,40125,"Pottawatomie County, OK","County or equivalent",2007,69226,1063,313,968,655,721,17,704,29
"43140",NA,NA,"Shelby, NC","Micropolitan Statistical Area",2007,98279,744,166,1220,1054,567,54,513,11
"43140",NA,37045,"Cleveland County, NC","County or equivalent",2007,98279,744,166,1220,1054,567,54,513,11
"43180",NA,NA,"Shelbyville, TN","Micropolitan Statistical Area",2007,43855,952,353,733,380,596,182,414,3
"43180",NA,47003,"Bedford County, TN","County or equivalent",2007,43855,952,353,733,380,596,182,414,3
"43220",NA,NA,"Shelton, WA","Micropolitan Statistical Area",2007,56859,1591,77,655,578,1479,38,1441,35
"43220",NA,53045,"Mason County, WA","County or equivalent",2007,56859,1591,77,655,578,1479,38,1441,35
"43260",NA,NA,"Sheridan, WY","Micropolitan Statistical Area",2007,28037,560,101,387,286,457,8,449,2
"43260",NA,56033,"Sheridan County, WY","County or equivalent",2007,28037,560,101,387,286,457,8,449,2
"43320",NA,NA,"Show Low, AZ","Micropolitan Statistical Area",2007,111079,2140,1177,1982,805,938,46,892,25
"43320",NA,4017,"Navajo County, AZ","County or equivalent",2007,111079,2140,1177,1982,805,938,46,892,25
"43380",NA,NA,"Sidney, OH","Micropolitan Statistical Area",2007,48748,197,286,704,418,-101,41,-142,12
"43380",NA,39149,"Shelby County, OH","County or equivalent",2007,48748,197,286,704,418,-101,41,-142,12
"43420",NA,NA,"Sierra Vista-Douglas, AZ","Micropolitan Statistical Area",2007,127931,1223,879,1851,972,320,163,157,24
"43420",NA,4003,"Cochise County, AZ","County or equivalent",2007,127931,1223,879,1851,972,320,163,157,24
"43460",NA,NA,"Sikeston, MO","Micropolitan Statistical Area",2007,40705,100,245,646,401,-154,9,-163,9
"43460",NA,29201,"Scott County, MO","County or equivalent",2007,40705,100,245,646,401,-154,9,-163,9
"43500",NA,NA,"Silver City, NM","Micropolitan Statistical Area",2007,29688,325,70,389,319,246,7,239,9
"43500",NA,35017,"Grant County, NM","County or equivalent",2007,29688,325,70,389,319,246,7,239,9
"43540",NA,NA,"Silverthorne, CO","Micropolitan Statistical Area",2007,26381,529,318,348,30,244,196,48,-33
"43540",NA,8117,"Summit County, CO","County or equivalent",2007,26381,529,318,348,30,244,196,48,-33
"43660",NA,NA,"Snyder, TX","Micropolitan Statistical Area",2007,15984,109,101,248,147,18,11,7,-10
"43660",NA,48415,"Scurry County, TX","County or equivalent",2007,15984,109,101,248,147,18,11,7,-10
"43700",NA,NA,"Somerset, KY","Micropolitan Statistical Area",2007,60060,601,99,779,680,494,11,483,8
"43700",NA,21199,"Pulaski County, KY","County or equivalent",2007,60060,601,99,779,680,494,11,483,8
"43740",NA,NA,"Somerset, PA","Micropolitan Statistical Area",2007,77860,-308,-229,726,955,-109,10,-119,30
"43740",NA,42111,"Somerset County, PA","County or equivalent",2007,77860,-308,-229,726,955,-109,10,-119,30
"43860",NA,NA,"Southern Pines-Pinehurst, NC","Micropolitan Statistical Area",2007,84209,1851,73,1016,943,1735,121,1614,43
"43860",NA,37125,"Moore County, NC","County or equivalent",2007,84209,1851,73,1016,943,1735,121,1614,43
"43940",NA,NA,"Spearfish, SD","Micropolitan Statistical Area",2007,23388,417,89,306,217,350,2,348,-22
"43940",NA,46081,"Lawrence County, SD","County or equivalent",2007,23388,417,89,306,217,350,2,348,-22
"43980",NA,NA,"Spencer, IA","Micropolitan Statistical Area",2007,16686,-47,15,202,187,-65,12,-77,3
"43980",NA,19041,"Clay County, IA","County or equivalent",2007,16686,-47,15,202,187,-65,12,-77,3
"44020",NA,NA,"Spirit Lake, IA","Micropolitan Statistical Area",2007,16669,1,-4,183,187,3,0,3,2
"44020",NA,19059,"Dickinson County, IA","County or equivalent",2007,16669,1,-4,183,187,3,0,3,2
"44260",NA,NA,"Starkville, MS","Micropolitan Statistical Area",2007,43958,743,327,610,283,407,93,314,9
"44260",NA,28105,"Oktibbeha County, MS","County or equivalent",2007,43958,743,327,610,283,407,93,314,9
"44340",NA,NA,"Statesboro, GA","Micropolitan Statistical Area",2007,66184,1518,393,837,444,1134,64,1070,-9
"44340",NA,13031,"Bulloch County, GA","County or equivalent",2007,66184,1518,393,837,444,1134,64,1070,-9
"44380",NA,NA,"Statesville-Mooresville, NC","Micropolitan Statistical Area",2007,151006,5116,793,2016,1223,4265,245,4020,58
"44380",NA,37097,"Iredell County, NC","County or equivalent",2007,151006,5116,793,2016,1223,4265,245,4020,58
"44420",NA,NA,"Staunton-Waynesboro, VA","Micropolitan Statistical Area",2007,116181,1392,233,1409,1176,1182,44,1138,-23
"44420",NA,51015,"Augusta County, VA","County or equivalent",2007,70823,754,230,842,612,522,26,496,2
"44420",NA,51790,"Staunton city, VA","County or equivalent",2007,23766,448,-31,280,311,487,3,484,-8
"44420",NA,51820,"Waynesboro city, VA","County or equivalent",2007,21592,190,34,287,253,173,15,158,-17
"44500",NA,NA,"Stephenville, TX","Micropolitan Statistical Area",2007,35587,296,222,531,309,78,68,10,-4
"44500",NA,48143,"Erath County, TX","County or equivalent",2007,35587,296,222,531,309,78,68,10,-4
"44540",NA,NA,"Sterling, CO","Micropolitan Statistical Area",2007,20990,63,60,250,190,-3,33,-36,6
"44540",NA,8075,"Logan County, CO","County or equivalent",2007,20990,63,60,250,190,-3,33,-36,6
"44580",NA,NA,"Sterling, IL","Micropolitan Statistical Area",2007,59026,-145,59,727,668,-221,35,-256,17
"44580",NA,17195,"Whiteside County, IL","County or equivalent",2007,59026,-145,59,727,668,-221,35,-256,17
"44620",NA,NA,"Stevens Point, WI","Micropolitan Statistical Area",2007,68318,489,337,787,450,169,35,134,-17
"44620",NA,55097,"Portage County, WI","County or equivalent",2007,68318,489,337,787,450,169,35,134,-17
"44660",NA,NA,"Stillwater, OK","Micropolitan Statistical Area",2007,77724,443,389,908,519,58,212,-154,-4
"44660",NA,40119,"Payne County, OK","County or equivalent",2007,77724,443,389,908,519,58,212,-154,-4
"44740",NA,NA,"Storm Lake, IA","Micropolitan Statistical Area",2007,19585,-70,93,273,180,-174,108,-282,11
"44740",NA,19021,"Buena Vista County, IA","County or equivalent",2007,19585,-70,93,273,180,-174,108,-282,11
"44780",NA,NA,"Sturgis, MI","Micropolitan Statistical Area",2007,62291,-9,347,913,566,-344,99,-443,-12
"44780",NA,26149,"St. Joseph County, MI","County or equivalent",2007,62291,-9,347,913,566,-344,99,-443,-12
"44860",NA,NA,"Sulphur Springs, TX","Micropolitan Statistical Area",2007,33699,404,160,496,336,266,48,218,-22
"44860",NA,48223,"Hopkins County, TX","County or equivalent",2007,33699,404,160,496,336,266,48,218,-22
"44900",NA,NA,"Summerville, GA","Micropolitan Statistical Area",2007,26804,710,50,335,285,656,19,637,4
"44900",NA,13055,"Chattooga County, GA","County or equivalent",2007,26804,710,50,335,285,656,19,637,4
"44980",NA,NA,"Sunbury, PA","Micropolitan Statistical Area",2007,90979,-47,-177,992,1169,100,17,83,30
"44980",NA,42097,"Northumberland County, PA","County or equivalent",2007,90979,-47,-177,992,1169,100,17,83,30
"45000",NA,NA,"Susanville, CA","Micropolitan Statistical Area",2007,34980,897,94,298,204,809,1,808,-6
"45000",NA,6035,"Lassen County, CA","County or equivalent",2007,34980,897,94,298,204,809,1,808,-6
"45020",NA,NA,"Sweetwater, TX","Micropolitan Statistical Area",2007,14550,1,45,219,174,-33,8,-41,-11
"45020",NA,48353,"Nolan County, TX","County or equivalent",2007,14550,1,45,219,174,-33,8,-41,-11
"45140",NA,NA,"Tahlequah, OK","Micropolitan Statistical Area",2007,45088,106,237,662,425,-124,70,-194,-7
"45140",NA,40021,"Cherokee County, OK","County or equivalent",2007,45088,106,237,662,425,-124,70,-194,-7
"45180",NA,NA,"Talladega-Sylacauga, AL","Micropolitan Statistical Area",2007,80177,105,109,1011,902,-17,15,-32,13
"45180",NA,1121,"Talladega County, AL","County or equivalent",2007,80177,105,109,1011,902,-17,15,-32,13
"45260",NA,NA,"Tallulah, LA","Micropolitan Statistical Area",2007,11814,-122,46,191,145,-173,1,-174,5
"45260",NA,22065,"Madison Parish, LA","County or equivalent",2007,11814,-122,46,191,145,-173,1,-174,5
"45340",NA,NA,"Taos, NM","Micropolitan Statistical Area",2007,31508,213,159,384,225,53,44,9,1
"45340",NA,35055,"Taos County, NM","County or equivalent",2007,31508,213,159,384,225,53,44,9,1
"45380",NA,NA,"Taylorville, IL","Micropolitan Statistical Area",2007,34563,-83,-11,407,418,-81,8,-89,9
"45380",NA,17021,"Christian County, IL","County or equivalent",2007,34563,-83,-11,407,418,-81,8,-89,9
"45540",NA,NA,"The Villages, FL","Micropolitan Statistical Area",2007,72089,4059,-207,604,811,4287,41,4246,-21
"45540",NA,12119,"Sumter County, FL","County or equivalent",2007,72089,4059,-207,604,811,4287,41,4246,-21
"45580",NA,NA,"Thomaston, GA","Micropolitan Statistical Area",2007,27581,102,25,356,331,73,33,40,4
"45580",NA,13293,"Upson County, GA","County or equivalent",2007,27581,102,25,356,331,73,33,40,4
"45620",NA,NA,"Thomasville, GA","Micropolitan Statistical Area",2007,45182,526,200,691,491,335,17,318,-9
"45620",NA,13275,"Thomas County, GA","County or equivalent",2007,45182,526,200,691,491,335,17,318,-9
"45640",NA,NA,"Thomasville-Lexington, NC","Micropolitan Statistical Area",2007,156074,1580,528,1974,1446,1038,306,732,14
"45640",NA,37057,"Davidson County, NC","County or equivalent",2007,156074,1580,528,1974,1446,1038,306,732,14
"45660",NA,NA,"Tiffin, OH","Micropolitan Statistical Area",2007,56688,-172,152,737,585,-336,15,-351,12
"45660",NA,39147,"Seneca County, OH","County or equivalent",2007,56688,-172,152,737,585,-336,15,-351,12
"45700",NA,NA,"Tifton, GA","Micropolitan Statistical Area",2007,41988,645,354,709,355,309,123,186,-18
"45700",NA,13277,"Tift County, GA","County or equivalent",2007,41988,645,354,709,355,309,123,186,-18
"45740",NA,NA,"Toccoa, GA","Micropolitan Statistical Area",2007,25221,54,73,382,309,-21,4,-25,2
"45740",NA,13257,"Stephens County, GA","County or equivalent",2007,25221,54,73,382,309,-21,4,-25,2
"45860",NA,NA,"Torrington, CT","Micropolitan Statistical Area",2007,187815,-266,243,1834,1591,-509,149,-658,0
"45860",NA,9005,"Litchfield County, CT","County or equivalent",2007,187815,-266,243,1834,1591,-509,149,-658,0
"45900",NA,NA,"Traverse City, MI","Micropolitan Statistical Area",2007,141825,777,454,1666,1212,328,50,278,-5
"45900",NA,26019,"Benzie County, MI","County or equivalent",2007,17481,-120,1,191,190,-110,1,-111,-11
"45900",NA,26055,"Grand Traverse County, MI","County or equivalent",2007,85401,993,385,1067,682,593,42,551,15
"45900",NA,26079,"Kalkaska County, MI","County or equivalent",2007,17114,-96,64,231,167,-149,1,-150,-11
"45900",NA,26089,"Leelanau County, MI","County or equivalent",2007,21829,0,4,177,173,-6,6,-12,2
"45980",NA,NA,"Troy, AL","Micropolitan Statistical Area",2007,30198,241,107,421,314,128,21,107,6
"45980",NA,1109,"Pike County, AL","County or equivalent",2007,30198,241,107,421,314,128,21,107,6
"46020",NA,NA,"Truckee-Grass Valley, CA","Micropolitan Statistical Area",2007,96853,139,-88,834,922,193,65,128,34
"46020",NA,6057,"Nevada County, CA","County or equivalent",2007,96853,139,-88,834,922,193,65,128,34
"46100",NA,NA,"Tullahoma, TN","Micropolitan Statistical Area",2007,98936,884,199,1226,1027,664,54,610,21
"46100",NA,47031,"Coffee County, TN","County or equivalent",2007,51734,414,128,721,593,276,44,232,10
"46100",NA,47051,"Franklin County, TN","County or equivalent",2007,41099,365,66,451,385,285,11,274,14
"46100",NA,47127,"Moore County, TN","County or equivalent",2007,6103,105,5,54,49,103,-1,104,-3
"46180",NA,NA,"Tupelo, MS","Micropolitan Statistical Area",2007,132060,1140,623,2102,1479,565,43,522,-48
"46180",NA,28057,"Itawamba County, MS","County or equivalent",2007,23032,46,63,303,240,-23,3,-26,6
"46180",NA,28081,"Lee County, MS","County or equivalent",2007,80209,887,296,1308,1012,641,27,614,-50
"46180",NA,28115,"Pontotoc County, MS","County or equivalent",2007,28819,207,264,491,227,-53,13,-66,-4
"46260",NA,NA,"Tuskegee, AL","Micropolitan Statistical Area",2007,22309,-238,-21,249,270,-227,13,-240,10
"46260",NA,1087,"Macon County, AL","County or equivalent",2007,22309,-238,-21,249,270,-227,13,-240,10
"46300",NA,NA,"Twin Falls, ID","Micropolitan Statistical Area",2007,92827,2171,776,1628,852,1457,210,1247,-62
"46300",NA,16053,"Jerome County, ID","County or equivalent",2007,19986,383,230,392,162,153,58,95,0
"46300",NA,16083,"Twin Falls County, ID","County or equivalent",2007,72841,1788,546,1236,690,1304,152,1152,-62
"46380",NA,NA,"Ukiah, CA","Micropolitan Statistical Area",2007,85960,-410,356,1144,788,-803,251,-1054,37
"46380",NA,6045,"Mendocino County, CA","County or equivalent",2007,85960,-410,356,1144,788,-803,251,-1054,37
"46420",NA,NA,"Union, SC","Micropolitan Statistical Area",2007,27789,-275,-68,329,397,-201,-1,-200,-6
"46420",NA,45087,"Union County, SC","County or equivalent",2007,27789,-275,-68,329,397,-201,-1,-200,-6
"46460",NA,NA,"Union City, TN-KY","Micropolitan Statistical Area",2007,38293,-132,-40,439,479,-79,21,-100,-13
"46460",NA,21075,"Fulton County, KY","County or equivalent",2007,6796,-60,-24,84,108,-35,0,-35,-1
"46460",NA,47131,"Obion County, TN","County or equivalent",2007,31497,-72,-16,355,371,-44,21,-65,-12
"46500",NA,NA,"Urbana, OH","Micropolitan Statistical Area",2007,39465,30,89,499,410,-57,1,-58,-2
"46500",NA,39021,"Champaign County, OH","County or equivalent",2007,39465,30,89,499,410,-57,1,-58,-2
"46620",NA,NA,"Uvalde, TX","Micropolitan Statistical Area",2007,26474,-46,254,461,207,-300,36,-336,0
"46620",NA,48463,"Uvalde County, TX","County or equivalent",2007,26474,-46,254,461,207,-300,36,-336,0
"46740",NA,NA,"Valley, AL","Micropolitan Statistical Area",2007,34713,-54,-31,414,445,-28,15,-43,5
"46740",NA,1017,"Chambers County, AL","County or equivalent",2007,34713,-54,-31,414,445,-28,15,-43,5
"46780",NA,NA,"Van Wert, OH","Micropolitan Statistical Area",2007,28872,-189,76,403,327,-279,5,-284,14
"46780",NA,39161,"Van Wert County, OH","County or equivalent",2007,28872,-189,76,403,327,-279,5,-284,14
"46820",NA,NA,"Vermillion, SD","Micropolitan Statistical Area",2007,13458,146,77,160,83,69,11,58,0
"46820",NA,46027,"Clay County, SD","County or equivalent",2007,13458,146,77,160,83,69,11,58,0
"46860",NA,NA,"Vernal, UT","Micropolitan Statistical Area",2007,28978,1160,425,622,197,735,7,728,0
"46860",NA,49047,"Uintah County, UT","County or equivalent",2007,28978,1160,425,622,197,735,7,728,0
"46900",NA,NA,"Vernon, TX","Micropolitan Statistical Area",2007,13858,-93,30,209,179,-121,13,-134,-2
"46900",NA,48487,"Wilbarger County, TX","County or equivalent",2007,13858,-93,30,209,179,-121,13,-134,-2
"46980",NA,NA,"Vicksburg, MS","Micropolitan Statistical Area",2007,48771,-291,329,823,494,-630,15,-645,10
"46980",NA,28149,"Warren County, MS","County or equivalent",2007,48771,-291,329,823,494,-630,15,-645,10
"47080",NA,NA,"Vidalia, GA","Micropolitan Statistical Area",2007,36739,521,290,618,328,245,89,156,-14
"47080",NA,13209,"Montgomery County, GA","County or equivalent",2007,8993,-9,66,122,56,-71,10,-81,-4
"47080",NA,13279,"Toombs County, GA","County or equivalent",2007,27746,530,224,496,272,316,79,237,-10
"47180",NA,NA,"Vincennes, IN","Micropolitan Statistical Area",2007,37982,-56,29,498,469,-91,28,-119,6
"47180",NA,18083,"Knox County, IN","County or equivalent",2007,37982,-56,29,498,469,-91,28,-119,6
"47340",NA,NA,"Wabash, IN","Micropolitan Statistical Area",2007,32872,-362,-33,371,404,-347,0,-347,18
"47340",NA,18169,"Wabash County, IN","County or equivalent",2007,32872,-362,-33,371,404,-347,0,-347,18
"47420",NA,NA,"Wahpeton, ND-MN","Micropolitan Statistical Area",2007,22899,-330,80,258,178,-389,4,-393,-21
"47420",NA,27167,"Wilkin County, MN","County or equivalent",2007,6409,-64,22,77,55,-73,0,-73,-13
"47420",NA,38077,"Richland County, ND","County or equivalent",2007,16490,-266,58,181,123,-316,4,-320,-8
"47460",NA,NA,"Walla Walla, WA","Micropolitan Statistical Area",2007,57129,206,199,735,536,-3,130,-133,10
"47460",NA,53071,"Walla Walla County, WA","County or equivalent",2007,57129,206,199,735,536,-3,130,-133,10
"47500",NA,NA,"Walterboro, SC","Micropolitan Statistical Area",2007,38916,72,141,570,429,-75,17,-92,6
"47500",NA,45029,"Colleton County, SC","County or equivalent",2007,38916,72,141,570,429,-75,17,-92,6
"47540",NA,NA,"Wapakoneta, OH","Micropolitan Statistical Area",2007,46376,-16,156,654,498,-182,17,-199,10
"47540",NA,39011,"Auglaize County, OH","County or equivalent",2007,46376,-16,156,654,498,-182,17,-199,10
"47620",NA,NA,"Warren, PA","Micropolitan Statistical Area",2007,40964,-171,-71,408,479,-107,2,-109,7
"47620",NA,42123,"Warren County, PA","County or equivalent",2007,40964,-171,-71,408,479,-107,2,-109,7
"47660",NA,NA,"Warrensburg, MO","Micropolitan Statistical Area",2007,51898,299,453,808,355,-149,32,-181,-5
"47660",NA,29101,"Johnson County, MO","County or equivalent",2007,51898,299,453,808,355,-149,32,-181,-5
"47700",NA,NA,"Warsaw, IN","Micropolitan Statistical Area",2007,76073,343,544,1137,593,-180,92,-272,-21
"47700",NA,18085,"Kosciusko County, IN","County or equivalent",2007,76073,343,544,1137,593,-180,92,-272,-21
"47780",NA,NA,"Washington, IN","Micropolitan Statistical Area",2007,29974,149,212,515,303,-59,37,-96,-4
"47780",NA,18027,"Daviess County, IN","County or equivalent",2007,29974,149,212,515,303,-59,37,-96,-4
"47820",NA,NA,"Washington, NC","Micropolitan Statistical Area",2007,45636,-76,57,582,525,-144,50,-194,11
"47820",NA,37013,"Beaufort County, NC","County or equivalent",2007,45636,-76,57,582,525,-144,50,-194,11
"47920",NA,NA,"Washington Court House, OH","Micropolitan Statistical Area",2007,28296,83,66,401,335,17,9,8,0
"47920",NA,39047,"Fayette County, OH","County or equivalent",2007,28296,83,66,401,335,17,9,8,0
"47980",NA,NA,"Watertown, SD","Micropolitan Statistical Area",2007,31954,291,227,535,308,66,9,57,-2
"47980",NA,46029,"Codington County, SD","County or equivalent",2007,26344,206,203,438,235,5,9,-4,-2
"47980",NA,46057,"Hamlin County, SD","County or equivalent",2007,5610,85,24,97,73,61,0,61,0
"48020",NA,NA,"Watertown-Fort Atkinson, WI","Micropolitan Statistical Area",2007,80074,748,476,1050,574,272,67,205,0
"48020",NA,55055,"Jefferson County, WI","County or equivalent",2007,80074,748,476,1050,574,272,67,205,0
"48060",NA,NA,"Watertown-Fort Drum, NY","Micropolitan Statistical Area",2007,117926,764,931,1807,876,-132,-89,-43,-35
"48060",NA,36045,"Jefferson County, NY","County or equivalent",2007,117926,764,931,1807,876,-132,-89,-43,-35
"48100",NA,NA,"Wauchula, FL","Micropolitan Statistical Area",2007,28627,530,345,520,175,209,185,24,-24
"48100",NA,12049,"Hardee County, FL","County or equivalent",2007,28627,530,345,520,175,209,185,24,-24
"48180",NA,NA,"Waycross, GA","Micropolitan Statistical Area",2007,53646,792,190,832,642,616,59,557,-14
"48180",NA,13229,"Pierce County, GA","County or equivalent",2007,17831,437,118,302,184,321,11,310,-2
"48180",NA,13299,"Ware County, GA","County or equivalent",2007,35815,355,72,530,458,295,48,247,-12
"48460",NA,NA,"West Plains, MO","Micropolitan Statistical Area",2007,38604,289,103,577,474,175,19,156,11
"48460",NA,29091,"Howell County, MO","County or equivalent",2007,38604,289,103,577,474,175,19,156,11
"48500",NA,NA,"West Point, MS","Micropolitan Statistical Area",2007,20963,-82,99,312,213,-187,4,-191,6
"48500",NA,28025,"Clay County, MS","County or equivalent",2007,20963,-82,99,312,213,-187,4,-191,6
"48580",NA,NA,"Whitewater, WI","Micropolitan Statistical Area",2007,100299,297,448,1280,832,-162,141,-303,11
"48580",NA,55127,"Walworth County, WI","County or equivalent",2007,100299,297,448,1280,832,-162,141,-303,11
"48740",NA,NA,"Willimantic, CT","Micropolitan Statistical Area",2007,116845,585,480,1316,836,85,215,-130,20
"48740",NA,9015,"Windham County, CT","County or equivalent",2007,116845,585,480,1316,836,85,215,-130,20
"48780",NA,NA,"Williston, ND","Micropolitan Statistical Area",2007,19559,315,89,277,188,225,3,222,1
"48780",NA,38105,"Williams County, ND","County or equivalent",2007,19559,315,89,277,188,225,3,222,1
"48820",NA,NA,"Willmar, MN","Micropolitan Statistical Area",2007,40630,-109,262,621,359,-362,34,-396,-9
"48820",NA,27067,"Kandiyohi County, MN","County or equivalent",2007,40630,-109,262,621,359,-362,34,-396,-9
"48940",NA,NA,"Wilmington, OH","Micropolitan Statistical Area",2007,42962,134,192,587,395,-63,31,-94,5
"48940",NA,39027,"Clinton County, OH","County or equivalent",2007,42962,134,192,587,395,-63,31,-94,5
"48980",NA,NA,"Wilson, NC","Micropolitan Statistical Area",2007,76532,873,330,1125,795,554,196,358,-11
"48980",NA,37195,"Wilson County, NC","County or equivalent",2007,76532,873,330,1125,795,554,196,358,-11
"49060",NA,NA,"Winfield, KS","Micropolitan Statistical Area",2007,34208,48,85,457,372,-1,19,-20,-36
"49060",NA,20035,"Cowley County, KS","County or equivalent",2007,34208,48,85,457,372,-1,19,-20,-36
"49100",NA,NA,"Winona, MN","Micropolitan Statistical Area",2007,49848,226,172,569,397,55,43,12,-1
"49100",NA,27169,"Winona County, MN","County or equivalent",2007,49848,226,172,569,397,55,43,12,-1
"49260",NA,NA,"Woodward, OK","Micropolitan Statistical Area",2007,19674,595,110,297,187,477,9,468,8
"49260",NA,40153,"Woodward County, OK","County or equivalent",2007,19674,595,110,297,187,477,9,468,8
"49300",NA,NA,"Wooster, OH","Micropolitan Statistical Area",2007,113411,-129,637,1615,978,-784,70,-854,18
"49300",NA,39169,"Wayne County, OH","County or equivalent",2007,113411,-129,637,1615,978,-784,70,-854,18
"49380",NA,NA,"Worthington, MN","Micropolitan Statistical Area",2007,20102,40,147,317,170,-113,54,-167,6
"49380",NA,27105,"Nobles County, MN","County or equivalent",2007,20102,40,147,317,170,-113,54,-167,6
"49460",NA,NA,"Yankton, SD","Micropolitan Statistical Area",2007,21672,33,95,288,193,-64,6,-70,2
"49460",NA,46135,"Yankton County, SD","County or equivalent",2007,21672,33,95,288,193,-64,6,-70,2
"49540",NA,NA,"Yazoo City, MS","Micropolitan Statistical Area",2007,28693,-60,234,489,255,-304,7,-311,10
"49540",NA,28163,"Yazoo County, MS","County or equivalent",2007,28693,-60,234,489,255,-304,7,-311,10
"49780",NA,NA,"Zanesville, OH","Micropolitan Statistical Area",2007,85230,-148,253,1138,885,-412,8,-420,11
"49780",NA,39119,"Muskingum County, OH","County or equivalent",2007,85230,-148,253,1138,885,-412,8,-420,11
"10180",NA,48059,"Callahan County, TX","County or equivalent",2008,13533,87,28,164,136,52,5,47,7
"10180",NA,48253,"Jones County, TX","County or equivalent",2008,19197,-60,15,185,170,-29,4,-33,-46
"10180",NA,48441,"Taylor County, TX","County or equivalent",2008,126791,338,935,2127,1192,-658,133,-791,61
"10420",NA,NA,"Akron, OH","Metropolitan Statistical Area",2008,698553,-529,2021,8548,6527,-2594,485,-3079,44
"10420",NA,39133,"Portage County, OH","County or equivalent",2008,155991,643,557,1734,1177,136,85,51,-50
"10420",NA,39153,"Summit County, OH","County or equivalent",2008,542562,-1172,1464,6814,5350,-2730,400,-3130,94
"10500",NA,NA,"Albany, GA","Metropolitan Statistical Area",2008,164919,978,998,2392,1394,-16,101,-117,-4
"10500",NA,13007,"Baker County, GA","County or equivalent",2008,3805,31,16,24,8,36,2,34,-21
"10500",NA,13095,"Dougherty County, GA","County or equivalent",2008,95754,99,748,1631,883,-662,75,-737,13
"10500",NA,13177,"Lee County, GA","County or equivalent",2008,33761,782,212,368,156,563,17,546,7
"10500",NA,13273,"Terrell County, GA","County or equivalent",2008,10293,18,-7,142,149,24,1,23,1
"10500",NA,13321,"Worth County, GA","County or equivalent",2008,21306,48,29,227,198,23,6,17,-4
"10580",NA,NA,"Albany-Schenectady-Troy, NY","Metropolitan Statistical Area",2008,853919,2355,2503,9937,7434,-490,1060,-1550,342
"10580",NA,36001,"Albany County, NY","County or equivalent",2008,298130,-449,620,3309,2689,-1253,530,-1783,184
"10580",NA,36083,"Rensselaer County, NY","County or equivalent",2008,155261,306,455,1856,1401,-172,208,-380,23
"10580",NA,36091,"Saratoga County, NY","County or equivalent",2008,217191,1560,928,2467,1539,575,117,458,57
"10580",NA,36093,"Schenectady County, NY","County or equivalent",2008,151427,954,477,1989,1512,412,203,209,65
"10580",NA,36095,"Schoharie County, NY","County or equivalent",2008,31910,-16,23,316,293,-52,2,-54,13
"10740",NA,NA,"Albuquerque, NM","Metropolitan Statistical Area",2008,845913,12869,6475,12753,6278,6487,1589,4898,-93
"10740",NA,35001,"Bernalillo County, NM","County or equivalent",2008,635139,7354,4939,9827,4888,2493,1414,1079,-78
"10740",NA,35043,"Sandoval County, NM","County or equivalent",2008,122298,4715,938,1688,750,3792,63,3729,-15
"10740",NA,35057,"Torrance County, NM","County or equivalent",2008,16269,-260,75,191,116,-327,9,-336,-8
"10740",NA,35061,"Valencia County, NM","County or equivalent",2008,72207,1060,523,1047,524,529,103,426,8
"10780",NA,NA,"Alexandria, LA","Metropolitan Statistical Area",2008,153105,449,690,2257,1567,-304,53,-357,63
"10780",NA,22043,"Grant Parish, LA","County or equivalent",2008,19974,209,67,260,193,133,2,131,9
"10780",NA,22079,"Rapides Parish, LA","County or equivalent",2008,133131,240,623,1997,1374,-437,51,-488,54
"10900",NA,NA,"Allentown-Bethlehem-Easton, PA-NJ","Metropolitan Statistical Area",2008,808210,5714,2318,9768,7450,3074,1400,1674,322
"10900",NA,34041,"Warren County, NJ","County or equivalent",2008,109876,384,456,1312,856,-128,164,-292,56
"10900",NA,42025,"Carbon County, PA","County or equivalent",2008,63558,404,-78,680,758,443,12,431,39
"10900",NA,42077,"Lehigh County, PA","County or equivalent",2008,339989,3192,1148,4329,3181,1964,773,1191,80
"10900",NA,42095,"Northampton County, PA","County or equivalent",2008,294787,1734,792,3447,2655,795,451,344,147
"11020",NA,NA,"Altoona, PA","Metropolitan Statistical Area",2008,125174,-168,-65,1488,1553,-182,19,-201,79
"11020",NA,42013,"Blair County, PA","County or equivalent",2008,125174,-168,-65,1488,1553,-182,19,-201,79
"11100",NA,NA,"Amarillo, TX","Metropolitan Statistical Area",2008,243838,1714,1955,3983,2028,-78,409,-487,-163
"11100",NA,48011,"Armstrong County, TX","County or equivalent",2008,2123,47,4,24,20,42,0,42,1
"11100",NA,48065,"Carson County, TX","County or equivalent",2008,6251,-66,11,78,67,-81,2,-83,4
"11100",NA,48375,"Potter County, TX","County or equivalent",2008,120918,528,1105,2312,1207,-591,315,-906,14
"11100",NA,48381,"Randall County, TX","County or equivalent",2008,114546,1205,835,1569,734,552,92,460,-182
"11180",NA,NA,"Ames, IA","Metropolitan Statistical Area",2008,86754,1448,577,1061,484,847,397,450,24
"11180",NA,19169,"Story County, IA","County or equivalent",2008,86754,1448,577,1061,484,847,397,450,24
"11260",NA,NA,"Anchorage, AK","Metropolitan Statistical Area",2008,364701,4612,4148,5842,1694,596,510,86,-132
"11260",NA,2020,"Anchorage Municipality, AK","County or equivalent",2008,279243,1701,3202,4505,1303,-1366,474,-1840,-135
"11260",NA,2170,"Matanuska-Susitna Borough, AK","County or equivalent",2008,85458,2911,946,1337,391,1962,36,1926,3
"11300",NA,NA,"Anderson, IN","Metropolitan Statistical Area",2008,131501,344,194,1649,1455,64,63,1,86
"11300",NA,18095,"Madison County, IN","County or equivalent",2008,131501,344,194,1649,1455,64,63,1,86
"11340",NA,NA,"Anderson, SC","Metropolitan Statistical Area",2008,182825,2861,445,2369,1924,2395,101,2294,21
"11340",NA,45007,"Anderson County, SC","County or equivalent",2008,182825,2861,445,2369,1924,2395,101,2294,21
"11460",NA,NA,"Ann Arbor, MI","Metropolitan Statistical Area",2008,347376,-593,2370,4253,1883,-3091,1583,-4674,128
"11460",NA,26161,"Washtenaw County, MI","County or equivalent",2008,347376,-593,2370,4253,1883,-3091,1583,-4674,128
"11500",NA,NA,"Anniston-Oxford, AL","Metropolitan Statistical Area",2008,113419,563,227,1544,1317,273,45,228,63
"11500",NA,1015,"Calhoun County, AL","County or equivalent",2008,113419,563,227,1544,1317,273,45,228,63
"11540",NA,NA,"Appleton, WI","Metropolitan Statistical Area",2008,219720,1880,1628,3050,1422,203,169,34,49
"11540",NA,55015,"Calumet County, WI","County or equivalent",2008,44727,495,419,682,263,92,27,65,-16
"11540",NA,55087,"Outagamie County, WI","County or equivalent",2008,174993,1385,1209,2368,1159,111,142,-31,65
"11700",NA,NA,"Asheville, NC","Metropolitan Statistical Area",2008,408436,4908,602,5003,4401,4238,637,3601,68
"11700",NA,37021,"Buncombe County, NC","County or equivalent",2008,229047,2647,642,2881,2239,1896,362,1534,109
"11700",NA,37087,"Haywood County, NC","County or equivalent",2008,56590,185,-55,615,670,293,22,271,-53
"11700",NA,37089,"Henderson County, NC","County or equivalent",2008,102367,1922,45,1292,1247,1875,243,1632,2
"11700",NA,37115,"Madison County, NC","County or equivalent",2008,20432,154,-30,215,245,174,10,164,10
"12020",NA,NA,"Athens-Clarke County, GA","Metropolitan Statistical Area",2008,189264,2946,1360,2595,1235,1599,605,994,-13
"12020",NA,13059,"Clarke County, GA","County or equivalent",2008,114737,1496,993,1678,685,509,553,-44,-6
"12020",NA,13195,"Madison County, GA","County or equivalent",2008,28200,259,102,356,254,154,18,136,3
"12020",NA,13219,"Oconee County, GA","County or equivalent",2008,32221,996,214,401,187,776,31,745,6
"12020",NA,13221,"Oglethorpe County, GA","County or equivalent",2008,14106,195,51,160,109,160,3,157,-16
"12060",NA,NA,"Atlanta-Sandy Springs-Marietta, GA","Metropolitan Statistical Area",2008,5376285,114989,52915,84080,31165,63235,20184,43051,-1161
"12060",NA,13013,"Barrow County, GA","County or equivalent",2008,70073,3145,801,1282,481,2418,46,2372,-74
"12060",NA,13015,"Bartow County, GA","County or equivalent",2008,94913,2352,814,1578,764,1570,98,1472,-32
"12060",NA,13035,"Butts County, GA","County or equivalent",2008,24423,765,124,332,208,660,5,655,-19
"12060",NA,13045,"Carroll County, GA","County or equivalent",2008,113688,1843,931,1844,913,942,152,790,-30
"12060",NA,13057,"Cherokee County, GA","County or equivalent",2008,210529,6859,2473,3569,1096,4454,388,4066,-68
"12060",NA,13063,"Clayton County, GA","County or equivalent",2008,273718,2574,3246,4706,1460,-398,1136,-1534,-274
"12060",NA,13067,"Cobb County, GA","County or equivalent",2008,698158,9262,7226,10854,3628,2051,3300,-1249,-15
"12060",NA,13077,"Coweta County, GA","County or equivalent",2008,122924,4472,1083,1877,794,3498,185,3313,-109
"12060",NA,13085,"Dawson County, GA","County or equivalent",2008,22006,538,176,336,160,351,9,342,11
"12060",NA,13089,"DeKalb County, GA","County or equivalent",2008,739956,6598,6765,10932,4167,-103,5384,-5487,-64
"12060",NA,13097,"Douglas County, GA","County or equivalent",2008,127932,3711,1291,2066,775,2403,140,2263,17
"12060",NA,13113,"Fayette County, GA","County or equivalent",2008,106465,655,354,1031,677,321,168,153,-20
"12060",NA,13117,"Forsyth County, GA","County or equivalent",2008,168060,9949,1852,2620,768,8214,285,7929,-117
"12060",NA,13121,"Fulton County, GA","County or equivalent",2008,1014932,22460,8469,14829,6360,14173,4047,10126,-182
"12060",NA,13135,"Gwinnett County, GA","County or equivalent",2008,789499,18033,10371,13584,3213,7578,4212,3366,84
"12060",NA,13143,"Haralson County, GA","County or equivalent",2008,28979,244,61,377,316,175,10,165,8
"12060",NA,13149,"Heard County, GA","County or equivalent",2008,11476,111,43,135,92,69,0,69,-1
"12060",NA,13151,"Henry County, GA","County or equivalent",2008,191502,6135,2271,3318,1047,3911,83,3828,-47
"12060",NA,13159,"Jasper County, GA","County or equivalent",2008,13842,208,78,184,106,130,9,121,0
"12060",NA,13171,"Lamar County, GA","County or equivalent",2008,17000,91,62,230,168,44,4,40,-15
"12060",NA,13199,"Meriwether County, GA","County or equivalent",2008,22840,99,17,298,281,67,1,66,15
"12060",NA,13217,"Newton County, GA","County or equivalent",2008,98542,2819,1043,1733,690,1819,52,1767,-43
"12060",NA,13223,"Paulding County, GA","County or equivalent",2008,133135,5541,1494,2161,667,4130,50,4080,-83
"12060",NA,13227,"Pickens County, GA","County or equivalent",2008,31176,723,70,368,298,663,12,651,-10
"12060",NA,13231,"Pike County, GA","County or equivalent",2008,17569,414,112,240,128,303,1,302,-1
"12060",NA,13247,"Rockdale County, GA","County or equivalent",2008,83222,1572,696,1282,586,874,295,579,2
"12060",NA,13255,"Spalding County, GA","County or equivalent",2008,63913,953,350,983,633,577,77,500,26
"12060",NA,13297,"Walton County, GA","County or equivalent",2008,85813,2863,642,1331,689,2341,35,2306,-120
"12100",NA,NA,"Atlantic City-Hammonton, NJ","Metropolitan Statistical Area",2008,270681,711,1131,3681,2550,-594,1078,-1672,174
"12100",NA,34001,"Atlantic County, NJ","County or equivalent",2008,270681,711,1131,3681,2550,-594,1078,-1672,174
"12220",NA,NA,"Auburn-Opelika, AL","Metropolitan Statistical Area",2008,133010,2489,793,1658,865,1703,146,1557,-7
"12220",NA,1081,"Lee County, AL","County or equivalent",2008,133010,2489,793,1658,865,1703,146,1557,-7
"12260",NA,NA,"Augusta-Richmond County, GA-SC","Metropolitan Statistical Area",2008,534218,5906,2854,7768,4914,3134,395,2739,-82
"12260",NA,13033,"Burke County, GA","County or equivalent",2008,22732,18,109,364,255,-92,5,-97,1
"12260",NA,13073,"Columbia County, GA","County or equivalent",2008,110627,1867,933,1604,671,965,87,878,-31
"12260",NA,13189,"McDuffie County, GA","County or equivalent",2008,21756,252,82,337,255,164,4,160,6
"12260",NA,13245,"Richmond County, GA","County or equivalent",2008,199486,1843,1334,3255,1921,525,155,370,-16
"12260",NA,45003,"Aiken County, SC","County or equivalent",2008,154071,1738,375,1943,1568,1416,136,1280,-53
"12260",NA,45037,"Edgefield County, SC","County or equivalent",2008,25546,188,21,265,244,156,8,148,11
"12420",NA,NA,"Austin-Round Rock, TX","Metropolitan Statistical Area",2008,1652602,60012,18906,26725,7819,41593,6552,35041,-487
"12420",NA,48021,"Bastrop County, TX","County or equivalent",2008,73491,1364,412,958,546,955,121,834,-3
"12420",NA,48055,"Caldwell County, TX","County or equivalent",2008,36899,299,271,543,272,24,34,-10,4
"12420",NA,48209,"Hays County, TX","County or equivalent",2008,149476,7526,1497,2194,697,6040,134,5906,-11
"12420",NA,48453,"Travis County, TX","County or equivalent",2008,998543,28651,12100,16571,4471,16522,5697,10825,29
"12420",NA,48491,"Williamson County, TX","County or equivalent",2008,394193,22172,4626,6459,1833,18052,566,17486,-506
"12540",NA,NA,"Bakersfield, CA","Metropolitan Statistical Area",2008,800458,13279,10347,15820,5473,2715,2325,390,217
"12540",NA,6029,"Kern County, CA","County or equivalent",2008,800458,13279,10347,15820,5473,2715,2325,390,217
"12580",NA,NA,"Baltimore-Towson, MD","Metropolitan Statistical Area",2008,2667117,3312,11953,35375,23422,-8594,3758,-12352,-47
"12580",NA,24003,"Anne Arundel County, MD","County or equivalent",2008,512790,2283,2916,6674,3758,-741,471,-1212,108
"12580",NA,24005,"Baltimore County, MD","County or equivalent",2008,785618,-212,2009,9682,7673,-2437,1411,-3848,216
"12580",NA,24013,"Carroll County, MD","County or equivalent",2008,169353,567,771,2088,1317,-178,55,-233,-26
"12580",NA,24025,"Harford County, MD","County or equivalent",2008,240351,945,1285,3012,1727,-375,141,-516,35
"12580",NA,24027,"Howard County, MD","County or equivalent",2008,274995,2384,2092,3424,1332,280,824,-544,12
"12580",NA,24035,"Queen Anne's County, MD","County or equivalent",2008,47091,576,172,533,361,381,28,353,23
"12580",NA,24510,"Baltimore city, MD","County or equivalent",2008,636919,-3231,2708,9962,7254,-5524,828,-6352,-415
"12620",NA,NA,"Bangor, ME","Metropolitan Statistical Area",2008,148651,124,383,1698,1315,-264,90,-354,5
"12620",NA,23019,"Penobscot County, ME","County or equivalent",2008,148651,124,383,1698,1315,-264,90,-354,5
"12700",NA,NA,"Barnstable Town, MA","Metropolitan Statistical Area",2008,221049,-941,-764,1986,2750,-260,282,-542,83
"12700",NA,25001,"Barnstable County, MA","County or equivalent",2008,221049,-941,-764,1986,2750,-260,282,-542,83
"12940",NA,NA,"Baton Rouge, LA","Metropolitan Statistical Area",2008,774327,4930,5082,11351,6269,102,700,-598,-254
"12940",NA,22005,"Ascension Parish, LA","County or equivalent",2008,101789,2700,1071,1724,653,1598,67,1531,31
"12940",NA,22033,"East Baton Rouge Parish, LA","County or equivalent",2008,428360,-1554,2685,6192,3507,-3998,606,-4604,-241
"12940",NA,22037,"East Feliciana Parish, LA","County or equivalent",2008,20874,47,28,262,234,22,0,22,-3
"12940",NA,22047,"Iberville Parish, LA","County or equivalent",2008,32545,78,133,470,337,-48,3,-51,-7
"12940",NA,22063,"Livingston Parish, LA","County or equivalent",2008,120256,3787,974,1818,844,2789,19,2770,24
"12940",NA,22077,"Pointe Coupee Parish, LA","County or equivalent",2008,22401,42,61,313,252,-14,1,-15,-5
"12940",NA,22091,"St. Helena Parish, LA","County or equivalent",2008,10546,-44,0,113,113,-39,0,-39,-5
"12940",NA,22121,"West Baton Rouge Parish, LA","County or equivalent",2008,22553,-67,122,336,214,-169,2,-171,-20
"12940",NA,22125,"West Feliciana Parish, LA","County or equivalent",2008,15003,-59,8,123,115,-39,2,-41,-28
"12980",NA,NA,"Battle Creek, MI","Metropolitan Statistical Area",2008,135861,-473,536,1882,1346,-1009,137,-1146,0
"12980",NA,26025,"Calhoun County, MI","County or equivalent",2008,135861,-473,536,1882,1346,-1009,137,-1146,0
"13020",NA,NA,"Bay City, MI","Metropolitan Statistical Area",2008,107495,129,224,1282,1058,-99,19,-118,4
"13020",NA,26017,"Bay County, MI","County or equivalent",2008,107495,129,224,1282,1058,-99,19,-118,4
"13140",NA,NA,"Beaumont-Port Arthur, TX","Metropolitan Statistical Area",2008,378255,1807,1327,5160,3833,584,441,143,-104
"13140",NA,48199,"Hardin County, TX","County or equivalent",2008,52143,613,226,709,483,397,9,388,-10
"13140",NA,48245,"Jefferson County, TX","County or equivalent",2008,243090,718,933,3384,2451,-195,391,-586,-20
"13140",NA,48361,"Orange County, TX","County or equivalent",2008,83022,476,168,1067,899,382,41,341,-74
"13380",NA,NA,"Bellingham, WA","Metropolitan Statistical Area",2008,196529,4176,1029,2401,1372,3197,472,2725,-50
"13380",NA,53073,"Whatcom County, WA","County or equivalent",2008,196529,4176,1029,2401,1372,3197,472,2725,-50
"13460",NA,NA,"Bend, OR","Metropolitan Statistical Area",2008,158456,4657,1030,2137,1107,3748,66,3682,-121
"13460",NA,41017,"Deschutes County, OR","County or equivalent",2008,158456,4657,1030,2137,1107,3748,66,3682,-121
"13740",NA,NA,"Billings, MT","Metropolitan Statistical Area",2008,152005,2530,775,2071,1296,1734,28,1706,21
"13740",NA,30009,"Carbon County, MT","County or equivalent",2008,9657,-52,-11,88,99,-41,3,-44,0
"13740",NA,30111,"Yellowstone County, MT","County or equivalent",2008,142348,2582,786,1983,1197,1775,25,1750,21
"13780",NA,NA,"Binghamton, NY","Metropolitan Statistical Area",2008,245189,-661,417,2819,2402,-1047,304,-1351,-31
"13780",NA,36007,"Broome County, NY","County or equivalent",2008,195018,-459,237,2206,1969,-728,288,-1016,32
"13780",NA,36107,"Tioga County, NY","County or equivalent",2008,50171,-202,180,613,433,-319,16,-335,-63
"13820",NA,NA,"Birmingham-Hoover, AL","Metropolitan Statistical Area",2008,1117608,8936,4363,15440,11077,4279,977,3302,294
"13820",NA,1007,"Bibb County, AL","County or equivalent",2008,21629,146,39,257,218,97,5,92,10
"13820",NA,1009,"Blount County, AL","County or equivalent",2008,57441,939,175,729,554,742,74,668,22
"13820",NA,1021,"Chilton County, AL","County or equivalent",2008,42444,248,149,573,424,102,25,77,-3
"13820",NA,1073,"Jefferson County, AL","County or equivalent",2008,659503,688,2112,9164,7052,-1649,707,-2356,225
"13820",NA,1115,"St. Clair County, AL","County or equivalent",2008,79837,1801,275,1058,783,1536,9,1527,-10
"13820",NA,1117,"Shelby County, AL","County or equivalent",2008,187784,4815,1697,2816,1119,3066,135,2931,52
"13820",NA,1127,"Walker County, AL","County or equivalent",2008,68970,299,-84,843,927,385,22,363,-2
"13900",NA,NA,"Bismarck, ND","Metropolitan Statistical Area",2008,104944,1817,691,1473,782,1110,34,1076,16
"13900",NA,38015,"Burleigh County, ND","County or equivalent",2008,78689,1433,547,1091,544,887,25,862,-1
"13900",NA,38059,"Morton County, ND","County or equivalent",2008,26255,384,144,382,238,223,9,214,17
"13980",NA,NA,"Blacksburg-Christiansburg-Radford, VA","Metropolitan Statistical Area",2008,158328,972,389,1625,1236,561,304,257,22
"13980",NA,51071,"Giles County, VA","County or equivalent",2008,17249,46,-30,183,213,81,-1,82,-5
"13980",NA,51121,"Montgomery County, VA","County or equivalent",2008,89967,944,417,932,515,506,288,218,21
"13980",NA,51155,"Pulaski County, VA","County or equivalent",2008,34987,-11,-35,357,392,13,4,9,11
"13980",NA,51750,"Radford city, VA","County or equivalent",2008,16125,-7,37,153,116,-39,13,-52,-5
"14020",NA,NA,"Bloomington, IN","Metropolitan Statistical Area",2008,183944,1324,707,2085,1378,597,360,237,20
"14020",NA,18055,"Greene County, IN","County or equivalent",2008,32577,-65,43,394,351,-84,2,-86,-24
"14020",NA,18105,"Monroe County, IN","County or equivalent",2008,128992,1367,647,1451,804,683,357,326,37
"14020",NA,18119,"Owen County, IN","County or equivalent",2008,22375,22,17,240,223,-2,1,-3,7
"14060",NA,NA,"Bloomington-Normal, IL","Metropolitan Statistical Area",2008,165298,1606,1310,2363,1053,251,218,33,45
"14060",NA,17113,"McLean County, IL","County or equivalent",2008,165298,1606,1310,2363,1053,251,218,33,45
"14260",NA,NA,"Boise City-Nampa, ID","Metropolitan Statistical Area",2008,599753,13153,6160,9899,3739,7462,917,6545,-469
"14260",NA,16001,"Ada County, ID","County or equivalent",2008,380920,7762,3673,5914,2241,4367,572,3795,-278
"14260",NA,16015,"Boise County, ID","County or equivalent",2008,7504,-38,27,62,35,-50,2,-52,-15
"14260",NA,16027,"Canyon County, ID","County or equivalent",2008,183939,5257,2347,3532,1185,3059,292,2767,-149
"14260",NA,16045,"Gem County, ID","County or equivalent",2008,16513,58,37,226,189,37,19,18,-16
"14260",NA,16073,"Owyhee County, ID","County or equivalent",2008,10877,114,76,165,89,49,32,17,-11
"14460",NA,NA,"Boston-Cambridge-Quincy, MA-NH","Metropolitan Statistical Area",2008,4522858,30520,20438,55264,34826,10308,18569,-8261,-226
"14460",14484,NA,"Boston-Quincy, MA","Metropolitan Division",2008,1884659,11947,8902,23456,14554,3408,8645,-5237,-363
"14460",14484,25021,"Norfolk County, MA","County or equivalent",2008,659909,4551,2291,7701,5410,2482,1818,664,-222
"14460",14484,25023,"Plymouth County, MA","County or equivalent",2008,492066,2258,1988,6007,4019,105,634,-529,165
"14460",14484,25025,"Suffolk County, MA","County or equivalent",2008,732684,5138,4623,9748,5125,821,6193,-5372,-306
"14460",15764,NA,"Cambridge-Newton-Framingham, MA","Metropolitan Division",2008,1482478,12680,6877,17988,11111,6003,7334,-1331,-200
"14460",15764,25017,"Middlesex County, MA","County or equivalent",2008,1482478,12680,6877,17988,11111,6003,7334,-1331,-200
"14460",37764,NA,"Peabody, MA","Metropolitan Division",2008,736457,3882,2936,9237,6301,634,2306,-1672,312
"14460",37764,25009,"Essex County, MA","County or equivalent",2008,736457,3882,2936,9237,6301,634,2306,-1672,312
"14460",40484,NA,"Rockingham County-Strafford County, NH","Metropolitan Division",2008,419264,2011,1723,4583,2860,263,284,-21,25
"14460",40484,33015,"Rockingham County, NH","County or equivalent",2008,297350,1308,1143,3125,1982,149,185,-36,16
"14460",40484,33017,"Strafford County, NH","County or equivalent",2008,121914,703,580,1458,878,114,99,15,9
"14500",NA,NA,"Boulder, CO /1","Metropolitan Statistical Area",2008,293161,4356,2212,3652,1440,2154,1183,971,-10
"14500",NA,8013,"Boulder County, CO /1","County or equivalent",2008,293161,4356,2212,3652,1440,2154,1183,971,-10
"14540",NA,NA,"Bowling Green, KY","Metropolitan Statistical Area",2008,117947,2249,669,1624,955,1579,276,1303,1
"14540",NA,21061,"Edmonson County, KY","County or equivalent",2008,12085,132,14,122,108,118,2,116,0
"14540",NA,21227,"Warren County, KY","County or equivalent",2008,105862,2117,655,1502,847,1461,274,1187,1
"14600",NA,NA,"Bradenton-Sarasota-Venice, FL","Metropolitan Statistical Area",2008,687823,2821,-1487,7253,8740,4005,1532,2473,303
"14600",NA,12081,"Manatee County, FL","County or equivalent",2008,315766,1635,368,3945,3577,1122,724,398,145
"14600",NA,12115,"Sarasota County, FL","County or equivalent",2008,372057,1186,-1855,3308,5163,2883,808,2075,158
"14740",NA,NA,"Bremerton-Silverdale, WA","Metropolitan Statistical Area",2008,239769,1609,1087,2885,1798,432,190,242,90
"14740",NA,53035,"Kitsap County, WA","County or equivalent",2008,239769,1609,1087,2885,1798,432,190,242,90
"14860",NA,NA,"Bridgeport-Stamford-Norwalk, CT","Metropolitan Statistical Area",2008,895030,4435,4939,11270,6331,-42,5148,-5190,-462
"14860",NA,9001,"Fairfield County, CT","County or equivalent",2008,895030,4435,4939,11270,6331,-42,5148,-5190,-462
"15180",NA,NA,"Brownsville-Harlingen, TX","Metropolitan Statistical Area",2008,392736,7831,6825,9123,2298,912,1576,-664,94
"15180",NA,48061,"Cameron County, TX","County or equivalent",2008,392736,7831,6825,9123,2298,912,1576,-664,94
"15260",NA,NA,"Brunswick, GA","Metropolitan Statistical Area",2008,102850,1351,390,1410,1020,957,108,849,4
"15260",NA,13025,"Brantley County, GA","County or equivalent",2008,15511,94,-9,131,140,103,4,99,0
"15260",NA,13127,"Glynn County, GA","County or equivalent",2008,75884,1218,376,1137,761,822,102,720,20
"15260",NA,13191,"McIntosh County, GA","County or equivalent",2008,11455,39,23,142,119,32,2,30,-16
"15380",NA,NA,"Buffalo-Niagara Falls, NY","Metropolitan Statistical Area",2008,1124309,-2204,984,12717,11733,-3282,1203,-4485,94
"15380",NA,36029,"Erie County, NY","County or equivalent",2008,909845,-2313,800,10270,9470,-3070,1057,-4127,-43
"15380",NA,36063,"Niagara County, NY","County or equivalent",2008,214464,109,184,2447,2263,-212,146,-358,137
"15500",NA,NA,"Burlington, NC","Metropolitan Statistical Area",2008,148053,3263,689,2038,1349,2496,499,1997,78
"15500",NA,37001,"Alamance County, NC","County or equivalent",2008,148053,3263,689,2038,1349,2496,499,1997,78
"15540",NA,NA,"Burlington-South Burlington, VT","Metropolitan Statistical Area",2008,208460,1240,960,2305,1345,194,358,-164,86
"15540",NA,50007,"Chittenden County, VT","County or equivalent",2008,152782,975,680,1626,946,228,342,-114,67
"15540",NA,50011,"Franklin County, VT","County or equivalent",2008,47949,119,252,605,353,-153,17,-170,20
"15540",NA,50013,"Grand Isle County, VT","County or equivalent",2008,7729,146,28,74,46,119,-1,120,-1
"15940",NA,NA,"Canton-Massillon, OH","Metropolitan Statistical Area",2008,407653,59,876,5007,4131,-999,64,-1063,182
"15940",NA,39019,"Carroll County, OH","County or equivalent",2008,28439,-106,88,340,252,-148,2,-150,-46
"15940",NA,39151,"Stark County, OH","County or equivalent",2008,379214,165,788,4667,3879,-851,62,-913,228
"15980",NA,NA,"Cape Coral-Fort Myers, FL","Metropolitan Statistical Area",2008,593136,5007,1637,7891,6254,3241,1492,1749,129
"15980",NA,12071,"Lee County, FL","County or equivalent",2008,593136,5007,1637,7891,6254,3241,1492,1749,129
"16180",NA,NA,"Carson City, NV","Metropolitan Statistical Area",2008,54867,143,111,738,627,-5,146,-151,37
"16180",NA,32510,"Carson City, NV","County or equivalent",2008,54867,143,111,738,627,-5,146,-151,37
"16220",NA,NA,"Casper, WY","Metropolitan Statistical Area",2008,73129,1345,524,1102,578,830,32,798,-9
"16220",NA,56025,"Natrona County, WY","County or equivalent",2008,73129,1345,524,1102,578,830,32,798,-9
"16300",NA,NA,"Cedar Rapids, IA","Metropolitan Statistical Area",2008,255452,2980,1603,3513,1910,1360,205,1155,17
"16300",NA,19011,"Benton County, IA","County or equivalent",2008,26532,31,89,308,219,-41,2,-43,-17
"16300",NA,19105,"Jones County, IA","County or equivalent",2008,20346,-4,64,248,184,-54,0,-54,-14
"16300",NA,19113,"Linn County, IA","County or equivalent",2008,208574,2953,1450,2957,1507,1455,203,1252,48
"16580",NA,NA,"Champaign-Urbana, IL","Metropolitan Statistical Area",2008,224191,605,1381,2939,1558,-787,778,-1565,11
"16580",NA,17019,"Champaign County, IL","County or equivalent",2008,193636,621,1350,2543,1193,-776,770,-1546,47
"16580",NA,17053,"Ford County, IL","County or equivalent",2008,14050,-64,-20,187,207,-29,5,-34,-15
"16580",NA,17147,"Piatt County, IL","County or equivalent",2008,16505,48,51,209,158,18,3,15,-21
"16620",NA,NA,"Charleston, WV","Metropolitan Statistical Area",2008,303944,288,130,3671,3541,98,64,34,60
"16620",NA,54005,"Boone County, WV","County or equivalent",2008,24977,-209,5,307,302,-210,5,-215,-4
"16620",NA,54015,"Clay County, WV","County or equivalent",2008,10075,-35,13,130,117,-53,0,-53,5
"16620",NA,54039,"Kanawha County, WV","County or equivalent",2008,191018,-162,-108,2260,2368,-87,54,-141,33
"16620",NA,54043,"Lincoln County, WV","County or equivalent",2008,22386,78,22,277,255,56,0,56,0
"16620",NA,54079,"Putnam County, WV","County or equivalent",2008,55488,616,198,697,499,392,5,387,26
"16700",NA,NA,"Charleston-North Charleston-Summerville, SC","Metropolitan Statistical Area",2008,644506,14072,4433,9357,4924,9650,673,8977,-11
"16700",NA,45015,"Berkeley County, SC","County or equivalent",2008,169327,5772,1480,2594,1114,4307,116,4191,-15
"16700",NA,45019,"Charleston County, SC","County or equivalent",2008,348046,4524,1992,4926,2934,2561,475,2086,-29
"16700",NA,45035,"Dorchester County, SC","County or equivalent",2008,127133,3776,961,1837,876,2782,82,2700,33
"16740",NA,NA,"Charlotte-Gastonia-Concord, NC-SC","Metropolitan Statistical Area",2008,1701799,55368,15944,27108,11164,39121,4734,34387,303
"16740",NA,37007,"Anson County, NC","County or equivalent",2008,25162,-56,19,312,293,-88,5,-93,13
"16740",NA,37025,"Cabarrus County, NC","County or equivalent",2008,168740,5942,1511,2761,1250,4371,319,4052,60
"16740",NA,37071,"Gaston County, NC","County or equivalent",2008,206679,4513,917,2867,1950,3502,413,3089,94
"16740",NA,37119,"Mecklenburg County, NC","County or equivalent",2008,890515,26714,10007,14973,4966,16472,3412,13060,235
"16740",NA,37179,"Union County, NC","County or equivalent",2008,193255,9371,2092,3141,1049,7278,423,6855,1
"16740",NA,45091,"York County, SC","County or equivalent",2008,217448,8884,1398,3054,1656,7586,162,7424,-100
"16820",NA,NA,"Charlottesville, VA","Metropolitan Statistical Area",2008,194391,2237,969,2437,1468,1248,416,832,20
"16820",NA,51003,"Albemarle County, VA","County or equivalent",2008,94075,1436,465,1101,636,926,277,649,45
"16820",NA,51065,"Fluvanna County, VA","County or equivalent",2008,25544,290,181,362,181,128,3,125,-19
"16820",NA,51079,"Greene County, VA","County or equivalent",2008,17964,132,162,280,118,-35,2,-37,5
"16820",NA,51125,"Nelson County, VA","County or equivalent",2008,15321,98,-19,168,187,121,-1,122,-4
"16820",NA,51540,"Charlottesville city, VA","County or equivalent",2008,41487,281,180,526,346,108,135,-27,-7
"16860",NA,NA,"Chattanooga, TN-GA","Metropolitan Statistical Area",2008,518441,4232,1469,6687,5218,2552,427,2125,211
"16860",NA,13047,"Catoosa County, GA","County or equivalent",2008,62825,705,303,827,524,410,22,388,-8
"16860",NA,13083,"Dade County, GA","County or equivalent",2008,16142,29,19,186,167,8,8,0,2
"16860",NA,13295,"Walker County, GA","County or equivalent",2008,64799,378,114,820,706,242,25,217,22
"16860",NA,47065,"Hamilton County, TN","County or equivalent",2008,332848,2771,956,4329,3373,1627,364,1263,188
"16860",NA,47115,"Marion County, TN","County or equivalent",2008,28247,129,31,353,322,92,2,90,6
"16860",NA,47153,"Sequatchie County, TN","County or equivalent",2008,13580,220,46,172,126,173,6,167,1
"16940",NA,NA,"Cheyenne, WY","Metropolitan Statistical Area",2008,87542,1062,645,1339,694,431,54,377,-14
"16940",NA,56021,"Laramie County, WY","County or equivalent",2008,87542,1062,645,1339,694,431,54,377,-14
"16980",NA,NA,"Chicago-Naperville-Joliet, IL-IN-WI","Metropolitan Statistical Area",2008,9569624,72771,74317,143040,68723,937,43047,-42110,-2483
"16980",16974,NA,"Chicago-Naperville-Joliet, IL","Metropolitan Division",2008,7990248,60408,63618,120779,57161,-495,39287,-39782,-2715
"16980",16974,17031,"Cook County, IL","County or equivalent",2008,5294664,23259,38035,79854,41819,-11854,31177,-43031,-2922
"16980",16974,17037,"DeKalb County, IL","County or equivalent",2008,106321,1141,800,1422,622,317,242,75,24
"16980",16974,17043,"DuPage County, IL","County or equivalent",2008,930528,4300,6255,11977,5722,-2053,4094,-6147,98
"16980",16974,17063,"Grundy County, IL","County or equivalent",2008,47958,971,463,801,338,491,29,462,17
"16980",16974,17089,"Kane County, IL","County or equivalent",2008,507579,9437,6314,9057,2743,3064,2263,801,59
"16980",16974,17093,"Kendall County, IL","County or equivalent",2008,103460,6894,1678,2073,395,5177,60,5117,39
"16980",16974,17111,"McHenry County, IL","County or equivalent",2008,318641,3972,2679,4594,1915,1455,577,878,-162
"16980",16974,17197,"Will County, IL","County or equivalent",2008,681097,10434,7394,11001,3607,2908,845,2063,132
"16980",23844,NA,"Gary, IN","Metropolitan Division",2008,702458,4727,3407,9733,6326,1229,607,622,91
"16980",23844,18073,"Jasper County, IN","County or equivalent",2008,32544,322,189,469,280,120,10,110,13
"16980",23844,18089,"Lake County, IN","County or equivalent",2008,493800,2562,2408,7118,4710,160,478,-318,-6
"16980",23844,18111,"Newton County, IN","County or equivalent",2008,13933,-71,3,146,143,-73,11,-84,-1
"16980",23844,18127,"Porter County, IN","County or equivalent",2008,162181,1914,807,2000,1193,1022,108,914,85
"16980",29404,NA,"Lake County-Kenosha County, IL-WI","Metropolitan Division",2008,876918,7636,7292,12528,5236,203,3153,-2950,141
"16980",29404,17097,"Lake County, IL","County or equivalent",2008,712453,6067,6312,10327,4015,-344,2977,-3321,99
"16980",29404,55059,"Kenosha County, WI","County or equivalent",2008,164465,1569,980,2201,1221,547,176,371,42
"17020",NA,NA,"Chico, CA","Metropolitan Statistical Area",2008,220337,2152,618,2752,2134,1481,355,1126,53
"17020",NA,6007,"Butte County, CA","County or equivalent",2008,220337,2152,618,2752,2134,1481,355,1126,53
"17140",NA,NA,"Cincinnati-Middletown, OH-KY-IN","Metropolitan Statistical Area",2008,2155137,11313,12756,30886,18130,-1672,1897,-3569,229
"17140",NA,18029,"Dearborn County, IN","County or equivalent",2008,49985,406,283,681,398,116,8,108,7
"17140",NA,18047,"Franklin County, IN","County or equivalent",2008,23343,160,113,318,205,36,1,35,11
"17140",NA,18115,"Ohio County, IN","County or equivalent",2008,5773,16,19,63,44,11,-1,12,-14
"17140",NA,21015,"Boone County, KY","County or equivalent",2008,115231,3142,1175,1857,682,1997,151,1846,-30
"17140",NA,21023,"Bracken County, KY","County or equivalent",2008,8569,19,40,119,79,-10,0,-10,-11
"17140",NA,21037,"Campbell County, KY","County or equivalent",2008,87038,228,291,1140,849,-95,56,-151,32
"17140",NA,21077,"Gallatin County, KY","County or equivalent",2008,8071,19,42,126,84,-25,0,-25,2
"17140",NA,21081,"Grant County, KY","County or equivalent",2008,25549,380,195,404,209,184,8,176,1
"17140",NA,21117,"Kenton County, KY","County or equivalent",2008,157629,1036,1138,2445,1307,-117,89,-206,15
"17140",NA,21191,"Pendleton County, KY","County or equivalent",2008,14992,-28,48,178,130,-76,3,-79,0
"17140",NA,39015,"Brown County, OH","County or equivalent",2008,43960,109,135,558,423,-37,5,-42,11
"17140",NA,39017,"Butler County, OH","County or equivalent",2008,360765,2857,2424,5291,2867,289,265,24,144
"17140",NA,39025,"Clermont County, OH","County or equivalent",2008,195385,1656,1405,2849,1444,177,82,95,74
"17140",NA,39061,"Hamilton County, OH","County or equivalent",2008,851494,-2434,3826,11909,8083,-6259,1113,-7372,-1
"17140",NA,39165,"Warren County, OH","County or equivalent",2008,207353,3747,1622,2948,1326,2137,117,2020,-12
"17300",NA,NA,"Clarksville, TN-KY","Metropolitan Statistical Area",2008,261220,-629,2860,4783,1923,-3564,235,-3799,75
"17300",NA,21047,"Christian County, KY","County or equivalent",2008,79820,-1224,1022,1680,658,-2264,66,-2330,18
"17300",NA,21221,"Trigg County, KY","County or equivalent",2008,13418,43,8,155,147,27,3,24,8
"17300",NA,47125,"Montgomery County, TN","County or equivalent",2008,154756,354,1828,2796,968,-1523,164,-1687,49
"17300",NA,47161,"Stewart County, TN","County or equivalent",2008,13226,198,2,152,150,196,2,194,0
"17420",NA,NA,"Cleveland, TN","Metropolitan Statistical Area",2008,112143,1233,391,1459,1068,815,89,726,27
"17420",NA,47011,"Bradley County, TN","County or equivalent",2008,96472,1197,410,1279,869,750,86,664,37
"17420",NA,47139,"Polk County, TN","County or equivalent",2008,15671,36,-19,180,199,65,3,62,-10
"17460",NA,NA,"Cleveland-Elyria-Mentor, OH","Metropolitan Statistical Area",2008,2088291,-6594,5417,26064,20647,-11949,2947,-14896,-62
"17460",NA,39035,"Cuyahoga County, OH","County or equivalent",2008,1283925,-11262,2569,16426,13857,-13459,2298,-15757,-372
"17460",NA,39055,"Geauga County, OH","County or equivalent",2008,94753,57,356,1087,731,-341,23,-364,42
"17460",NA,39085,"Lake County, OH","County or equivalent",2008,234030,1017,448,2630,2182,487,335,152,82
"17460",NA,39093,"Lorain County, OH","County or equivalent",2008,304373,1686,1093,3802,2709,475,209,266,118
"17460",NA,39103,"Medina County, OH","County or equivalent",2008,171210,1908,951,2119,1168,889,82,807,68
"17660",NA,NA,"Coeur d'Alene, ID","Metropolitan Statistical Area",2008,137475,3264,708,1778,1070,2708,38,2670,-152
"17660",NA,16055,"Kootenai County, ID","County or equivalent",2008,137475,3264,708,1778,1070,2708,38,2670,-152
"17780",NA,NA,"College Station-Bryan, TX","Metropolitan Statistical Area",2008,207425,4226,1968,3155,1187,2276,889,1387,-18
"17780",NA,48041,"Brazos County, TX","County or equivalent",2008,175122,4238,1834,2698,864,2418,866,1552,-14
"17780",NA,48051,"Burleson County, TX","County or equivalent",2008,16610,48,75,226,151,-15,9,-24,-12
"17780",NA,48395,"Robertson County, TX","County or equivalent",2008,15693,-60,59,231,172,-127,14,-141,8
"17820",NA,NA,"Colorado Springs, CO","Metropolitan Statistical Area",2008,617714,9856,5789,9361,3572,3860,986,2874,207
"17820",NA,8041,"El Paso County, CO","County or equivalent",2008,596053,9977,5679,9136,3457,4071,983,3088,227
"17820",NA,8119,"Teller County, CO","County or equivalent",2008,21661,-121,110,225,115,-211,3,-214,-20
"17860",NA,NA,"Columbia, MO","Metropolitan Statistical Area",2008,164283,2367,1329,2317,988,1000,326,674,38
"17860",NA,29019,"Boone County, MO","County or equivalent",2008,154365,2316,1314,2198,884,970,325,645,32
"17860",NA,29089,"Howard County, MO","County or equivalent",2008,9918,51,15,119,104,30,1,29,6
"17900",NA,NA,"Columbia, SC","Metropolitan Statistical Area",2008,728063,12385,3795,9739,5944,8446,883,7563,144
"17900",NA,45017,"Calhoun County, SC","County or equivalent",2008,14583,-164,-5,163,168,-159,3,-162,0
"17900",NA,45039,"Fairfield County, SC","County or equivalent",2008,23435,151,7,297,290,130,3,127,14
"17900",NA,45055,"Kershaw County, SC","County or equivalent",2008,58901,763,247,802,555,482,14,468,34
"17900",NA,45063,"Lexington County, SC","County or equivalent",2008,248518,5721,1407,3378,1971,4313,291,4022,1
"17900",NA,45079,"Richland County, SC","County or equivalent",2008,364001,5981,2114,4858,2744,3783,481,3302,84
"17900",NA,45081,"Saluda County, SC","County or equivalent",2008,18625,-67,25,241,216,-103,91,-194,11
"17980",NA,NA,"Columbus, GA-AL","Metropolitan Statistical Area",2008,287653,764,1761,4494,2733,-1078,377,-1455,81
"17980",NA,1113,"Russell County, AL","County or equivalent",2008,50504,317,145,706,561,144,39,105,28
"17980",NA,13053,"Chattahoochee County, GA","County or equivalent",2008,13754,-147,193,213,20,-340,31,-371,0
"17980",NA,13145,"Harris County, GA","County or equivalent",2008,29447,433,127,359,232,296,10,286,10
"17980",NA,13197,"Marion County, GA","County or equivalent",2008,6964,-16,29,107,78,-36,18,-54,-9
"17980",NA,13215,"Muscogee County, GA","County or equivalent",2008,186984,177,1267,3109,1842,-1142,279,-1421,52
"18020",NA,NA,"Columbus, IN","Metropolitan Statistical Area",2008,75360,782,396,1079,683,368,177,191,18
"18020",NA,18005,"Bartholomew County, IN","County or equivalent",2008,75360,782,396,1079,683,368,177,191,18
"18140",NA,NA,"Columbus, OH","Metropolitan Statistical Area",2008,1773120,20110,14211,27219,13008,5846,3347,2499,53
"18140",NA,39041,"Delaware County, OH","County or equivalent",2008,165026,4668,1857,2633,776,2838,50,2788,-27
"18140",NA,39045,"Fairfield County, OH","County or equivalent",2008,142223,1178,788,1843,1055,325,15,310,65
"18140",NA,39049,"Franklin County, OH","County or equivalent",2008,1129067,12118,9760,18207,8447,2384,3210,-826,-26
"18140",NA,39089,"Licking County, OH","County or equivalent",2008,157721,987,832,2171,1339,91,41,50,64
"18140",NA,39097,"Madison County, OH","County or equivalent",2008,41861,188,164,509,345,17,18,-1,7
"18140",NA,39117,"Morrow County, OH","County or equivalent",2008,34455,-22,186,458,272,-179,2,-181,-29
"18140",NA,39129,"Pickaway County, OH","County or equivalent",2008,54544,381,186,660,474,187,1,186,8
"18140",NA,39159,"Union County, OH","County or equivalent",2008,48223,612,438,738,300,183,10,173,-9
"18580",NA,NA,"Corpus Christi, TX","Metropolitan Statistical Area",2008,415376,2322,3285,6661,3376,-1008,464,-1472,45
"18580",NA,48007,"Aransas County, TX","County or equivalent",2008,24900,351,-2,281,283,367,31,336,-14
"18580",NA,48355,"Nueces County, TX","County or equivalent",2008,322077,1957,2683,5200,2517,-766,393,-1159,40
"18580",NA,48409,"San Patricio County, TX","County or equivalent",2008,68399,14,604,1180,576,-609,40,-649,19
"18700",NA,NA,"Corvallis, OR","Metropolitan Statistical Area",2008,81859,708,353,863,510,367,270,97,-12
"18700",NA,41003,"Benton County, OR","County or equivalent",2008,81859,708,353,863,510,367,270,97,-12
"19060",NA,NA,"Cumberland, MD-WV","Metropolitan Statistical Area",2008,99033,-269,-138,1016,1154,-92,11,-103,-39
"19060",NA,24001,"Allegany County, MD","County or equivalent",2008,72238,-365,-168,714,882,-212,8,-220,15
"19060",NA,54057,"Mineral County, WV","County or equivalent",2008,26795,96,30,302,272,120,3,117,-54
"19100",NA,NA,"Dallas-Fort Worth-Arlington, TX","Metropolitan Statistical Area",2008,6300006,146532,70852,106131,35279,75468,32293,43175,212
"19100",19124,NA,"Dallas-Plano-Irving, TX","Metropolitan Division",2008,4226003,97036,48888,71303,22415,48554,24945,23609,-406
"19100",19124,48085,"Collin County, TX","County or equivalent",2008,762010,31104,9052,11891,2839,22182,2537,19645,-130
"19100",19124,48113,"Dallas County, TX","County or equivalent",2008,2412827,29648,28342,42533,14191,1458,20305,-18847,-152
"19100",19124,48119,"Delta County, TX","County or equivalent",2008,5458,90,4,62,58,86,1,85,0
"19100",19124,48121,"Denton County, TX","County or equivalent",2008,636557,22897,7876,10275,2399,15135,1431,13704,-114
"19100",19124,48139,"Ellis County, TX","County or equivalent",2008,148186,5188,1447,2422,975,3785,287,3498,-44
"19100",19124,48231,"Hunt County, TX","County or equivalent",2008,82805,100,388,1165,777,-309,158,-467,21
"19100",19124,48257,"Kaufman County, TX","County or equivalent",2008,100527,4069,864,1638,774,3149,149,3000,56
"19100",19124,48397,"Rockwall County, TX","County or equivalent",2008,77633,3940,915,1317,402,3068,77,2991,-43
"19100",23104,NA,"Fort Worth-Arlington, TX","Metropolitan Division",2008,2074003,49496,21964,34828,12864,26914,7348,19566,618
"19100",23104,48251,"Johnson County, TX","County or equivalent",2008,153630,4266,1048,2189,1141,3174,200,2974,44
"19100",23104,48367,"Parker County, TX","County or equivalent",2008,111776,3343,582,1410,828,2703,64,2639,58
"19100",23104,48439,"Tarrant County, TX","County or equivalent",2008,1750091,40842,20046,30483,10437,20296,6994,13302,500
"19100",23104,48497,"Wise County, TX","County or equivalent",2008,58506,1045,288,746,458,741,90,651,16
"19140",NA,NA,"Dalton, GA","Metropolitan Statistical Area",2008,134139,972,1503,2487,984,-468,759,-1227,-63
"19140",NA,13213,"Murray County, GA","County or equivalent",2008,40304,-230,315,600,285,-518,49,-567,-27
"19140",NA,13313,"Whitfield County, GA","County or equivalent",2008,93835,1202,1188,1887,699,50,710,-660,-36
"19180",NA,NA,"Danville, IL","Metropolitan Statistical Area",2008,80680,-487,132,1095,963,-655,39,-694,36
"19180",NA,17183,"Vermilion County, IL","County or equivalent",2008,80680,-487,132,1095,963,-655,39,-694,36
"19260",NA,NA,"Danville, VA","Metropolitan Statistical Area",2008,105783,-165,-84,1273,1357,-46,66,-112,-35
"19260",NA,51143,"Pittsylvania County, VA","County or equivalent",2008,61123,143,95,704,609,74,32,42,-26
"19260",NA,51590,"Danville city, VA","County or equivalent",2008,44660,-308,-179,569,748,-120,34,-154,-9
"19340",NA,NA,"Davenport-Moline-Rock Island, IA-IL","Metropolitan Statistical Area",2008,377626,1988,1798,5195,3397,4,426,-422,186
"19340",NA,17073,"Henry County, IL","County or equivalent",2008,49569,-35,63,585,522,-130,21,-151,32
"19340",NA,17131,"Mercer County, IL","County or equivalent",2008,16481,28,0,180,180,20,2,18,8
"19340",NA,17161,"Rock Island County, IL","County or equivalent",2008,146886,-250,613,2057,1444,-933,227,-1160,70
"19340",NA,19163,"Scott County, IA","County or equivalent",2008,164690,2245,1122,2373,1251,1047,176,871,76
"19380",NA,NA,"Dayton, OH","Metropolitan Statistical Area",2008,836544,-2284,2955,10973,8018,-5333,484,-5817,94
"19380",NA,39057,"Greene County, OH","County or equivalent",2008,159190,596,665,1911,1246,-75,162,-237,6
"19380",NA,39109,"Miami County, OH","County or equivalent",2008,101085,239,356,1283,927,-175,43,-218,58
"19380",NA,39113,"Montgomery County, OH","County or equivalent",2008,534626,-3130,1823,7258,5435,-5003,271,-5274,50
"19380",NA,39135,"Preble County, OH","County or equivalent",2008,41643,11,111,521,410,-80,8,-88,-20
"19460",NA,NA,"Decatur, AL","Metropolitan Statistical Area",2008,150125,1130,497,1979,1482,585,149,436,48
"19460",NA,1079,"Lawrence County, AL","County or equivalent",2008,34166,-40,67,405,338,-117,7,-124,10
"19460",NA,1103,"Morgan County, AL","County or equivalent",2008,115959,1170,430,1574,1144,702,142,560,38
"19500",NA,NA,"Decatur, IL","Metropolitan Statistical Area",2008,108328,-336,266,1429,1163,-636,43,-679,34
"19500",NA,17115,"Macon County, IL","County or equivalent",2008,108328,-336,266,1429,1163,-636,43,-679,34
"19660",NA,NA,"Deltona-Daytona Beach-Ormond Beach, FL","Metropolitan Statistical Area",2008,498036,-1698,-702,5519,6221,-1438,689,-2127,442
"19660",NA,12127,"Volusia County, FL","County or equivalent",2008,498036,-1698,-702,5519,6221,-1438,689,-2127,442
"19740",NA,NA,"Denver-Aurora, CO /1","Metropolitan Statistical Area",2008,2506626,53233,24977,39364,14387,28168,10296,17872,88
"19740",NA,8001,"Adams County, CO /1","County or equivalent",2008,430836,10003,5249,7586,2337,4815,1969,2846,-61
"19740",NA,8005,"Arapahoe County, CO /1","County or equivalent",2008,554282,10975,5204,8383,3179,5662,2073,3589,109
"19740",NA,8014,"Broomfield County, CO /1","County or equivalent",2008,54858,1238,596,867,271,628,88,540,14
"19740",NA,8019,"Clear Creek County, CO /1","County or equivalent",2008,8908,-25,47,94,47,-47,0,-47,-25
"19740",NA,8031,"Denver County, CO /1","County or equivalent",2008,598707,15847,6969,11186,4217,8872,4940,3932,6
"19740",NA,8035,"Douglas County, CO /1","County or equivalent",2008,280621,9589,3769,4479,710,5795,321,5474,25
"19740",NA,8039,"Elbert County, CO /1","County or equivalent",2008,22929,273,101,198,97,165,5,160,7
"19740",NA,8047,"Gilpin County, CO /1","County or equivalent",2008,5153,68,29,53,24,37,1,36,2
"19740",NA,8059,"Jefferson County, CO /1","County or equivalent",2008,533339,5225,2938,6369,3431,2255,893,1362,32
"19740",NA,8093,"Park County, CO /1","County or equivalent",2008,16993,40,75,149,74,-14,6,-20,-21
"19780",NA,NA,"Des Moines-West Des Moines, IA","Metropolitan Statistical Area",2008,556230,10561,4924,8801,3877,5472,1089,4383,165
"19780",NA,19049,"Dallas County, IA","County or equivalent",2008,59930,2729,618,945,327,2095,56,2039,16
"19780",NA,19077,"Guthrie County, IA","County or equivalent",2008,10956,-59,-12,125,137,-34,1,-35,-13
"19780",NA,19121,"Madison County, IA","County or equivalent",2008,15507,130,62,208,146,72,-1,73,-4
"19780",NA,19153,"Polk County, IA","County or equivalent",2008,424778,7110,4041,6945,2904,2896,1025,1871,173
"19780",NA,19181,"Warren County, IA","County or equivalent",2008,45059,651,215,578,363,443,8,435,-7
"19820",NA,NA,"Detroit-Warren-Livonia, MI","Metropolitan Statistical Area",2008,4425110,-32413,19284,56901,37617,-52089,10071,-62160,392
"19820",19804,NA,"Detroit-Livonia-Dearborn, MI","Metropolitan Division",2008,1949929,-31725,9159,27389,18230,-40530,4610,-45140,-354
"19820",19804,26163,"Wayne County, MI","County or equivalent",2008,1949929,-31725,9159,27389,18230,-40530,4610,-45140,-354
"19820",47644,NA,"Warren-Troy-Farmington Hills, MI","Metropolitan Division",2008,2475181,-688,10125,29512,19387,-11559,5461,-17020,746
"19820",47644,26087,"Lapeer County, MI","County or equivalent",2008,90875,-848,410,1057,647,-1298,32,-1330,40
"19820",47644,26093,"Livingston County, MI","County or equivalent",2008,182575,-80,1012,2101,1089,-1128,125,-1253,36
"19820",47644,26099,"Macomb County, MI","County or equivalent",2008,830663,1299,2912,10153,7241,-1797,1505,-3302,184
"19820",47644,26125,"Oakland County, MI","County or equivalent",2008,1202174,-113,5164,14118,8954,-5698,3730,-9428,421
"19820",47644,26147,"St. Clair County, MI","County or equivalent",2008,168894,-946,627,2083,1456,-1638,69,-1707,65
"20020",NA,NA,"Dothan, AL","Metropolitan Statistical Area",2008,140961,1625,469,1896,1427,1176,48,1128,-20
"20020",NA,1061,"Geneva County, AL","County or equivalent",2008,25882,188,0,297,297,189,3,186,-1
"20020",NA,1067,"Henry County, AL","County or equivalent",2008,16591,12,-9,203,212,11,6,5,10
"20020",NA,1069,"Houston County, AL","County or equivalent",2008,98488,1425,478,1396,918,976,39,937,-29
"20100",NA,NA,"Dover, DE","Metropolitan Statistical Area",2008,155415,3710,1145,2358,1213,2634,125,2509,-69
"20100",NA,10001,"Kent County, DE","County or equivalent",2008,155415,3710,1145,2358,1213,2634,125,2509,-69
"20220",NA,NA,"Dubuque, IA","Metropolitan Statistical Area",2008,92724,428,457,1256,799,-88,86,-174,59
"20220",NA,19061,"Dubuque County, IA","County or equivalent",2008,92724,428,457,1256,799,-88,86,-174,59
"20260",NA,NA,"Duluth, MN-WI","Metropolitan Statistical Area",2008,274571,814,420,3215,2795,327,86,241,67
"20260",NA,27017,"Carlton County, MN","County or equivalent",2008,33933,310,104,436,332,183,5,178,23
"20260",NA,27137,"St. Louis County, MN","County or equivalent",2008,196864,444,226,2265,2039,185,58,127,33
"20260",NA,55031,"Douglas County, WI","County or equivalent",2008,43774,60,90,514,424,-41,23,-64,11
"20500",NA,NA,"Durham, NC","Metropolitan Statistical Area",2008,489762,11759,3645,7015,3370,8008,2420,5588,106
"20500",NA,37037,"Chatham County, NC","County or equivalent",2008,63077,2048,239,779,540,1798,280,1518,11
"20500",NA,37063,"Durham County, NC","County or equivalent",2008,262715,7355,2630,4315,1685,4640,1544,3096,85
"20500",NA,37135,"Orange County, NC","County or equivalent",2008,126532,2224,704,1439,735,1529,579,950,-9
"20500",NA,37145,"Person County, NC","County or equivalent",2008,37438,132,72,482,410,41,17,24,19
"20740",NA,NA,"Eau Claire, WI","Metropolitan Statistical Area",2008,158742,1193,827,2050,1223,322,61,261,44
"20740",NA,55017,"Chippewa County, WI","County or equivalent",2008,60456,456,277,795,518,150,12,138,29
"20740",NA,55035,"Eau Claire County, WI","County or equivalent",2008,98286,737,550,1255,705,172,49,123,15
"20940",NA,NA,"El Centro, CA","Metropolitan Statistical Area",2008,163972,3142,2486,3488,1002,642,852,-210,14
"20940",NA,6025,"Imperial County, CA","County or equivalent",2008,163972,3142,2486,3488,1002,642,852,-210,14
"21060",NA,NA,"Elizabethtown, KY","Metropolitan Statistical Area",2008,112268,676,818,1725,907,-180,109,-289,38
"21060",NA,21093,"Hardin County, KY","County or equivalent",2008,98546,622,822,1561,739,-230,109,-339,30
"21060",NA,21123,"Larue County, KY","County or equivalent",2008,13722,54,-4,164,168,50,0,50,8
"21140",NA,NA,"Elkhart-Goshen, IN","Metropolitan Statistical Area",2008,199137,1498,2039,3411,1372,-550,667,-1217,9
"21140",NA,18039,"Elkhart County, IN","County or equivalent",2008,199137,1498,2039,3411,1372,-550,667,-1217,9
"21300",NA,NA,"Elmira, NY","Metropolitan Statistical Area",2008,87813,-100,172,1081,909,-269,34,-303,-3
"21300",NA,36015,"Chemung County, NY","County or equivalent",2008,87813,-100,172,1081,909,-269,34,-303,-3
"21340",NA,NA,"El Paso, TX","Metropolitan Statistical Area",2008,742062,12093,10626,15224,4598,1572,3512,-1940,-105
"21340",NA,48141,"El Paso County, TX","County or equivalent",2008,742062,12093,10626,15224,4598,1572,3512,-1940,-105
"21500",NA,NA,"Erie, PA","Metropolitan Statistical Area",2008,279175,-118,730,3379,2649,-920,331,-1251,72
"21500",NA,42049,"Erie County, PA","County or equivalent",2008,279175,-118,730,3379,2649,-920,331,-1251,72
"21660",NA,NA,"Eugene-Springfield, OR","Metropolitan Statistical Area",2008,346560,3779,1017,3938,2921,2699,541,2158,63
"21660",NA,41039,"Lane County, OR","County or equivalent",2008,346560,3779,1017,3938,2921,2699,541,2158,63
"21780",NA,NA,"Evansville, IN-KY","Metropolitan Statistical Area",2008,350261,538,1206,4645,3439,-778,165,-943,110
"21780",NA,18051,"Gibson County, IN","County or equivalent",2008,32666,-43,108,415,307,-128,10,-138,-23
"21780",NA,18129,"Posey County, IN","County or equivalent",2008,26079,-129,48,255,207,-165,7,-172,-12
"21780",NA,18163,"Vanderburgh County, IN","County or equivalent",2008,174729,-40,604,2444,1840,-758,101,-859,114
"21780",NA,18173,"Warrick County, IN","County or equivalent",2008,57656,660,227,720,493,429,12,417,4
"21780",NA,21101,"Henderson County, KY","County or equivalent",2008,45462,279,178,618,440,76,18,58,25
"21780",NA,21233,"Webster County, KY","County or equivalent",2008,13669,-189,41,193,152,-232,17,-249,2
"21820",NA,NA,"Fairbanks, AK","Metropolitan Statistical Area",2008,97970,-16,1499,1825,326,-1507,103,-1610,-8
"21820",NA,2090,"Fairbanks North Star Borough, AK","County or equivalent",2008,97970,-16,1499,1825,326,-1507,103,-1610,-8
"22020",NA,NA,"Fargo, ND-MN","Metropolitan Statistical Area",2008,195685,3755,1708,2900,1192,1970,283,1687,77
"22020",NA,27027,"Clay County, MN","County or equivalent",2008,55767,1172,380,786,406,762,30,732,30
"22020",NA,38017,"Cass County, ND","County or equivalent",2008,139918,2583,1328,2114,786,1208,253,955,47
"22140",NA,NA,"Farmington, NM","Metropolitan Statistical Area",2008,122500,261,1150,2018,868,-896,95,-991,7
"22140",NA,35045,"San Juan County, NM","County or equivalent",2008,122500,261,1150,2018,868,-896,95,-991,7
"22180",NA,NA,"Fayetteville, NC","Metropolitan Statistical Area",2008,356105,5023,4050,6375,2325,1037,702,335,-64
"22180",NA,37051,"Cumberland County, NC","County or equivalent",2008,312696,3749,3505,5561,2056,300,586,-286,-56
"22180",NA,37093,"Hoke County, NC","County or equivalent",2008,43409,1274,545,814,269,737,116,621,-8
"22220",NA,NA,"Fayetteville-Springdale-Rogers, AR-MO","Metropolitan Statistical Area",2008,443976,9333,4754,7580,2826,4630,1112,3518,-51
"22220",NA,5007,"Benton County, AR","County or equivalent",2008,209791,7152,2175,3488,1313,5029,385,4644,-52
"22220",NA,5087,"Madison County, AR","County or equivalent",2008,15651,262,75,217,142,194,5,189,-7
"22220",NA,5143,"Washington County, AR","County or equivalent",2008,195803,1991,2312,3498,1186,-350,662,-1012,29
"22220",NA,29119,"McDonald County, MO","County or equivalent",2008,22731,-72,192,377,185,-243,60,-303,-21
"22380",NA,NA,"Flagstaff, AZ","Metropolitan Statistical Area",2008,128558,1208,1526,2174,648,-252,154,-406,-66
"22380",NA,4005,"Coconino County, AZ","County or equivalent",2008,128558,1208,1526,2174,648,-252,154,-406,-66
"22420",NA,NA,"Flint, MI","Metropolitan Statistical Area",2008,428790,-5237,2245,6058,3813,-7462,119,-7581,-20
"22420",NA,26049,"Genesee County, MI","County or equivalent",2008,428790,-5237,2245,6058,3813,-7462,119,-7581,-20
"22500",NA,NA,"Florence, SC","Metropolitan Statistical Area",2008,199831,1294,704,2831,2127,478,77,401,112
"22500",NA,45031,"Darlington County, SC","County or equivalent",2008,67031,225,91,855,764,95,19,76,39
"22500",NA,45041,"Florence County, SC","County or equivalent",2008,132800,1069,613,1976,1363,383,58,325,73
"22520",NA,NA,"Florence-Muscle Shoals, AL","Metropolitan Statistical Area",2008,143791,784,14,1630,1616,716,46,670,54
"22520",NA,1033,"Colbert County, AL","County or equivalent",2008,54663,144,-15,625,640,157,11,146,2
"22520",NA,1077,"Lauderdale County, AL","County or equivalent",2008,89128,640,29,1005,976,559,35,524,52
"22540",NA,NA,"Fond du Lac, WI","Metropolitan Statistical Area",2008,99453,410,376,1274,898,-20,83,-103,54
"22540",NA,55039,"Fond du Lac County, WI","County or equivalent",2008,99453,410,376,1274,898,-20,83,-103,54
"22660",NA,NA,"Fort Collins-Loveland, CO","Metropolitan Statistical Area",2008,292825,6098,2111,3751,1640,4053,491,3562,-66
"22660",NA,8069,"Larimer County, CO","County or equivalent",2008,292825,6098,2111,3751,1640,4053,491,3562,-66
"22900",NA,NA,"Fort Smith, AR-OK","Metropolitan Statistical Area",2008,290977,2064,1661,4404,2743,331,420,-89,72
"22900",NA,5033,"Crawford County, AR","County or equivalent",2008,59682,743,327,844,517,403,18,385,13
"22900",NA,5047,"Franklin County, AR","County or equivalent",2008,18185,33,41,234,193,-15,7,-22,7
"22900",NA,5131,"Sebastian County, AR","County or equivalent",2008,122274,888,939,1981,1042,-86,317,-403,35
"22900",NA,40079,"Le Flore County, OK","County or equivalent",2008,49802,292,210,762,552,57,69,-12,25
"22900",NA,40135,"Sequoyah County, OK","County or equivalent",2008,41034,108,144,583,439,-28,9,-37,-8
"23020",NA,NA,"Fort Walton Beach-Crestview-Destin, FL","Metropolitan Statistical Area",2008,179693,-1394,1261,2677,1416,-2431,171,-2602,-224
"23020",NA,12091,"Okaloosa County, FL","County or equivalent",2008,179693,-1394,1261,2677,1416,-2431,171,-2602,-224
"23060",NA,NA,"Fort Wayne, IN","Metropolitan Statistical Area",2008,411154,1977,2978,6237,3259,-1142,619,-1761,141
"23060",NA,18003,"Allen County, IN","County or equivalent",2008,350523,1762,2720,5433,2713,-1084,611,-1695,126
"23060",NA,18179,"Wells County, IN","County or equivalent",2008,27964,65,103,358,255,-37,1,-38,-1
"23060",NA,18183,"Whitley County, IN","County or equivalent",2008,32667,150,155,446,291,-21,7,-28,16
"23420",NA,NA,"Fresno, CA","Metropolitan Statistical Area",2008,909153,14405,11354,17406,6052,2793,3676,-883,258
"23420",NA,6019,"Fresno County, CA","County or equivalent",2008,909153,14405,11354,17406,6052,2793,3676,-883,258
"23460",NA,NA,"Gadsden, AL","Metropolitan Statistical Area",2008,103303,223,-43,1283,1326,194,66,128,72
"23460",NA,1055,"Etowah County, AL","County or equivalent",2008,103303,223,-43,1283,1326,194,66,128,72
"23540",NA,NA,"Gainesville, FL","Metropolitan Statistical Area",2008,258555,2138,1403,3180,1777,749,679,70,-14
"23540",NA,12001,"Alachua County, FL","County or equivalent",2008,241364,1930,1356,2966,1610,595,677,-82,-21
"23540",NA,12041,"Gilchrist County, FL","County or equivalent",2008,17191,208,47,214,167,154,2,152,7
"23580",NA,NA,"Gainesville, GA","Metropolitan Statistical Area",2008,184814,6194,2194,3385,1191,4039,1290,2749,-39
"23580",NA,13139,"Hall County, GA","County or equivalent",2008,184814,6194,2194,3385,1191,4039,1290,2749,-39
"24020",NA,NA,"Glens Falls, NY","Metropolitan Statistical Area",2008,128775,305,141,1403,1262,91,30,61,73
"24020",NA,36113,"Warren County, NY","County or equivalent",2008,65971,70,60,696,636,-23,23,-46,33
"24020",NA,36115,"Washington County, NY","County or equivalent",2008,62804,235,81,707,626,114,7,107,40
"24140",NA,NA,"Goldsboro, NC","Metropolitan Statistical Area",2008,113671,275,784,1839,1055,-466,226,-692,-43
"24140",NA,37191,"Wayne County, NC","County or equivalent",2008,113671,275,784,1839,1055,-466,226,-692,-43
"24220",NA,NA,"Grand Forks, ND-MN","Metropolitan Statistical Area",2008,97279,498,627,1402,775,-126,112,-238,-3
"24220",NA,27119,"Polk County, MN","County or equivalent",2008,30694,-61,67,424,357,-135,8,-143,7
"24220",NA,38035,"Grand Forks County, ND","County or equivalent",2008,66585,559,560,978,418,9,104,-95,-10
"24300",NA,NA,"Grand Junction, CO","Metropolitan Statistical Area",2008,143171,4288,903,2169,1266,3422,93,3329,-37
"24300",NA,8077,"Mesa County, CO","County or equivalent",2008,143171,4288,903,2169,1266,3422,93,3329,-37
"24340",NA,NA,"Grand Rapids-Wyoming, MI","Metropolitan Statistical Area",2008,776833,1902,6536,11875,5339,-4756,1687,-6443,122
"24340",NA,26015,"Barry County, MI","County or equivalent",2008,58890,-225,268,740,472,-481,3,-484,-12
"24340",NA,26067,"Ionia County, MI","County or equivalent",2008,63833,-208,421,856,435,-605,11,-616,-24
"24340",NA,26081,"Kent County, MI","County or equivalent",2008,605213,2537,5606,9618,4012,-3249,1651,-4900,180
"24340",NA,26123,"Newaygo County, MI","County or equivalent",2008,48897,-202,241,661,420,-421,22,-443,-22
"24500",NA,NA,"Great Falls, MT","Metropolitan Statistical Area",2008,82026,242,435,1177,742,-184,32,-216,-9
"24500",NA,30013,"Cascade County, MT","County or equivalent",2008,82026,242,435,1177,742,-184,32,-216,-9
"24540",NA,NA,"Greeley, CO /1","Metropolitan Statistical Area",2008,249775,7127,3088,4382,1294,3995,690,3305,44
"24540",NA,8123,"Weld County, CO /1","County or equivalent",2008,249775,7127,3088,4382,1294,3995,690,3305,44
"24580",NA,NA,"Green Bay, WI","Metropolitan Statistical Area",2008,302935,1879,2096,4176,2080,-289,385,-674,72
"24580",NA,55009,"Brown County, WI","County or equivalent",2008,245018,1852,1953,3533,1580,-168,382,-550,67
"24580",NA,55061,"Kewaunee County, WI","County or equivalent",2008,20388,-75,44,228,184,-130,2,-132,11
"24580",NA,55083,"Oconto County, WI","County or equivalent",2008,37529,102,99,415,316,9,1,8,-6
"24660",NA,NA,"Greensboro-High Point, NC","Metropolitan Statistical Area",2008,705684,9946,3673,9515,5842,6014,2155,3859,259
"24660",NA,37081,"Guilford County, NC","County or equivalent",2008,472216,8182,2897,6492,3595,5100,1523,3577,185
"24660",NA,37151,"Randolph County, NC","County or equivalent",2008,141186,1674,698,1907,1209,900,485,415,76
"24660",NA,37157,"Rockingham County, NC","County or equivalent",2008,92282,90,78,1116,1038,14,147,-133,-2
"24780",NA,NA,"Greenville, NC","Metropolitan Statistical Area",2008,176758,3920,1326,2623,1297,2573,305,2268,21
"24780",NA,37079,"Greene County, NC","County or equivalent",2008,20677,-23,76,262,186,-90,66,-156,-9
"24780",NA,37147,"Pitt County, NC","County or equivalent",2008,156081,3943,1250,2361,1111,2663,239,2424,30
"24860",NA,NA,"Greenville-Mauldin-Easley, SC","Metropolitan Statistical Area",2008,624715,12148,3052,8350,5298,8822,1229,7593,274
"24860",NA,45045,"Greenville County, SC","County or equivalent",2008,438119,10691,2638,6204,3566,7879,1001,6878,174
"24860",NA,45059,"Laurens County, SC","County or equivalent",2008,69681,148,47,792,745,59,64,-5,42
"24860",NA,45077,"Pickens County, SC","County or equivalent",2008,116915,1309,367,1354,987,884,164,720,58
"25060",NA,NA,"Gulfport-Biloxi, MS","Metropolitan Statistical Area",2008,234625,2969,1493,3526,2033,1993,186,1807,-517
"25060",NA,28045,"Hancock County, MS","County or equivalent",2008,40140,399,123,469,346,403,10,393,-127
"25060",NA,28047,"Harrison County, MS","County or equivalent",2008,178460,2094,1275,2824,1549,1208,174,1034,-389
"25060",NA,28131,"Stone County, MS","County or equivalent",2008,16025,476,95,233,138,382,2,380,-1
"25180",NA,NA,"Hagerstown-Martinsburg, MD-WV","Metropolitan Statistical Area",2008,263753,3214,1144,3459,2315,1995,79,1916,75
"25180",NA,24043,"Washington County, MD","County or equivalent",2008,145384,722,560,1910,1350,92,58,34,70
"25180",NA,54003,"Berkeley County, WV","County or equivalent",2008,102044,2513,623,1395,772,1867,16,1851,23
"25180",NA,54065,"Morgan County, WV","County or equivalent",2008,16325,-21,-39,154,193,36,5,31,-18
"25260",NA,NA,"Hanford-Corcoran, CA","Metropolitan Statistical Area",2008,149518,1286,1937,2747,810,-675,464,-1139,24
"25260",NA,6031,"Kings County, CA","County or equivalent",2008,149518,1286,1937,2747,810,-675,464,-1139,24
"25420",NA,NA,"Harrisburg-Carlisle, PA","Metropolitan Statistical Area",2008,531108,3228,1564,6422,4858,1683,640,1043,-19
"25420",NA,42041,"Cumberland County, PA","County or equivalent",2008,229361,2158,381,2472,2091,1725,236,1489,52
"25420",NA,42043,"Dauphin County, PA","County or equivalent",2008,256562,970,1004,3383,2379,43,403,-360,-77
"25420",NA,42099,"Perry County, PA","County or equivalent",2008,45185,100,179,567,388,-85,1,-86,6
"25500",NA,NA,"Harrisonburg, VA","Metropolitan Statistical Area",2008,118409,980,725,1597,872,246,320,-74,9
"25500",NA,51165,"Rockingham County, VA","County or equivalent",2008,74394,721,345,967,622,350,95,255,26
"25500",NA,51660,"Harrisonburg city, VA","County or equivalent",2008,44015,259,380,630,250,-104,225,-329,-17
"25540",NA,NA,"Hartford-West Hartford-East Hartford, CT","Metropolitan Statistical Area",2008,1190512,4027,4290,13893,9603,-352,3334,-3686,89
"25540",NA,9003,"Hartford County, CT","County or equivalent",2008,877312,2237,3329,10760,7431,-1138,2927,-4065,46
"25540",NA,9007,"Middlesex County, CT","County or equivalent",2008,164794,967,431,1730,1299,464,209,255,72
"25540",NA,9013,"Tolland County, CT","County or equivalent",2008,148406,823,530,1403,873,322,198,124,-29
"25620",NA,NA,"Hattiesburg, MS","Metropolitan Statistical Area",2008,140781,2312,1184,2297,1113,1126,96,1030,2
"25620",NA,28035,"Forrest County, MS","County or equivalent",2008,79425,814,598,1287,689,212,89,123,4
"25620",NA,28073,"Lamar County, MS","County or equivalent",2008,49121,1473,511,828,317,962,7,955,0
"25620",NA,28111,"Perry County, MS","County or equivalent",2008,12235,25,75,182,107,-48,0,-48,-2
"25860",NA,NA,"Hickory-Lenoir-Morganton, NC","Metropolitan Statistical Area",2008,363036,3467,1297,4542,3245,2065,750,1315,105
"25860",NA,37003,"Alexander County, NC","County or equivalent",2008,36537,239,142,436,294,83,30,53,14
"25860",NA,37023,"Burke County, NC","County or equivalent",2008,89361,574,191,1018,827,357,161,196,26
"25860",NA,37027,"Caldwell County, NC","County or equivalent",2008,80059,698,178,950,772,504,75,429,16
"25860",NA,37035,"Catawba County, NC","County or equivalent",2008,157079,1956,786,2138,1352,1121,484,637,49
"25980",NA,NA,"Hinesville-Fort Stewart, GA","Metropolitan Statistical Area",2008,69943,-1783,1079,1446,367,-2897,161,-3058,35
"25980",NA,13179,"Liberty County, GA","County or equivalent",2008,58491,-1939,999,1297,298,-2975,125,-3100,37
"25980",NA,13183,"Long County, GA","County or equivalent",2008,11452,156,80,149,69,78,36,42,-2
"26100",NA,NA,"Holland-Grand Haven, MI","Metropolitan Statistical Area",2008,260364,1903,2278,3801,1523,-485,266,-751,110
"26100",NA,26139,"Ottawa County, MI","County or equivalent",2008,260364,1903,2278,3801,1523,-485,266,-751,110
"26180",NA,NA,"Honolulu, HI","Metropolitan Statistical Area",2008,905034,4509,6918,13521,6603,-2931,3260,-6191,522
"26180",NA,15003,"Honolulu County, HI","County or equivalent",2008,905034,4509,6918,13521,6603,-2931,3260,-6191,522
"26300",NA,NA,"Hot Springs, AR","Metropolitan Statistical Area",2008,97465,1220,-70,1215,1285,1226,52,1174,64
"26300",NA,5051,"Garland County, AR","County or equivalent",2008,97465,1220,-70,1215,1285,1226,52,1174,64
"26380",NA,NA,"Houma-Bayou Cane-Thibodaux, LA","Metropolitan Statistical Area",2008,201148,128,1312,2953,1641,-950,93,-1043,-234
"26380",NA,22057,"Lafourche Parish, LA","County or equivalent",2008,92572,-132,429,1209,780,-488,44,-532,-73
"26380",NA,22109,"Terrebonne Parish, LA","County or equivalent",2008,108576,260,883,1744,861,-462,49,-511,-161
"26420",NA,NA,"Houston-Sugar Land-Baytown, TX","Metropolitan Statistical Area",2008,5728143,130185,64139,96953,32814,66116,29392,36724,-70
"26420",NA,48015,"Austin County, TX","County or equivalent",2008,26851,341,110,372,262,222,47,175,9
"26420",NA,48039,"Brazoria County, TX","County or equivalent",2008,301044,7953,3006,4982,1976,4864,550,4314,83
"26420",NA,48071,"Chambers County, TX","County or equivalent",2008,29356,616,195,383,188,426,37,389,-5
"26420",NA,48157,"Fort Bend County, TX","County or equivalent",2008,532141,24565,5593,7660,2067,18713,1455,17258,259
"26420",NA,48167,"Galveston County, TX","County or equivalent",2008,288239,5157,1918,4309,2391,3418,649,2769,-179
"26420",NA,48201,"Harris County, TX","County or equivalent",2008,3984349,72153,48647,70702,22055,23722,25557,-1835,-216
"26420",NA,48291,"Liberty County, TX","County or equivalent",2008,75333,403,417,1114,697,-43,80,-123,29
"26420",NA,48339,"Montgomery County, TX","County or equivalent",2008,429953,18699,3872,6560,2688,14877,919,13958,-50
"26420",NA,48407,"San Jacinto County, TX","County or equivalent",2008,24882,118,54,272,218,71,20,51,-7
"26420",NA,48473,"Waller County, TX","County or equivalent",2008,35995,180,327,599,272,-154,78,-232,7
"26580",NA,NA,"Huntington-Ashland, WV-KY-OH","Metropolitan Statistical Area",2008,284234,291,59,3419,3360,275,61,214,-43
"26580",NA,21019,"Boyd County, KY","County or equivalent",2008,48560,80,-4,583,587,123,8,115,-39
"26580",NA,21089,"Greenup County, KY","County or equivalent",2008,37388,150,16,431,415,128,1,127,6
"26580",NA,39087,"Lawrence County, OH","County or equivalent",2008,62573,-25,71,806,735,-88,8,-96,-8
"26580",NA,54011,"Cabell County, WV","County or equivalent",2008,94631,221,-7,1158,1165,169,37,132,59
"26580",NA,54099,"Wayne County, WV","County or equivalent",2008,41082,-135,-17,441,458,-57,7,-64,-61
"26620",NA,NA,"Huntsville, AL","Metropolitan Statistical Area",2008,395645,9323,1984,5096,3112,7169,405,6764,170
"26620",NA,1083,"Limestone County, AL","County or equivalent",2008,76135,2259,289,948,659,1928,31,1897,42
"26620",NA,1089,"Madison County, AL","County or equivalent",2008,319510,7064,1695,4148,2453,5241,374,4867,128
"26820",NA,NA,"Idaho Falls, ID","Metropolitan Statistical Area",2008,122995,3862,1669,2465,796,2206,108,2098,-13
"26820",NA,16019,"Bonneville County, ID","County or equivalent",2008,99135,2779,1291,1951,660,1510,86,1424,-22
"26820",NA,16051,"Jefferson County, ID","County or equivalent",2008,23860,1083,378,514,136,696,22,674,9
"26900",NA,NA,"Indianapolis-Carmel, IN","Metropolitan Statistical Area",2008,1715459,22722,13572,26361,12789,9008,2301,6707,142
"26900",NA,18011,"Boone County, IN","County or equivalent",2008,55027,1048,323,772,449,720,14,706,5
"26900",NA,18013,"Brown County, IN","County or equivalent",2008,14550,-91,-25,104,129,-44,4,-48,-22
"26900",NA,18057,"Hamilton County, IN","County or equivalent",2008,269785,8981,3026,4175,1149,5962,229,5733,-7
"26900",NA,18059,"Hancock County, IN","County or equivalent",2008,67282,1175,508,1021,513,648,5,643,19
"26900",NA,18063,"Hendricks County, IN","County or equivalent",2008,137240,3010,958,1782,824,1995,54,1941,57
"26900",NA,18081,"Johnson County, IN","County or equivalent",2008,139158,3126,858,1944,1086,2269,72,2197,-1
"26900",NA,18097,"Marion County, IN","County or equivalent",2008,880380,4236,7338,14691,7353,-3185,1855,-5040,83
"26900",NA,18109,"Morgan County, IN","County or equivalent",2008,70668,913,316,883,567,588,9,579,9
"26900",NA,18133,"Putnam County, IN","County or equivalent",2008,37183,44,114,424,310,-53,10,-63,-17
"26900",NA,18145,"Shelby County, IN","County or equivalent",2008,44186,280,156,565,409,108,49,59,16
"26980",NA,NA,"Iowa City, IA","Metropolitan Statistical Area",2008,149437,2747,1248,1988,740,1464,403,1061,35
"26980",NA,19103,"Johnson County, IA","County or equivalent",2008,128094,2640,1178,1705,527,1434,399,1035,28
"26980",NA,19183,"Washington County, IA","County or equivalent",2008,21343,107,70,283,213,30,4,26,7
"27060",NA,NA,"Ithaca, NY","Metropolitan Statistical Area",2008,101136,735,457,1017,560,282,532,-250,-4
"27060",NA,36109,"Tompkins County, NY","County or equivalent",2008,101136,735,457,1017,560,282,532,-250,-4
"27100",NA,NA,"Jackson, MI","Metropolitan Statistical Area",2008,160180,-2526,683,2164,1481,-3277,81,-3358,68
"27100",NA,26075,"Jackson County, MI","County or equivalent",2008,160180,-2526,683,2164,1481,-3277,81,-3358,68
"27140",NA,NA,"Jackson, MS","Metropolitan Statistical Area",2008,537285,3491,4070,8610,4540,-270,224,-494,-309
"27140",NA,28029,"Copiah County, MS","County or equivalent",2008,29331,28,168,472,304,-148,5,-153,8
"27140",NA,28049,"Hinds County, MS","County or equivalent",2008,247650,-1505,2062,4045,1983,-3452,93,-3545,-115
"27140",NA,28089,"Madison County, MS","County or equivalent",2008,91369,2048,442,1476,1034,1712,37,1675,-106
"27140",NA,28121,"Rankin County, MS","County or equivalent",2008,140901,2709,1289,2191,902,1529,74,1455,-109
"27140",NA,28127,"Simpson County, MS","County or equivalent",2008,28034,211,109,426,317,89,15,74,13
"27180",NA,NA,"Jackson, TN","Metropolitan Statistical Area",2008,112685,295,517,1585,1068,-257,108,-365,35
"27180",NA,47023,"Chester County, TN","County or equivalent",2008,16309,215,46,196,150,162,1,161,7
"27180",NA,47113,"Madison County, TN","County or equivalent",2008,96376,80,471,1389,918,-419,107,-526,28
"27260",NA,NA,"Jacksonville, FL","Metropolitan Statistical Area",2008,1313228,15415,8594,19103,10509,6444,1676,4768,377
"27260",NA,12003,"Baker County, FL","County or equivalent",2008,26164,473,192,407,215,283,2,281,-2
"27260",NA,12019,"Clay County, FL","County or equivalent",2008,184727,3048,1299,2615,1316,1671,151,1520,78
"27260",NA,12031,"Duval County, FL","County or equivalent",2008,850962,3998,6207,13153,6946,-2571,1384,-3955,362
"27260",NA,12089,"Nassau County, FL","County or equivalent",2008,69835,1514,235,876,641,1241,28,1213,38
"27260",NA,12109,"St. Johns County, FL","County or equivalent",2008,181540,6382,661,2052,1391,5820,111,5709,-99
"27340",NA,NA,"Jacksonville, NC","Metropolitan Statistical Area",2008,165938,2602,2722,3556,834,5,231,-226,-125
"27340",NA,37133,"Onslow County, NC","County or equivalent",2008,165938,2602,2722,3556,834,5,231,-226,-125
"27500",NA,NA,"Janesville, WI","Metropolitan Statistical Area",2008,160213,815,939,2198,1259,-160,208,-368,36
"27500",NA,55105,"Rock County, WI","County or equivalent",2008,160213,815,939,2198,1259,-160,208,-368,36
"27620",NA,NA,"Jefferson City, MO","Metropolitan Statistical Area",2008,146363,1193,869,1983,1114,286,104,182,38
"27620",NA,29027,"Callaway County, MO","County or equivalent",2008,43464,284,224,542,318,39,22,17,21
"27620",NA,29051,"Cole County, MO","County or equivalent",2008,74313,807,461,1021,560,339,80,259,7
"27620",NA,29135,"Moniteau County, MO","County or equivalent",2008,15121,-5,100,231,131,-110,2,-112,5
"27620",NA,29151,"Osage County, MO","County or equivalent",2008,13465,107,84,189,105,18,0,18,5
"27740",NA,NA,"Johnson City, TN","Metropolitan Statistical Area",2008,195849,2554,152,2265,2113,2373,105,2268,29
"27740",NA,47019,"Carter County, TN","County or equivalent",2008,59492,350,-34,636,670,358,16,342,26
"27740",NA,47171,"Unicoi County, TN","County or equivalent",2008,17718,35,-73,182,255,93,1,92,15
"27740",NA,47179,"Washington County, TN","County or equivalent",2008,118639,2169,259,1447,1188,1922,88,1834,-12
"27780",NA,NA,"Johnstown, PA","Metropolitan Statistical Area",2008,144319,-677,-273,1514,1787,-392,34,-426,-12
"27780",NA,42021,"Cambria County, PA","County or equivalent",2008,144319,-677,-273,1514,1787,-392,34,-426,-12
"27860",NA,NA,"Jonesboro, AR","Metropolitan Statistical Area",2008,117361,1813,687,1793,1106,1123,100,1023,3
"27860",NA,5031,"Craighead County, AR","County or equivalent",2008,92640,1913,632,1427,795,1280,90,1190,1
"27860",NA,5111,"Poinsett County, AR","County or equivalent",2008,24721,-100,55,366,311,-157,10,-167,2
"27900",NA,NA,"Joplin, MO","Metropolitan Statistical Area",2008,172933,1890,1163,2741,1578,702,152,550,25
"27900",NA,29097,"Jasper County, MO","County or equivalent",2008,116813,1764,848,1923,1075,905,127,778,11
"27900",NA,29145,"Newton County, MO","County or equivalent",2008,56120,126,315,818,503,-203,25,-228,14
"28020",NA,NA,"Kalamazoo-Portage, MI","Metropolitan Statistical Area",2008,323713,1373,1843,4381,2538,-574,439,-1013,104
"28020",NA,26077,"Kalamazoo County, MI","County or equivalent",2008,245912,1353,1457,3315,1858,-225,397,-622,121
"28020",NA,26159,"Van Buren County, MI","County or equivalent",2008,77801,20,386,1066,680,-349,42,-391,-17
"28100",NA,NA,"Kankakee-Bradley, IL","Metropolitan Statistical Area",2008,112524,986,613,1686,1073,319,109,210,54
"28100",NA,17091,"Kankakee County, IL","County or equivalent",2008,112524,986,613,1686,1073,319,109,210,54
"28140",NA,NA,"Kansas City, MO-KS","Metropolitan Statistical Area",2008,2002047,20567,15735,30766,15031,4673,3260,1413,159
"28140",NA,20059,"Franklin County, KS","County or equivalent",2008,26562,151,158,388,230,-6,15,-21,-1
"28140",NA,20091,"Johnson County, KS","County or equivalent",2008,534093,9292,5081,8122,3041,4077,966,3111,134
"28140",NA,20103,"Leavenworth County, KS","County or equivalent",2008,74276,769,486,989,503,282,48,234,1
"28140",NA,20107,"Linn County, KS","County or equivalent",2008,9616,-110,25,120,95,-141,0,-141,6
"28140",NA,20121,"Miami County, KS","County or equivalent",2008,30989,92,204,451,247,-125,5,-130,13
"28140",NA,20209,"Wyandotte County, KS","County or equivalent",2008,154287,686,1557,2864,1307,-775,762,-1537,-96
"28140",NA,29013,"Bates County, MO","County or equivalent",2008,17075,73,32,229,197,37,5,32,4
"28140",NA,29025,"Caldwell County, MO","County or equivalent",2008,9248,-25,34,133,99,-67,0,-67,8
"28140",NA,29037,"Cass County, MO","County or equivalent",2008,98429,1502,622,1407,785,845,47,798,35
"28140",NA,29047,"Clay County, MO","County or equivalent",2008,215707,4182,1851,3306,1455,2262,202,2060,69
"28140",NA,29049,"Clinton County, MO","County or equivalent",2008,21094,119,57,286,229,67,2,65,-5
"28140",NA,29095,"Jackson County, MO","County or equivalent",2008,668417,2417,4841,10583,5742,-2403,1092,-3495,-21
"28140",NA,29107,"Lafayette County, MO","County or equivalent",2008,32913,246,80,436,356,149,4,145,17
"28140",NA,29165,"Platte County, MO","County or equivalent",2008,85896,1174,624,1145,521,546,111,435,4
"28140",NA,29177,"Ray County, MO","County or equivalent",2008,23445,-1,83,307,224,-75,1,-76,-9
"28420",NA,NA,"Kennewick-Pasco-Richland, WA","Metropolitan Statistical Area",2008,235841,7936,2648,4024,1376,5241,842,4399,47
"28420",NA,53005,"Benton County, WA","County or equivalent",2008,163058,4277,1234,2300,1066,2995,395,2600,48
"28420",NA,53021,"Franklin County, WA","County or equivalent",2008,72783,3659,1414,1724,310,2246,447,1799,-1
"28660",NA,NA,"Killeen-Temple-Fort Hood, TX","Metropolitan Statistical Area",2008,378935,8180,4716,7016,2300,3509,642,2867,-45
"28660",NA,48027,"Bell County, TX","County or equivalent",2008,285084,7311,4101,5890,1789,3138,540,2598,72
"28660",NA,48099,"Coryell County, TX","County or equivalent",2008,72654,546,559,872,313,72,80,-8,-85
"28660",NA,48281,"Lampasas County, TX","County or equivalent",2008,21197,323,56,254,198,299,22,277,-32
"28700",NA,NA,"Kingsport-Bristol-Bristol, TN-VA","Metropolitan Statistical Area",2008,304689,1379,-275,3313,3588,1515,105,1410,139
"28700",NA,47073,"Hawkins County, TN","County or equivalent",2008,57477,549,67,666,599,449,14,435,33
"28700",NA,47163,"Sullivan County, TN","County or equivalent",2008,153900,543,-176,1663,1839,621,74,547,98
"28700",NA,51169,"Scott County, VA","County or equivalent",2008,22850,-38,-74,225,299,31,2,29,5
"28700",NA,51191,"Washington County, VA","County or equivalent",2008,53038,292,-31,561,592,321,11,310,2
"28700",NA,51520,"Bristol city, VA","County or equivalent",2008,17424,33,-61,198,259,93,4,89,1
"28740",NA,NA,"Kingston, NY","Metropolitan Statistical Area",2008,181670,77,347,1883,1536,-342,174,-516,72
"28740",NA,36111,"Ulster County, NY","County or equivalent",2008,181670,77,347,1883,1536,-342,174,-516,72
"28940",NA,NA,"Knoxville, TN","Metropolitan Statistical Area",2008,691152,10500,2084,8636,6552,8316,503,7813,100
"28940",NA,47001,"Anderson County, TN","County or equivalent",2008,74169,923,84,903,819,790,69,721,49
"28940",NA,47009,"Blount County, TN","County or equivalent",2008,121511,1909,207,1434,1227,1707,75,1632,-5
"28940",NA,47093,"Knox County, TN","County or equivalent",2008,430019,6416,1705,5498,3793,4606,331,4275,105
"28940",NA,47105,"Loudon County, TN","County or equivalent",2008,46445,1082,27,561,534,1084,27,1057,-29
"28940",NA,47173,"Union County, TN","County or equivalent",2008,19008,170,61,240,179,129,1,128,-20
"29020",NA,NA,"Kokomo, IN","Metropolitan Statistical Area",2008,99304,-371,291,1315,1024,-700,46,-746,38
"29020",NA,18067,"Howard County, IN","County or equivalent",2008,83381,-267,251,1120,869,-556,44,-600,38
"29020",NA,18159,"Tipton County, IN","County or equivalent",2008,15923,-104,40,195,155,-144,2,-146,0
"29100",NA,NA,"La Crosse, WI-MN","Metropolitan Statistical Area",2008,131872,838,508,1576,1068,334,50,284,-4
"29100",NA,27055,"Houston County, MN","County or equivalent",2008,19245,-254,43,218,175,-288,1,-289,-9
"29100",NA,55063,"La Crosse County, WI","County or equivalent",2008,112627,1092,465,1358,893,622,49,573,5
"29140",NA,NA,"Lafayette, IN","Metropolitan Statistical Area",2008,192870,2111,1314,2628,1314,772,734,38,25
"29140",NA,18007,"Benton County, IN","County or equivalent",2008,8769,-5,31,122,91,-42,0,-42,6
"29140",NA,18015,"Carroll County, IN","County or equivalent",2008,19864,-57,46,224,178,-102,13,-115,-1
"29140",NA,18157,"Tippecanoe County, IN","County or equivalent",2008,164237,2173,1237,2282,1045,916,721,195,20
"29180",NA,NA,"Lafayette, LA","Metropolitan Statistical Area",2008,259073,2800,1947,3959,2012,989,194,795,-136
"29180",NA,22055,"Lafayette Parish, LA","County or equivalent",2008,206976,2327,1633,3191,1558,823,188,635,-129
"29180",NA,22099,"St. Martin Parish, LA","County or equivalent",2008,52097,473,314,768,454,166,6,160,-7
"29340",NA,NA,"Lake Charles, LA","Metropolitan Statistical Area",2008,192856,976,1034,2875,1841,68,70,-2,-126
"29340",NA,22019,"Calcasieu Parish, LA","County or equivalent",2008,185618,1147,1029,2817,1788,215,64,151,-97
"29340",NA,22023,"Cameron Parish, LA","County or equivalent",2008,7238,-171,5,58,53,-147,6,-153,-29
"29420",NA,NA,"Lake Havasu City-Kingman, AZ","Metropolitan Statistical Area",2008,196281,408,284,2579,2295,52,237,-185,72
"29420",NA,4015,"Mohave County, AZ","County or equivalent",2008,196281,408,284,2579,2295,52,237,-185,72
"29460",NA,NA,"Lakeland-Winter Haven, FL","Metropolitan Statistical Area",2008,580594,7627,3044,8866,5822,4231,1043,3188,352
"29460",NA,12105,"Polk County, FL","County or equivalent",2008,580594,7627,3044,8866,5822,4231,1043,3188,352
"29540",NA,NA,"Lancaster, PA","Metropolitan Statistical Area",2008,502370,4415,2737,7203,4466,1625,507,1118,53
"29540",NA,42071,"Lancaster County, PA","County or equivalent",2008,502370,4415,2737,7203,4466,1625,507,1118,53
"29620",NA,NA,"Lansing-East Lansing, MI","Metropolitan Statistical Area",2008,454035,-1036,2708,5852,3144,-3844,962,-4806,100
"29620",NA,26037,"Clinton County, MI","County or equivalent",2008,69726,89,413,885,472,-324,11,-335,0
"29620",NA,26045,"Eaton County, MI","County or equivalent",2008,106781,-337,442,1256,814,-789,65,-854,10
"29620",NA,26065,"Ingham County, MI","County or equivalent",2008,277528,-788,1853,3711,1858,-2731,886,-3617,90
"29700",NA,NA,"Laredo, TX","Metropolitan Statistical Area",2008,236941,5464,5149,6332,1183,243,1280,-1037,72
"29700",NA,48479,"Webb County, TX","County or equivalent",2008,236941,5464,5149,6332,1183,243,1280,-1037,72
"29740",NA,NA,"Las Cruces, NM","Metropolitan Statistical Area",2008,201603,3555,2325,3691,1366,1183,584,599,47
"29740",NA,35013,"Dona Ana County, NM","County or equivalent",2008,201603,3555,2325,3691,1366,1183,584,599,47
"29820",NA,NA,"Las Vegas-Paradise, NV","Metropolitan Statistical Area",2008,1865746,38091,16804,30074,13270,21737,7372,14365,-450
"29820",NA,32003,"Clark County, NV","County or equivalent",2008,1865746,38091,16804,30074,13270,21737,7372,14365,-450
"29940",NA,NA,"Lawrence, KS","Metropolitan Statistical Area",2008,114748,1348,804,1361,557,567,263,304,-23
"29940",NA,20045,"Douglas County, KS","County or equivalent",2008,114748,1348,804,1361,557,567,263,304,-23
"30020",NA,NA,"Lawton, OK","Metropolitan Statistical Area",2008,111772,-2159,1176,2081,905,-3368,109,-3477,33
"30020",NA,40031,"Comanche County, OK","County or equivalent",2008,111772,-2159,1176,2081,905,-3368,109,-3477,33
"30140",NA,NA,"Lebanon, PA","Metropolitan Statistical Area",2008,128934,1073,305,1637,1332,728,122,606,40
"30140",NA,42075,"Lebanon County, PA","County or equivalent",2008,128934,1073,305,1637,1332,728,122,606,40
"30300",NA,NA,"Lewiston, ID-WA","Metropolitan Statistical Area",2008,60395,490,115,768,653,423,16,407,-48
"30300",NA,16069,"Nez Perce County, ID","County or equivalent",2008,38975,155,50,492,442,170,14,156,-65
"30300",NA,53003,"Asotin County, WA","County or equivalent",2008,21420,335,65,276,211,253,2,251,17
"30340",NA,NA,"Lewiston-Auburn, ME","Metropolitan Statistical Area",2008,106877,176,369,1388,1019,-200,48,-248,7
"30340",NA,23001,"Androscoggin County, ME","County or equivalent",2008,106877,176,369,1388,1019,-200,48,-248,7
"30460",NA,NA,"Lexington-Fayette, KY","Metropolitan Statistical Area",2008,453424,7315,3045,6416,3371,4214,1007,3207,56
"30460",NA,21017,"Bourbon County, KY","County or equivalent",2008,19828,112,42,245,203,68,26,42,2
"30460",NA,21049,"Clark County, KY","County or equivalent",2008,35691,170,117,460,343,32,15,17,21
"30460",NA,21067,"Fayette County, KY","County or equivalent",2008,282114,3827,1987,4027,2040,1774,862,912,66
"30460",NA,21113,"Jessamine County, KY","County or equivalent",2008,46716,1163,313,663,350,862,25,837,-12
"30460",NA,21209,"Scott County, KY","County or equivalent",2008,44549,1721,478,714,236,1262,34,1228,-19
"30460",NA,21239,"Woodford County, KY","County or equivalent",2008,24526,322,108,307,199,216,45,171,-2
"30620",NA,NA,"Lima, OH","Metropolitan Statistical Area",2008,105168,35,425,1482,1057,-437,22,-459,47
"30620",NA,39003,"Allen County, OH","County or equivalent",2008,105168,35,425,1482,1057,-437,22,-459,47
"30700",NA,NA,"Lincoln, NE","Metropolitan Statistical Area",2008,295486,4238,2740,4631,1891,1387,738,649,111
"30700",NA,31109,"Lancaster County, NE","County or equivalent",2008,278728,4003,2692,4418,1726,1202,732,470,109
"30700",NA,31159,"Seward County, NE","County or equivalent",2008,16758,235,48,213,165,185,6,179,2
"30780",NA,NA,"Little Rock-North Little Rock-Conway, AR","Metropolitan Statistical Area",2008,675069,9412,4665,10114,5449,4588,478,4110,159
"30780",NA,5045,"Faulkner County, AR","County or equivalent",2008,106823,2529,855,1563,708,1645,64,1581,29
"30780",NA,5053,"Grant County, AR","County or equivalent",2008,17690,240,45,200,155,193,-1,194,2
"30780",NA,5085,"Lonoke County, AR","County or equivalent",2008,65233,1765,507,992,485,1223,12,1211,35
"30780",NA,5105,"Perry County, AR","County or equivalent",2008,10317,-71,9,124,115,-76,-1,-75,-4
"30780",NA,5119,"Pulaski County, AR","County or equivalent",2008,376797,2786,2832,6015,3183,-93,380,-473,47
"30780",NA,5125,"Saline County, AR","County or equivalent",2008,98209,2163,417,1220,803,1696,24,1672,50
"30860",NA,NA,"Logan, UT-ID","Metropolitan Statistical Area",2008,125070,3917,2545,3074,529,1365,306,1059,7
"30860",NA,16041,"Franklin County, ID","County or equivalent",2008,12454,296,133,220,87,162,17,145,1
"30860",NA,49005,"Cache County, UT","County or equivalent",2008,112616,3621,2412,2854,442,1203,289,914,6
"30980",NA,NA,"Longview, TX","Metropolitan Statistical Area",2008,204746,1541,1011,3128,2117,482,296,186,48
"30980",NA,48183,"Gregg County, TX","County or equivalent",2008,117528,656,770,1937,1167,-157,206,-363,43
"30980",NA,48401,"Rusk County, TX","County or equivalent",2008,48887,435,166,684,518,264,76,188,5
"30980",NA,48459,"Upshur County, TX","County or equivalent",2008,38331,450,75,507,432,375,14,361,0
"31020",NA,NA,"Longview, WA","Metropolitan Statistical Area",2008,101254,1038,392,1362,970,640,108,532,6
"31020",NA,53015,"Cowlitz County, WA","County or equivalent",2008,101254,1038,392,1362,970,640,108,532,6
"31100",NA,NA,"Los Angeles-Long Beach-Santa Ana, CA","Metropolitan Statistical Area",2008,12872808,88196,113780,192833,79053,-25363,89674,-115037,-221
"31100",31084,NA,"Los Angeles-Long Beach-Glendale, CA","Metropolitan Division",2008,9862049,54179,87911,149317,61406,-32868,70136,-103004,-864
"31100",31084,6037,"Los Angeles County, CA","County or equivalent",2008,9862049,54179,87911,149317,61406,-32868,70136,-103004,-864
"31100",42044,NA,"Santa Ana-Anaheim-Irvine, CA","Metropolitan Division",2008,3010759,34017,25869,43516,17647,7505,19538,-12033,643
"31100",42044,6059,"Orange County, CA","County or equivalent",2008,3010759,34017,25869,43516,17647,7505,19538,-12033,643
"31140",NA,NA,"Louisville/Jefferson County, KY-IN","Metropolitan Statistical Area",2008,1244696,12392,5463,16760,11297,6406,1307,5099,523
"31140",NA,18019,"Clark County, IN","County or equivalent",2008,106673,1623,421,1452,1031,1171,78,1093,31
"31140",NA,18043,"Floyd County, IN","County or equivalent",2008,73780,837,252,934,682,571,10,561,14
"31140",NA,18061,"Harrison County, IN","County or equivalent",2008,37067,292,129,461,332,160,11,149,3
"31140",NA,18175,"Washington County, IN","County or equivalent",2008,27949,70,76,350,274,-21,3,-24,15
"31140",NA,21029,"Bullitt County, KY","County or equivalent",2008,75028,1141,362,834,472,756,6,750,23
"31140",NA,21103,"Henry County, KY","County or equivalent",2008,15741,74,46,199,153,37,9,28,-9
"31140",NA,21111,"Jefferson County, KY","County or equivalent",2008,713877,5264,3004,10074,7070,1856,1038,818,404
"31140",NA,21163,"Meade County, KY","County or equivalent",2008,27043,-170,85,251,166,-243,11,-254,-12
"31140",NA,21179,"Nelson County, KY","County or equivalent",2008,43113,702,321,632,311,360,27,333,21
"31140",NA,21185,"Oldham County, KY","County or equivalent",2008,56874,1105,337,651,314,747,22,725,21
"31140",NA,21211,"Shelby County, KY","County or equivalent",2008,41157,812,296,593,297,511,88,423,5
"31140",NA,21215,"Spencer County, KY","County or equivalent",2008,17382,584,105,211,106,473,4,469,6
"31140",NA,21223,"Trimble County, KY","County or equivalent",2008,9012,58,29,118,89,28,0,28,1
"31180",NA,NA,"Lubbock, TX","Metropolitan Statistical Area",2008,270610,2525,2302,4439,2137,130,217,-87,93
"31180",NA,48107,"Crosby County, TX","County or equivalent",2008,6192,-66,53,110,57,-108,1,-109,-11
"31180",NA,48303,"Lubbock County, TX","County or equivalent",2008,264418,2591,2249,4329,2080,238,216,22,104
"31340",NA,NA,"Lynchburg, VA","Metropolitan Statistical Area",2008,245809,2157,603,2934,2331,1661,153,1508,-107
"31340",NA,51009,"Amherst County, VA","County or equivalent",2008,32539,325,4,327,323,316,12,304,5
"31340",NA,51011,"Appomattox County, VA","County or equivalent",2008,14501,305,37,170,133,286,6,280,-18
"31340",NA,51019,"Bedford County, VA","County or equivalent",2008,66831,253,206,724,518,68,21,47,-21
"31340",NA,51031,"Campbell County, VA","County or equivalent",2008,53030,408,139,612,473,272,21,251,-3
"31340",NA,51515,"Bedford city, VA","County or equivalent",2008,6312,20,-32,63,95,62,-1,63,-10
"31340",NA,51680,"Lynchburg city, VA","County or equivalent",2008,72596,846,249,1038,789,657,94,563,-60
"31420",NA,NA,"Macon, GA","Metropolitan Statistical Area",2008,230777,946,1097,3392,2295,-224,140,-364,73
"31420",NA,13021,"Bibb County, GA","County or equivalent",2008,155216,410,946,2593,1647,-616,117,-733,80
"31420",NA,13079,"Crawford County, GA","County or equivalent",2008,12510,10,21,127,106,-7,0,-7,-4
"31420",NA,13169,"Jones County, GA","County or equivalent",2008,27542,381,62,279,217,307,11,296,12
"31420",NA,13207,"Monroe County, GA","County or equivalent",2008,25252,149,54,278,224,113,11,102,-18
"31420",NA,13289,"Twiggs County, GA","County or equivalent",2008,10257,-4,14,115,101,-21,1,-22,3
"31460",NA,NA,"Madera, CA","Metropolitan Statistical Area",2008,148333,2679,1764,2688,924,981,645,336,-66
"31460",NA,6039,"Madera County, CA","County or equivalent",2008,148333,2679,1764,2688,924,981,645,336,-66
"31540",NA,NA,"Madison, WI","Metropolitan Statistical Area",2008,561505,7238,4001,7356,3355,3051,1371,1680,186
"31540",NA,55021,"Columbia County, WI","County or equivalent",2008,55196,50,210,700,490,-163,16,-179,3
"31540",NA,55025,"Dane County, WI","County or equivalent",2008,482705,7104,3659,6333,2674,3257,1356,1901,188
"31540",NA,55049,"Iowa County, WI","County or equivalent",2008,23604,84,132,323,191,-43,-1,-42,-5
"31700",NA,NA,"Manchester-Nashua, NH","Metropolitan Statistical Area",2008,402042,982,2043,4845,2802,-1150,968,-2118,89
"31700",NA,33011,"Hillsborough County, NH","County or equivalent",2008,402042,982,2043,4845,2802,-1150,968,-2118,89
"31900",NA,NA,"Mansfield, OH","Metropolitan Statistical Area",2008,124999,-869,396,1623,1227,-1262,39,-1301,-3
"31900",NA,39139,"Richland County, OH","County or equivalent",2008,124999,-869,396,1623,1227,-1262,39,-1301,-3
"32580",NA,NA,"McAllen-Edinburg-Mission, TX","Metropolitan Statistical Area",2008,726604,21126,14568,18125,3557,6402,3675,2727,156
"32580",NA,48215,"Hidalgo County, TX","County or equivalent",2008,726604,21126,14568,18125,3557,6402,3675,2727,156
"32780",NA,NA,"Medford, OR","Metropolitan Statistical Area",2008,201138,2135,512,2436,1924,1674,205,1469,-51
"32780",NA,41029,"Jackson County, OR","County or equivalent",2008,201138,2135,512,2436,1924,1674,205,1469,-51
"32820",NA,NA,"Memphis, TN-MS-AR","Metropolitan Statistical Area",2008,1285732,6612,9501,20329,10828,-3095,1452,-4547,206
"32820",NA,5035,"Crittenden County, AR","County or equivalent",2008,52554,444,430,917,487,2,23,-21,12
"32820",NA,28033,"DeSoto County, MS","County or equivalent",2008,154748,5612,1339,2322,983,4228,90,4138,45
"32820",NA,28093,"Marshall County, MS","County or equivalent",2008,37102,391,190,558,368,222,5,217,-21
"32820",NA,28137,"Tate County, MS","County or equivalent",2008,27176,296,174,430,256,131,2,129,-9
"32820",NA,28143,"Tunica County, MS","County or equivalent",2008,10448,-16,123,219,96,-137,6,-143,-2
"32820",NA,47047,"Fayette County, TN","County or equivalent",2008,38173,1038,141,505,364,893,5,888,4
"32820",NA,47157,"Shelby County, TN","County or equivalent",2008,906825,-2237,6829,14564,7735,-9227,1306,-10533,161
"32820",NA,47167,"Tipton County, TN","County or equivalent",2008,58706,1084,275,814,539,793,15,778,16
"32900",NA,NA,"Merced, CA","Metropolitan Statistical Area",2008,246117,1899,3191,4766,1575,-1367,981,-2348,75
"32900",NA,6047,"Merced County, CA","County or equivalent",2008,246117,1899,3191,4766,1575,-1367,981,-2348,75
"33100",NA,NA,"Miami-Fort Lauderdale-Pompano Beach, FL","Metropolitan Statistical Area",2008,5414772,22654,19753,68728,48975,209,47206,-46997,2692
"33100",22744,NA,"Fort Lauderdale-Pompano Beach-Deerfield Beach, FL","Metropolitan Division",2008,1751234,2463,6456,21765,15309,-4878,11770,-16648,885
"33100",22744,12011,"Broward County, FL","County or equivalent",2008,1751234,2463,6456,21765,15309,-4878,11770,-16648,885
"33100",33124,NA,"Miami-Miami Beach-Kendall, FL","Metropolitan Division",2008,2398245,15284,12528,31846,19318,1169,29568,-28399,1587
"33100",33124,12086,"Miami-Dade County, FL","County or equivalent",2008,2398245,15284,12528,31846,19318,1169,29568,-28399,1587
"33100",48424,NA,"West Palm Beach-Boca Raton-Boynton Beach, FL","Metropolitan Division",2008,1265293,4907,769,15117,14348,3918,5868,-1950,220
"33100",48424,12099,"Palm Beach County, FL","County or equivalent",2008,1265293,4907,769,15117,14348,3918,5868,-1950,220
"33140",NA,NA,"Michigan City-La Porte, IN","Metropolitan Statistical Area",2008,110888,614,314,1366,1052,254,72,182,46
"33140",NA,18091,"LaPorte County, IN","County or equivalent",2008,110888,614,314,1366,1052,254,72,182,46
"33260",NA,NA,"Midland, TX","Metropolitan Statistical Area",2008,129494,3235,1252,2214,962,1985,151,1834,-2
"33260",NA,48329,"Midland County, TX","County or equivalent",2008,129494,3235,1252,2214,962,1985,151,1834,-2
"33340",NA,NA,"Milwaukee-Waukesha-West Allis, WI","Metropolitan Statistical Area",2008,1549308,5930,9673,22117,12444,-3739,2704,-6443,-4
"33340",NA,55079,"Milwaukee County, WI","County or equivalent",2008,953328,1997,7266,15401,8135,-5032,2350,-7382,-237
"33340",NA,55089,"Ozaukee County, WI","County or equivalent",2008,85874,496,240,878,638,226,60,166,30
"33340",NA,55131,"Washington County, WI","County or equivalent",2008,129477,1463,669,1574,905,749,53,696,45
"33340",NA,55133,"Waukesha County, WI","County or equivalent",2008,380629,1974,1498,4264,2766,318,241,77,158
"33460",NA,NA,"Minneapolis-St. Paul-Bloomington, MN-WI","Metropolitan Statistical Area",2008,3229878,32258,27822,47115,19293,4544,7984,-3440,-108
"33460",NA,27003,"Anoka County, MN","County or equivalent",2008,327090,1770,2937,4459,1522,-956,324,-1280,-211
"33460",NA,27019,"Carver County, MN","County or equivalent",2008,90043,1947,990,1336,346,967,108,859,-10
"33460",NA,27025,"Chisago County, MN","County or equivalent",2008,50257,367,406,744,338,-31,2,-33,-8
"33460",NA,27037,"Dakota County, MN","County or equivalent",2008,392755,3337,3739,5608,1869,-428,545,-973,26
"33460",NA,27053,"Hennepin County, MN","County or equivalent",2008,1140988,9033,8691,16307,7616,316,4935,-4619,26
"33460",NA,27059,"Isanti County, MN","County or equivalent",2008,39105,293,272,530,258,23,4,19,-2
"33460",NA,27123,"Ramsey County, MN","County or equivalent",2008,501428,2800,3349,7275,3926,-660,1742,-2402,111
"33460",NA,27139,"Scott County, MN","County or equivalent",2008,128937,2999,1816,2302,486,1216,101,1115,-33
"33460",NA,27141,"Sherburne County, MN","County or equivalent",2008,87660,1607,975,1428,453,650,16,634,-18
"33460",NA,27163,"Washington County, MN","County or equivalent",2008,229173,3381,2006,3136,1130,1382,165,1217,-7
"33460",NA,27171,"Wright County, MN","County or equivalent",2008,119701,2769,1619,2259,640,1124,22,1102,26
"33460",NA,55093,"Pierce County, WI","County or equivalent",2008,40254,460,238,479,241,209,5,204,13
"33460",NA,55109,"St. Croix County, WI","County or equivalent",2008,82487,1495,784,1252,468,732,15,717,-21
"33540",NA,NA,"Missoula, MT","Metropolitan Statistical Area",2008,107320,1682,669,1367,698,981,62,919,32
"33540",NA,30063,"Missoula County, MT","County or equivalent",2008,107320,1682,669,1367,698,981,62,919,32
"33660",NA,NA,"Mobile, AL","Metropolitan Statistical Area",2008,406309,2212,2118,6044,3926,245,356,-111,-151
"33660",NA,1097,"Mobile County, AL","County or equivalent",2008,406309,2212,2118,6044,3926,245,356,-111,-151
"33700",NA,NA,"Modesto, CA","Metropolitan Statistical Area",2008,510694,1626,5074,8841,3767,-3682,1647,-5329,234
"33700",NA,6099,"Stanislaus County, CA","County or equivalent",2008,510694,1626,5074,8841,3767,-3682,1647,-5329,234
"33740",NA,NA,"Monroe, LA","Metropolitan Statistical Area",2008,172743,512,1051,2709,1658,-578,46,-624,39
"33740",NA,22073,"Ouachita Parish, LA","County or equivalent",2008,150051,558,987,2388,1401,-456,37,-493,27
"33740",NA,22111,"Union Parish, LA","County or equivalent",2008,22692,-46,64,321,257,-122,9,-131,12
"33780",NA,NA,"Monroe, MI","Metropolitan Statistical Area",2008,152949,-382,629,1855,1226,-1095,85,-1180,84
"33780",NA,26115,"Monroe County, MI","County or equivalent",2008,152949,-382,629,1855,1226,-1095,85,-1180,84
"33860",NA,NA,"Montgomery, AL","Metropolitan Statistical Area",2008,365924,-52,2124,5425,3301,-2304,129,-2433,128
"33860",NA,1001,"Autauga County, AL","County or equivalent",2008,50364,534,270,718,448,250,5,245,14
"33860",NA,1051,"Elmore County, AL","County or equivalent",2008,78106,748,450,1110,660,265,9,256,33
"33860",NA,1085,"Lowndes County, AL","County or equivalent",2008,12644,-55,21,176,155,-82,-1,-81,6
"33860",NA,1101,"Montgomery County, AL","County or equivalent",2008,224810,-1279,1383,3421,2038,-2737,116,-2853,75
"34060",NA,NA,"Morgantown, WV","Metropolitan Statistical Area",2008,118506,959,381,1319,938,576,173,403,2
"34060",NA,54061,"Monongalia County, WV","County or equivalent",2008,88221,907,385,988,603,534,173,361,-12
"34060",NA,54077,"Preston County, WV","County or equivalent",2008,30285,52,-4,331,335,42,0,42,14
"34100",NA,NA,"Morristown, TN","Metropolitan Statistical Area",2008,135914,1667,340,1741,1401,1263,289,974,64
"34100",NA,47057,"Grainger County, TN","County or equivalent",2008,22708,180,26,269,243,155,11,144,-1
"34100",NA,47063,"Hamblen County, TN","County or equivalent",2008,62132,567,223,886,663,309,232,77,35
"34100",NA,47089,"Jefferson County, TN","County or equivalent",2008,51074,920,91,586,495,799,46,753,30
"34580",NA,NA,"Mount Vernon-Anacortes, WA","Metropolitan Statistical Area",2008,118000,2102,520,1579,1059,1623,292,1331,-41
"34580",NA,53057,"Skagit County, WA","County or equivalent",2008,118000,2102,520,1579,1059,1623,292,1331,-41
"34620",NA,NA,"Muncie, IN","Metropolitan Statistical Area",2008,114685,-482,196,1353,1157,-731,96,-827,53
"34620",NA,18035,"Delaware County, IN","County or equivalent",2008,114685,-482,196,1353,1157,-731,96,-827,53
"34740",NA,NA,"Muskegon-Norton Shores, MI","Metropolitan Statistical Area",2008,174344,236,922,2456,1534,-728,79,-807,42
"34740",NA,26121,"Muskegon County, MI","County or equivalent",2008,174344,236,922,2456,1534,-728,79,-807,42
"34820",NA,NA,"Myrtle Beach-North Myrtle Beach-Conway, SC","Metropolitan Statistical Area",2008,257380,7669,810,3318,2508,6954,327,6627,-95
"34820",NA,45051,"Horry County, SC","County or equivalent",2008,257380,7669,810,3318,2508,6954,327,6627,-95
"34900",NA,NA,"Napa, CA","Metropolitan Statistical Area",2008,133433,1652,554,1718,1164,1044,618,426,54
"34900",NA,6055,"Napa County, CA","County or equivalent",2008,133433,1652,554,1718,1164,1044,618,426,54
"34940",NA,NA,"Naples-Marco Island, FL","Metropolitan Statistical Area",2008,315258,1603,1095,4073,2978,463,1805,-1342,45
"34940",NA,12021,"Collier County, FL","County or equivalent",2008,315258,1603,1095,4073,2978,463,1805,-1342,45
"34980",NA,NA,"Nashville-Davidson--Murfreesboro--Franklin, TN","Metropolitan Statistical Area",2008,1550733,30573,11022,22884,11862,19465,2840,16625,86
"34980",NA,47015,"Cannon County, TN","County or equivalent",2008,13804,370,-5,141,146,377,4,373,-2
"34980",NA,47021,"Cheatham County, TN","County or equivalent",2008,39396,397,202,508,306,192,8,184,3
"34980",NA,47037,"Davidson County, TN","County or equivalent",2008,626144,5877,4273,9590,5317,1510,2057,-547,94
"34980",NA,47043,"Dickson County, TN","County or equivalent",2008,47884,547,251,701,450,308,5,303,-12
"34980",NA,47081,"Hickman County, TN","County or equivalent",2008,23841,88,33,273,240,53,2,51,2
"34980",NA,47111,"Macon County, TN","County or equivalent",2008,21838,279,38,276,238,237,26,211,4
"34980",NA,47147,"Robertson County, TN","County or equivalent",2008,64898,1736,517,1064,547,1212,104,1108,7
"34980",NA,47149,"Rutherford County, TN","County or equivalent",2008,249270,8393,2576,3979,1403,5879,264,5615,-62
"34980",NA,47159,"Smith County, TN","County or equivalent",2008,19107,312,53,241,188,259,9,250,0
"34980",NA,47165,"Sumner County, TN","County or equivalent",2008,155474,3063,918,2141,1223,2122,131,1991,23
"34980",NA,47169,"Trousdale County, TN","County or equivalent",2008,7822,123,5,90,85,116,6,110,2
"34980",NA,47187,"Williamson County, TN","County or equivalent",2008,171452,5762,1478,2358,880,4253,185,4068,31
"34980",NA,47189,"Wilson County, TN","County or equivalent",2008,109803,3626,683,1522,839,2947,39,2908,-4
"35300",NA,NA,"New Haven-Milford, CT","Metropolitan Statistical Area",2008,846101,1743,3421,10644,7223,-1872,2625,-4497,194
"35300",NA,9009,"New Haven County, CT","County or equivalent",2008,846101,1743,3421,10644,7223,-1872,2625,-4497,194
"35380",NA,NA,"New Orleans-Metairie-Kenner, LA","Metropolitan Statistical Area",2008,1134029,24618,4580,14549,9969,21561,1225,20336,-1523
"35380",NA,22051,"Jefferson Parish, LA","County or equivalent",2008,436181,-4158,1360,5513,4153,-4935,634,-5569,-583
"35380",NA,22071,"Orleans Parish, LA","County or equivalent",2008,311853,23740,894,3738,2844,23265,409,22856,-419
"35380",NA,22075,"Plaquemines Parish, LA","County or equivalent",2008,21276,-321,108,270,162,-380,1,-381,-49
"35380",NA,22087,"St. Bernard Parish, LA","County or equivalent",2008,37722,4283,199,393,194,4215,21,4194,-131
"35380",NA,22089,"St. Charles Parish, LA","County or equivalent",2008,51547,-435,325,721,396,-707,37,-744,-53
"35380",NA,22095,"St. John the Baptist Parish, LA","County or equivalent",2008,46994,-684,396,753,357,-1024,23,-1047,-56
"35380",NA,22103,"St. Tammany Parish, LA","County or equivalent",2008,228456,2193,1298,3161,1863,1127,100,1027,-232
"35620",NA,NA,"New York-Northern New Jersey-Long Island, NY-NJ-PA","Metropolitan Statistical Area",2008,19006798,84227,115147,255281,140134,-21041,123058,-144099,-9879
"35620",20764,NA,"Edison-New Brunswick, NJ","Metropolitan Division",2008,2325224,14288,11076,30393,19317,2947,9871,-6924,265
"35620",20764,34023,"Middlesex County, NJ","County or equivalent",2008,789102,6073,5450,10733,5283,746,6146,-5400,-123
"35620",20764,34025,"Monmouth County, NJ","County or equivalent",2008,642448,1083,2316,7449,5133,-1345,1538,-2883,112
"35620",20764,34029,"Ocean County, NJ","County or equivalent",2008,569111,4320,1343,8144,6801,2813,529,2284,164
"35620",20764,34035,"Somerset County, NJ","County or equivalent",2008,324563,2812,1967,4067,2100,733,1658,-925,112
"35620",35004,NA,"Nassau-Suffolk, NY","Metropolitan Division",2008,2863849,-944,9623,31849,22226,-9723,7001,-16724,-844
"35620",35004,36059,"Nassau County, NY","County or equivalent",2008,1351625,-1436,3032,13830,10798,-3592,3650,-7242,-876
"35620",35004,36103,"Suffolk County, NY","County or equivalent",2008,1512224,492,6591,18019,11428,-6131,3351,-9482,32
"35620",35084,NA,"Newark-Union, NJ-PA","Metropolitan Division",2008,2121076,2165,12431,28031,15600,-8987,10739,-19726,-1279
"35620",35084,34013,"Essex County, NJ","County or equivalent",2008,770675,-1598,5659,11758,6099,-6617,4898,-11515,-640
"35620",35084,34019,"Hunterdon County, NJ","County or equivalent",2008,129031,58,472,1240,768,-319,166,-485,-95
"35620",35084,34027,"Morris County, NJ","County or equivalent",2008,487548,1376,2165,5559,3394,-701,2081,-2782,-88
"35620",35084,34037,"Sussex County, NJ","County or equivalent",2008,150909,-348,660,1619,959,-1020,117,-1137,12
"35620",35084,34039,"Union County, NJ","County or equivalent",2008,523249,1571,3475,7405,3930,-1411,3472,-4883,-493
"35620",35084,42103,"Pike County, PA","County or equivalent",2008,59664,1106,0,450,450,1081,5,1076,25
"35620",35644,NA,"New York-White Plains-Wayne, NY-NJ","Metropolitan Division",2008,11696649,68718,82017,165008,82991,-5278,95447,-100725,-8021
"35620",35644,34003,"Bergen County, NJ","County or equivalent",2008,894840,4776,2928,9720,6792,2616,5435,-2819,-768
"35620",35644,34017,"Hudson County, NJ","County or equivalent",2008,595419,3055,4735,8610,3875,-858,7049,-7907,-822
"35620",35644,34031,"Passaic County, NJ","County or equivalent",2008,490948,1438,4171,7764,3593,-2647,3502,-6149,-86
"35620",35644,36005,"Bronx County, NY","County or equivalent",2008,1391903,6781,13123,23097,9974,-5777,10562,-16339,-565
"35620",35644,36047,"Kings County, NY","County or equivalent",2008,2556598,17392,22595,40744,18149,-2990,22706,-25696,-2213
"35620",35644,36061,"New York County, NY","County or equivalent",2008,1634795,9544,10122,21296,11174,252,12607,-12355,-830
"35620",35644,36079,"Putnam County, NY","County or equivalent",2008,99244,37,425,1006,581,-365,174,-539,-23
"35620",35644,36081,"Queens County, NY","County or equivalent",2008,2293007,15228,14441,30226,15785,3187,25449,-22262,-2400
"35620",35644,36085,"Richmond County, NY","County or equivalent",2008,487407,4553,2342,6006,3664,2160,1526,634,51
"35620",35644,36087,"Rockland County, NY","County or equivalent",2008,298545,1540,2530,4666,2136,-805,1165,-1970,-185
"35620",35644,36119,"Westchester County, NY","County or equivalent",2008,953943,4374,4605,11873,7268,-51,5272,-5323,-180
"35660",NA,NA,"Niles-Benton Harbor, MI","Metropolitan Statistical Area",2008,159481,135,526,2086,1560,-451,260,-711,60
"35660",NA,26021,"Berrien County, MI","County or equivalent",2008,159481,135,526,2086,1560,-451,260,-711,60
"35980",NA,NA,"Norwich-New London, CT","Metropolitan Statistical Area",2008,264519,749,1079,3200,2121,-372,393,-765,42
"35980",NA,9011,"New London County, CT","County or equivalent",2008,264519,749,1079,3200,2121,-372,393,-765,42
"36100",NA,NA,"Ocala, FL","Metropolitan Statistical Area",2008,329628,5535,-431,3961,4392,6428,294,6134,-462
"36100",NA,12083,"Marion County, FL","County or equivalent",2008,329628,5535,-431,3961,4392,6428,294,6134,-462
"36140",NA,NA,"Ocean City, NJ","Metropolitan Statistical Area",2008,95838,-490,-200,993,1193,-192,74,-266,-98
"36140",NA,34009,"Cape May County, NJ","County or equivalent",2008,95838,-490,-200,993,1193,-192,74,-266,-98
"36220",NA,NA,"Odessa, TX","Metropolitan Statistical Area",2008,131941,2531,1464,2540,1076,1067,166,901,0
"36220",NA,48135,"Ector County, TX","County or equivalent",2008,131941,2531,1464,2540,1076,1067,166,901,0
"36260",NA,NA,"Ogden-Clearfield, UT","Metropolitan Statistical Area",2008,531488,13983,8191,10967,2776,5663,730,4933,129
"36260",NA,49011,"Davis County, UT","County or equivalent",2008,295332,7581,5188,6506,1318,2339,240,2099,54
"36260",NA,49029,"Morgan County, UT","County or equivalent",2008,8669,334,137,170,33,212,2,210,-15
"36260",NA,49057,"Weber County, UT","County or equivalent",2008,227487,6068,2866,4291,1425,3112,488,2624,90
"36420",NA,NA,"Oklahoma City, OK","Metropolitan Statistical Area",2008,1206142,16984,9218,19290,10072,7786,2305,5481,-20
"36420",NA,40017,"Canadian County, OK","County or equivalent",2008,106079,2748,909,1619,710,1850,69,1781,-11
"36420",NA,40027,"Cleveland County, OK","County or equivalent",2008,239760,4519,1687,3083,1396,2933,356,2577,-101
"36420",NA,40051,"Grady County, OK","County or equivalent",2008,51066,620,241,712,471,356,3,353,23
"36420",NA,40081,"Lincoln County, OK","County or equivalent",2008,32153,-58,100,421,321,-141,6,-147,-17
"36420",NA,40083,"Logan County, OK","County or equivalent",2008,38102,979,173,485,312,803,9,794,3
"36420",NA,40087,"McClain County, OK","County or equivalent",2008,32365,586,207,486,279,373,24,349,6
"36420",NA,40109,"Oklahoma County, OK","County or equivalent",2008,706617,7590,5901,12484,6583,1612,1838,-226,77
"36500",NA,NA,"Olympia, WA","Metropolitan Statistical Area",2008,245181,7015,1158,2942,1784,6008,258,5750,-151
"36500",NA,53067,"Thurston County, WA","County or equivalent",2008,245181,7015,1158,2942,1784,6008,258,5750,-151
"36540",NA,NA,"Omaha-Council Bluffs, NE-IA","Metropolitan Statistical Area",2008,837925,10259,7791,13801,6010,2417,1346,1071,51
"36540",NA,19085,"Harrison County, IA","County or equivalent",2008,15222,-181,6,191,185,-199,1,-200,12
"36540",NA,19129,"Mills County, IA","County or equivalent",2008,15113,-10,63,197,134,-66,1,-67,-7
"36540",NA,19155,"Pottawattamie County, IA","County or equivalent",2008,89647,292,442,1263,821,-121,40,-161,-29
"36540",NA,31025,"Cass County, NE","County or equivalent",2008,25598,118,138,336,198,-16,5,-21,-4
"36540",NA,31055,"Douglas County, NE","County or equivalent",2008,502032,6085,4983,8615,3632,994,1168,-174,108
"36540",NA,31153,"Sarpy County, NE","County or equivalent",2008,150467,4152,2002,2694,692,2180,112,2068,-30
"36540",NA,31155,"Saunders County, NE","County or equivalent",2008,20034,-85,86,264,178,-165,8,-173,-6
"36540",NA,31177,"Washington County, NE","County or equivalent",2008,19812,-112,71,241,170,-190,11,-201,7
"36740",NA,NA,"Orlando-Kissimmee, FL","Metropolitan Statistical Area",2008,2054574,25905,14197,29530,15333,12343,9190,3153,-635
"36740",NA,12069,"Lake County, FL","County or equivalent",2008,307243,6940,-240,3768,4008,8334,303,8031,-1154
"36740",NA,12095,"Orange County, FL","County or equivalent",2008,1072801,8822,9869,16668,6799,-1464,5878,-7342,417
"36740",NA,12097,"Osceola County, FL","County or equivalent",2008,263676,7850,2425,4156,1731,5534,1839,3695,-109
"36740",NA,12117,"Seminole County, FL","County or equivalent",2008,410854,2293,2143,4938,2795,-61,1170,-1231,211
"36780",NA,NA,"Oshkosh-Neenah, WI","Metropolitan Statistical Area",2008,162111,803,714,1959,1245,89,144,-55,0
"36780",NA,55139,"Winnebago County, WI","County or equivalent",2008,162111,803,714,1959,1245,89,144,-55,0
"36980",NA,NA,"Owensboro, KY","Metropolitan Statistical Area",2008,112762,778,489,1606,1117,228,32,196,61
"36980",NA,21059,"Daviess County, KY","County or equivalent",2008,94418,728,448,1374,926,226,30,196,54
"36980",NA,21091,"Hancock County, KY","County or equivalent",2008,8663,90,44,123,79,43,0,43,3
"36980",NA,21149,"McLean County, KY","County or equivalent",2008,9681,-40,-3,109,112,-41,2,-43,4
"37100",NA,NA,"Oxnard-Thousand Oaks-Ventura, CA","Metropolitan Statistical Area",2008,797740,5284,7293,12244,4951,-2166,3067,-5233,157
"37100",NA,6111,"Ventura County, CA","County or equivalent",2008,797740,5284,7293,12244,4951,-2166,3067,-5233,157
"37340",NA,NA,"Palm Bay-Melbourne-Titusville, FL","Metropolitan Statistical Area",2008,536521,1516,-153,5779,5932,1553,536,1017,116
"37340",NA,12009,"Brevard County, FL","County or equivalent",2008,536521,1516,-153,5779,5932,1553,536,1017,116
"37380",NA,NA,"Palm Coast, FL","Metropolitan Statistical Area",2008,91247,3069,36,952,916,3126,58,3068,-93
"37380",NA,12035,"Flagler County, FL","County or equivalent",2008,91247,3069,36,952,916,3126,58,3068,-93
"37460",NA,NA,"Panama City-Lynn Haven, FL","Metropolitan Statistical Area",2008,163946,392,833,2328,1495,-408,108,-516,-33
"37460",NA,12005,"Bay County, FL","County or equivalent",2008,163946,392,833,2328,1495,-408,108,-516,-33
"37620",NA,NA,"Parkersburg-Marietta-Vienna, WV-OH","Metropolitan Statistical Area",2008,160678,-1,-11,1805,1816,-66,18,-84,76
"37620",NA,39167,"Washington County, OH","County or equivalent",2008,61567,-115,-4,699,703,-144,1,-145,33
"37620",NA,54073,"Pleasants County, WV","County or equivalent",2008,7150,-46,-34,60,94,-17,1,-18,5
"37620",NA,54105,"Wirt County, WV","County or equivalent",2008,5757,-38,-8,63,71,-31,1,-32,1
"37620",NA,54107,"Wood County, WV","County or equivalent",2008,86204,198,35,983,948,126,15,111,37
"37700",NA,NA,"Pascagoula, MS","Metropolitan Statistical Area",2008,153100,963,983,2289,1306,262,130,132,-282
"37700",NA,28039,"George County, MS","County or equivalent",2008,22406,470,185,387,202,290,12,278,-5
"37700",NA,28059,"Jackson County, MS","County or equivalent",2008,130694,493,798,1902,1104,-28,118,-146,-277
"37860",NA,NA,"Pensacola-Ferry Pass-Brent, FL","Metropolitan Statistical Area",2008,452992,1601,2294,6265,3971,-753,346,-1099,60
"37860",NA,12033,"Escambia County, FL","County or equivalent",2008,302939,-718,1432,4388,2956,-2343,272,-2615,193
"37860",NA,12113,"Santa Rosa County, FL","County or equivalent",2008,150053,2319,862,1877,1015,1590,74,1516,-133
"37900",NA,NA,"Peoria, IL","Metropolitan Statistical Area",2008,372487,1694,1625,5276,3651,-7,250,-257,76
"37900",NA,17123,"Marshall County, IL","County or equivalent",2008,12670,-153,-12,156,168,-147,2,-149,6
"37900",NA,17143,"Peoria County, IL","County or equivalent",2008,183655,649,997,2738,1741,-398,210,-608,50
"37900",NA,17175,"Stark County, IL","County or equivalent",2008,6135,-16,-4,80,84,-9,1,-10,-3
"37900",NA,17179,"Tazewell County, IL","County or equivalent",2008,131524,655,467,1783,1316,168,32,136,20
"37900",NA,17203,"Woodford County, IL","County or equivalent",2008,38503,559,177,519,342,379,5,374,3
"37980",NA,NA,"Philadelphia-Camden-Wilmington, PA-NJ-DE-MD","Metropolitan Statistical Area",2008,5838471,15186,25103,77625,52522,-10651,11197,-21848,734
"37980",15804,NA,"Camden, NJ","Metropolitan Division",2008,1250569,1534,6219,16598,10379,-4890,1649,-6539,205
"37980",15804,34005,"Burlington County, NJ","County or equivalent",2008,445475,-745,1799,5442,3643,-2597,528,-3125,53
"37980",15804,34007,"Camden County, NJ","County or equivalent",2008,517234,-53,3044,7470,4426,-3185,991,-4176,88
"37980",15804,34015,"Gloucester County, NJ","County or equivalent",2008,287860,2332,1376,3686,2310,892,130,762,64
"37980",37964,NA,"Philadelphia, PA","Metropolitan Division",2008,3892194,9630,14786,51493,36707,-5484,8201,-13685,328
"37980",37964,42017,"Bucks County, PA","County or equivalent",2008,621643,1580,1540,6879,5339,-325,736,-1061,365
"37980",37964,42029,"Chester County, PA","County or equivalent",2008,491489,5891,2894,6433,3539,2862,734,2128,135
"37980",37964,42045,"Delaware County, PA","County or equivalent",2008,553619,457,1302,6762,5460,-904,924,-1828,59
"37980",37964,42091,"Montgomery County, PA","County or equivalent",2008,778048,2938,2194,9220,7026,472,1187,-715,272
"37980",37964,42101,"Philadelphia County, PA","County or equivalent",2008,1447395,-1236,6856,22199,15343,-7589,4620,-12209,-503
"37980",48864,NA,"Wilmington, DE-MD-NJ","Metropolitan Division",2008,695708,4022,4098,9534,5436,-277,1347,-1624,201
"37980",48864,10003,"New Castle County, DE","County or equivalent",2008,529641,3233,3390,7373,3983,-288,1239,-1527,131
"37980",48864,24015,"Cecil County, MD","County or equivalent",2008,99926,558,568,1347,779,-45,43,-88,35
"37980",48864,34033,"Salem County, NJ","County or equivalent",2008,66141,231,140,814,674,56,65,-9,35
"38060",NA,NA,"Phoenix-Mesa-Scottsdale, AZ","Metropolitan Statistical Area",2008,4281899,115978,46488,73738,27250,69748,18671,51077,-258
"38060",NA,4013,"Maricopa County, AZ","County or equivalent",2008,3954598,89550,43079,68176,25097,46724,18261,28463,-253
"38060",NA,4021,"Pinal County, AZ","County or equivalent",2008,327301,26428,3409,5562,2153,23024,410,22614,-5
"38220",NA,NA,"Pine Bluff, AR","Metropolitan Statistical Area",2008,100647,-961,382,1397,1015,-1281,45,-1326,-62
"38220",NA,5025,"Cleveland County, AR","County or equivalent",2008,8665,-86,27,114,87,-115,0,-115,2
"38220",NA,5069,"Jefferson County, AR","County or equivalent",2008,78373,-783,311,1137,826,-1042,46,-1088,-52
"38220",NA,5079,"Lincoln County, AR","County or equivalent",2008,13609,-92,44,146,102,-124,-1,-123,-12
"38300",NA,NA,"Pittsburgh, PA","Metropolitan Statistical Area",2008,2351192,-2967,-2777,24526,27303,-708,1724,-2432,518
"38300",NA,42003,"Allegheny County, PA","County or equivalent",2008,1215103,-3326,-1264,12942,14206,-2064,1537,-3601,2
"38300",NA,42005,"Armstrong County, PA","County or equivalent",2008,68790,-214,-159,700,859,-112,-1,-111,57
"38300",NA,42007,"Beaver County, PA","County or equivalent",2008,172476,-547,-319,1772,2091,-251,37,-288,23
"38300",NA,42019,"Butler County, PA","County or equivalent",2008,182902,1168,316,2082,1766,809,60,749,43
"38300",NA,42051,"Fayette County, PA","County or equivalent",2008,143925,-451,-233,1496,1729,-263,13,-276,45
"38300",NA,42125,"Washington County, PA","County or equivalent",2008,206407,975,-225,2131,2356,1071,37,1034,129
"38300",NA,42129,"Westmoreland County, PA","County or equivalent",2008,361589,-572,-893,3403,4296,102,41,61,219
"38340",NA,NA,"Pittsfield, MA","Metropolitan Statistical Area",2008,129395,-637,-182,1307,1489,-528,106,-634,73
"38340",NA,25003,"Berkshire County, MA","County or equivalent",2008,129395,-637,-182,1307,1489,-528,106,-634,73
"38540",NA,NA,"Pocatello, ID","Metropolitan Statistical Area",2008,88495,924,1032,1661,629,-97,77,-174,-11
"38540",NA,16005,"Bannock County, ID","County or equivalent",2008,80812,889,958,1527,569,-59,54,-113,-10
"38540",NA,16077,"Power County, ID","County or equivalent",2008,7683,35,74,134,60,-38,23,-61,-1
"38860",NA,NA,"Portland-South Portland-Biddeford, ME","Metropolitan Statistical Area",2008,514065,1708,1322,5529,4207,180,372,-192,206
"38860",NA,23005,"Cumberland County, ME","County or equivalent",2008,276047,1165,694,2983,2289,334,289,45,137
"38860",NA,23023,"Sagadahoc County, ME","County or equivalent",2008,36332,-12,100,410,310,-118,14,-132,6
"38860",NA,23031,"York County, ME","County or equivalent",2008,201686,555,528,2136,1608,-36,69,-105,63
"38900",NA,NA,"Portland-Vancouver-Beaverton, OR-WA","Metropolitan Statistical Area",2008,2207462,40971,15588,30472,14884,25570,7574,17996,-187
"38900",NA,41005,"Clackamas County, OR","County or equivalent",2008,380576,5469,1484,4235,2751,3978,715,3263,7
"38900",NA,41009,"Columbia County, OR","County or equivalent",2008,49408,494,197,553,356,295,10,285,2
"38900",NA,41051,"Multnomah County, OR","County or equivalent",2008,714567,15381,4762,10164,5402,10459,3104,7355,160
"38900",NA,41067,"Washington County, OR","County or equivalent",2008,529216,9422,5264,8010,2746,4209,2377,1832,-51
"38900",NA,41071,"Yamhill County, OR","County or equivalent",2008,98168,1869,662,1406,744,1238,244,994,-31
"38900",NA,53011,"Clark County, WA","County or equivalent",2008,424733,8240,3187,5998,2811,5326,1121,4205,-273
"38900",NA,53059,"Skamania County, WA","County or equivalent",2008,10794,96,32,106,74,65,3,62,-1
"38940",NA,NA,"Port St. Lucie, FL","Metropolitan Statistical Area",2008,403768,4888,709,5118,4409,3976,733,3243,203
"38940",NA,12085,"Martin County, FL","County or equivalent",2008,138660,-130,-347,1367,1714,238,261,-23,-21
"38940",NA,12111,"St. Lucie County, FL","County or equivalent",2008,265108,5018,1056,3751,2695,3738,472,3266,224
"39100",NA,NA,"Poughkeepsie-Newburgh-Middletown, NY","Metropolitan Statistical Area",2008,672525,3896,4042,8794,4752,-266,1190,-1456,120
"39100",NA,36027,"Dutchess County, NY","County or equivalent",2008,292878,654,970,3209,2239,-356,537,-893,40
"39100",NA,36071,"Orange County, NY","County or equivalent",2008,379647,3242,3072,5585,2513,90,653,-563,80
"39140",NA,NA,"Prescott, AZ","Metropolitan Statistical Area",2008,215503,3324,133,2513,2380,3278,260,3018,-87
"39140",NA,4025,"Yavapai County, AZ","County or equivalent",2008,215503,3324,133,2513,2380,3278,260,3018,-87
"39300",NA,NA,"Providence-New Bedford-Fall River, RI-MA","Metropolitan Statistical Area",2008,1596611,-1737,5057,19237,14180,-7062,3564,-10626,268
"39300",NA,25005,"Bristol County, MA","County or equivalent",2008,545823,611,1511,6494,4983,-1107,703,-1810,207
"39300",NA,44001,"Bristol County, RI","County or equivalent",2008,49838,-103,-74,435,509,-64,23,-87,35
"39300",NA,44003,"Kent County, RI","County or equivalent",2008,168058,-263,148,1748,1600,-434,119,-553,23
"39300",NA,44005,"Newport County, RI","County or equivalent",2008,80478,-615,189,864,675,-827,105,-932,23
"39300",NA,44007,"Providence County, RI","County or equivalent",2008,626150,-1118,3036,8496,5460,-4118,2525,-6643,-36
"39300",NA,44009,"Washington County, RI","County or equivalent",2008,126264,-249,247,1200,953,-512,89,-601,16
"39340",NA,NA,"Provo-Orem, UT","Metropolitan Statistical Area",2008,540820,17989,11161,13071,1910,6800,1073,5727,28
"39340",NA,49023,"Juab County, UT","County or equivalent",2008,9983,415,141,207,66,278,0,278,-4
"39340",NA,49049,"Utah County, UT","County or equivalent",2008,530837,17574,11020,12864,1844,6522,1073,5449,32
"39380",NA,NA,"Pueblo, CO","Metropolitan Statistical Area",2008,156737,2059,706,2221,1515,1270,140,1130,83
"39380",NA,8101,"Pueblo County, CO","County or equivalent",2008,156737,2059,706,2221,1515,1270,140,1130,83
"39460",NA,NA,"Punta Gorda, FL","Metropolitan Statistical Area",2008,150060,-2419,-896,1200,2096,-517,138,-655,-1006
"39460",NA,12015,"Charlotte County, FL","County or equivalent",2008,150060,-2419,-896,1200,2096,-517,138,-655,-1006
"39540",NA,NA,"Racine, WI","Metropolitan Statistical Area",2008,199510,492,1206,2666,1460,-730,209,-939,16
"39540",NA,55101,"Racine County, WI","County or equivalent",2008,199510,492,1206,2666,1460,-730,209,-939,16
"39580",NA,NA,"Raleigh-Cary, NC","Metropolitan Statistical Area",2008,1088765,44804,11605,17175,5570,33034,3766,29268,165
"39580",NA,37069,"Franklin County, NC","County or equivalent",2008,58927,1875,265,742,477,1581,103,1478,29
"39580",NA,37101,"Johnston County, NC","County or equivalent",2008,163428,6548,1529,2602,1073,4969,417,4552,50
"39580",NA,37183,"Wake County, NC","County or equivalent",2008,866410,36381,9811,13831,4020,26484,3246,23238,86
"39660",NA,NA,"Rapid City, SD","Metropolitan Statistical Area",2008,122522,2235,1121,1984,863,1053,57,996,61
"39660",NA,46093,"Meade County, SD","County or equivalent",2008,23989,-68,143,334,191,-220,14,-234,9
"39660",NA,46103,"Pennington County, SD","County or equivalent",2008,98533,2303,978,1650,672,1273,43,1230,52
"39740",NA,NA,"Reading, PA","Metropolitan Statistical Area",2008,403595,2116,1710,5322,3612,195,657,-462,211
"39740",NA,42011,"Berks County, PA","County or equivalent",2008,403595,2116,1710,5322,3612,195,657,-462,211
"39820",NA,NA,"Redding, CA","Metropolitan Statistical Area",2008,180214,1146,508,2328,1820,591,94,497,47
"39820",NA,6089,"Shasta County, CA","County or equivalent",2008,180214,1146,508,2328,1820,591,94,497,47
"39900",NA,NA,"Reno-Sparks, NV","Metropolitan Statistical Area",2008,414784,5897,2846,6047,3201,2994,1365,1629,57
"39900",NA,32029,"Storey County, NV","County or equivalent",2008,4341,164,23,31,8,149,1,148,-8
"39900",NA,32031,"Washoe County, NV","County or equivalent",2008,410443,5733,2823,6016,3193,2845,1364,1481,65
"40060",NA,NA,"Richmond, VA","Metropolitan Statistical Area",2008,1225626,14525,6622,16791,10169,8107,1545,6562,-204
"40060",NA,51007,"Amelia County, VA","County or equivalent",2008,12808,169,40,163,123,123,0,123,6
"40060",NA,51033,"Caroline County, VA","County or equivalent",2008,27632,409,167,415,248,228,6,222,14
"40060",NA,51036,"Charles City County, VA","County or equivalent",2008,7212,82,4,73,69,73,0,73,5
"40060",NA,51041,"Chesterfield County, VA","County or equivalent",2008,303469,4447,2477,4139,1662,2006,377,1629,-36
"40060",NA,51049,"Cumberland County, VA","County or equivalent",2008,9670,83,43,117,74,43,7,36,-3
"40060",NA,51053,"Dinwiddie County, VA","County or equivalent",2008,26082,387,57,300,243,359,4,355,-29
"40060",NA,51075,"Goochland County, VA","County or equivalent",2008,20956,403,54,221,167,342,11,331,7
"40060",NA,51085,"Hanover County, VA","County or equivalent",2008,99716,854,365,1113,748,459,36,423,30
"40060",NA,51087,"Henrico County, VA","County or equivalent",2008,292599,3139,1705,4164,2459,1486,703,783,-52
"40060",NA,51097,"King and Queen County, VA","County or equivalent",2008,6830,-34,-4,83,87,-35,-1,-34,5
"40060",NA,51101,"King William County, VA","County or equivalent",2008,16040,377,95,218,123,287,4,283,-5
"40060",NA,51109,"Louisa County, VA","County or equivalent",2008,32716,835,104,418,314,745,3,742,-14
"40060",NA,51127,"New Kent County, VA","County or equivalent",2008,17825,582,88,203,115,484,0,484,10
"40060",NA,51145,"Powhatan County, VA","County or equivalent",2008,28006,407,140,302,162,254,0,254,13
"40060",NA,51149,"Prince George County, VA","County or equivalent",2008,36089,241,224,372,148,53,17,36,-36
"40060",NA,51183,"Sussex County, VA","County or equivalent",2008,12148,36,-19,137,156,48,5,43,7
"40060",NA,51570,"Colonial Heights city, VA","County or equivalent",2008,17768,12,4,228,224,20,11,9,-12
"40060",NA,51670,"Hopewell city, VA","County or equivalent",2008,23142,76,100,372,272,-28,11,-39,4
"40060",NA,51730,"Petersburg city, VA","County or equivalent",2008,32916,9,97,570,473,-112,16,-128,24
"40060",NA,51760,"Richmond city, VA","County or equivalent",2008,202002,2011,881,3183,2302,1272,335,937,-142
"40140",NA,NA,"Riverside-San Bernardino-Ontario, CA","Metropolitan Statistical Area",2008,4115871,49298,45530,72512,26982,3384,10992,-7608,384
"40140",NA,6065,"Riverside County, CA","County or equivalent",2008,2100516,36151,22007,36675,14668,14204,5471,8733,-60
"40140",NA,6071,"San Bernardino County, CA","County or equivalent",2008,2015355,13147,23523,35837,12314,-10820,5521,-16341,444
"40220",NA,NA,"Roanoke, VA","Metropolitan Statistical Area",2008,298108,1753,395,3584,3189,1465,256,1209,-107
"40220",NA,51023,"Botetourt County, VA","County or equivalent",2008,32261,280,53,299,246,282,1,281,-55
"40220",NA,51045,"Craig County, VA","County or equivalent",2008,5087,-45,-12,49,61,-35,0,-35,2
"40220",NA,51067,"Franklin County, VA","County or equivalent",2008,51477,205,124,597,473,107,6,101,-26
"40220",NA,51161,"Roanoke County, VA","County or equivalent",2008,90867,681,331,1208,877,299,86,213,51
"40220",NA,51770,"Roanoke city, VA","County or equivalent",2008,92967,304,-75,1171,1246,459,148,311,-80
"40220",NA,51775,"Salem city, VA","County or equivalent",2008,25449,328,-26,260,286,353,15,338,1
"40340",NA,NA,"Rochester, MN","Metropolitan Statistical Area",2008,182924,2619,1663,2831,1168,889,498,391,67
"40340",NA,27039,"Dodge County, MN","County or equivalent",2008,19751,275,177,301,124,95,6,89,3
"40340",NA,27109,"Olmsted County, MN","County or equivalent",2008,141360,2228,1402,2257,855,764,474,290,62
"40340",NA,27157,"Wabasha County, MN","County or equivalent",2008,21813,116,84,273,189,30,18,12,2
"40380",NA,NA,"Rochester, NY","Metropolitan Statistical Area",2008,1034090,1602,3295,12103,8808,-2122,1628,-3750,429
"40380",NA,36051,"Livingston County, NY","County or equivalent",2008,63154,-15,138,649,511,-166,7,-173,13
"40380",NA,36055,"Monroe County, NY","County or equivalent",2008,732762,982,2446,8677,6231,-1831,1494,-3325,367
"40380",NA,36069,"Ontario County, NY","County or equivalent",2008,104475,735,256,1183,927,417,78,339,62
"40380",NA,36073,"Orleans County, NY","County or equivalent",2008,42135,-173,93,459,366,-270,13,-283,4
"40380",NA,36117,"Wayne County, NY","County or equivalent",2008,91564,73,362,1135,773,-272,36,-308,-17
"40420",NA,NA,"Rockford, IL","Metropolitan Statistical Area",2008,354394,3134,2294,5197,2903,691,732,-41,149
"40420",NA,17007,"Boone County, IL","County or equivalent",2008,54142,892,511,844,333,360,111,249,21
"40420",NA,17201,"Winnebago County, IL","County or equivalent",2008,300252,2242,1783,4353,2570,331,621,-290,128
"40580",NA,NA,"Rocky Mount, NC","Metropolitan Statistical Area",2008,146356,1023,581,2096,1515,522,157,365,-80
"40580",NA,37065,"Edgecombe County, NC","County or equivalent",2008,52682,54,217,798,581,-103,65,-168,-60
"40580",NA,37127,"Nash County, NC","County or equivalent",2008,93674,969,364,1298,934,625,92,533,-20
"40660",NA,NA,"Rome, GA","Metropolitan Statistical Area",2008,95980,616,423,1432,1009,157,198,-41,36
"40660",NA,13115,"Floyd County, GA","County or equivalent",2008,95980,616,423,1432,1009,157,198,-41,36
"40900",NA,NA,"Sacramento--Arden-Arcade--Roseville, CA","Metropolitan Statistical Area",2008,2109832,27646,16246,31392,15146,11562,7038,4524,-162
"40900",NA,6017,"El Dorado County, CA","County or equivalent",2008,176075,876,939,2100,1161,196,235,-39,-259
"40900",NA,6061,"Placer County, CA","County or equivalent",2008,341945,9824,1822,4484,2662,8426,394,8032,-424
"40900",NA,6067,"Sacramento County, CA","County or equivalent",2008,1394154,13922,11897,22023,10126,1520,5251,-3731,505
"40900",NA,6113,"Yolo County, CA","County or equivalent",2008,197658,3024,1588,2785,1197,1420,1158,262,16
"40980",NA,NA,"Saginaw-Saginaw Township North, MI","Metropolitan Statistical Area",2008,200745,-1527,577,2569,1992,-2177,111,-2288,73
"40980",NA,26145,"Saginaw County, MI","County or equivalent",2008,200745,-1527,577,2569,1992,-2177,111,-2288,73
"41060",NA,NA,"St. Cloud, MN","Metropolitan Statistical Area",2008,186954,1411,1524,2673,1149,-157,123,-280,44
"41060",NA,27009,"Benton County, MN","County or equivalent",2008,39878,402,293,606,313,128,18,110,-19
"41060",NA,27145,"Stearns County, MN","County or equivalent",2008,147076,1009,1231,2067,836,-285,105,-390,63
"41100",NA,NA,"St. George, UT","Metropolitan Statistical Area",2008,137589,4142,2033,2954,921,2453,127,2326,-344
"41100",NA,49053,"Washington County, UT","County or equivalent",2008,137589,4142,2033,2954,921,2453,127,2326,-344
"41140",NA,NA,"St. Joseph, MO-KS","Metropolitan Statistical Area",2008,126359,528,510,1724,1214,-8,34,-42,26
"41140",NA,20043,"Doniphan County, KS","County or equivalent",2008,7753,-14,13,88,75,-24,1,-25,-3
"41140",NA,29003,"Andrew County, MO","County or equivalent",2008,16923,90,46,199,153,43,2,41,1
"41140",NA,29021,"Buchanan County, MO","County or equivalent",2008,89408,395,441,1312,871,-81,28,-109,35
"41140",NA,29063,"DeKalb County, MO","County or equivalent",2008,12275,57,10,125,115,54,3,51,-7
"41180",NA,NA,"St. Louis, MO-IL","Metropolitan Statistical Area",2008,2816710,11245,13675,38185,24510,-2475,3092,-5567,45
"41180",NA,17005,"Bond County, IL","County or equivalent",2008,18253,-81,41,225,184,-126,3,-129,4
"41180",NA,17013,"Calhoun County, IL","County or equivalent",2008,5101,-36,3,61,58,-36,0,-36,-3
"41180",NA,17027,"Clinton County, IL","County or equivalent",2008,36711,317,118,466,348,188,10,178,11
"41180",NA,17083,"Jersey County, IL","County or equivalent",2008,22622,222,30,262,232,180,1,179,12
"41180",NA,17117,"Macoupin County, IL","County or equivalent",2008,48138,-22,36,597,561,-77,5,-82,19
"41180",NA,17119,"Madison County, IL","County or equivalent",2008,268078,1025,1022,3619,2597,-107,76,-183,110
"41180",NA,17133,"Monroe County, IL","County or equivalent",2008,32804,480,148,412,264,318,4,314,14
"41180",NA,17163,"St. Clair County, IL","County or equivalent",2008,262291,824,1398,3927,2529,-661,141,-802,87
"41180",NA,29071,"Franklin County, MO","County or equivalent",2008,100898,976,509,1377,868,424,8,416,43
"41180",NA,29099,"Jefferson County, MO","County or equivalent",2008,217679,1915,1401,3044,1643,455,64,391,59
"41180",NA,29113,"Lincoln County, MO","County or equivalent",2008,52775,1343,454,827,373,911,8,903,-22
"41180",NA,29183,"St. Charles County, MO","County or equivalent",2008,349407,6200,2932,4973,2041,3259,147,3112,9
"41180",NA,29189,"St. Louis County, MO","County or equivalent",2008,991830,-1682,3295,12226,8931,-5046,1350,-6396,69
"41180",NA,29219,"Warren County, MO","County or equivalent",2008,31214,800,258,495,237,526,5,521,16
"41180",NA,29221,"Washington County, MO","County or equivalent",2008,24548,266,103,358,255,166,4,162,-3
"41180",NA,29510,"St. Louis city, MO","County or equivalent",2008,354361,-1302,1927,5316,3389,-2849,1266,-4115,-380
"41420",NA,NA,"Salem, OR","Metropolitan Statistical Area",2008,391680,6572,3071,6102,3031,3529,1406,2123,-28
"41420",NA,41047,"Marion County, OR","County or equivalent",2008,314606,4506,2675,5128,2453,1737,1269,468,94
"41420",NA,41053,"Polk County, OR","County or equivalent",2008,77074,2066,396,974,578,1792,137,1655,-122
"41500",NA,NA,"Salinas, CA","Metropolitan Statistical Area",2008,408238,3592,5131,7451,2320,-1387,3098,-4485,-152
"41500",NA,6053,"Monterey County, CA","County or equivalent",2008,408238,3592,5131,7451,2320,-1387,3098,-4485,-152
"41540",NA,NA,"Salisbury, MD","Metropolitan Statistical Area",2008,120165,800,494,1646,1152,353,134,219,-47
"41540",NA,24039,"Somerset County, MD","County or equivalent",2008,26119,-28,29,292,263,-57,20,-77,0
"41540",NA,24045,"Wicomico County, MD","County or equivalent",2008,94046,828,465,1354,889,410,114,296,-47
"41620",NA,NA,"Salt Lake City, UT","Metropolitan Statistical Area",2008,1115692,20330,15542,21283,5741,4612,4369,243,176
"41620",NA,49035,"Salt Lake County, UT","County or equivalent",2008,1022651,17406,14173,19540,5367,3042,4206,-1164,191
"41620",NA,49043,"Summit County, UT","County or equivalent",2008,36100,723,440,552,112,295,111,184,-12
"41620",NA,49045,"Tooele County, UT","County or equivalent",2008,56941,2201,929,1191,262,1275,52,1223,-3
"41660",NA,NA,"San Angelo, TX","Metropolitan Statistical Area",2008,109563,1212,749,1732,983,435,98,337,28
"41660",NA,48235,"Irion County, TX","County or equivalent",2008,1699,-23,11,12,1,-27,0,-27,-7
"41660",NA,48451,"Tom Green County, TX","County or equivalent",2008,107864,1235,738,1720,982,462,98,364,35
"41700",NA,NA,"San Antonio, TX","Metropolitan Statistical Area",2008,2031445,46524,19669,33813,14144,26587,3796,22791,268
"41700",NA,48013,"Atascosa County, TX","County or equivalent",2008,43877,400,374,712,338,20,33,-13,6
"41700",NA,48019,"Bandera County, TX","County or equivalent",2008,20303,191,38,207,169,166,13,153,-13
"41700",NA,48029,"Bexar County, TX","County or equivalent",2008,1622899,32753,17007,28018,11011,15399,3458,11941,347
"41700",NA,48091,"Comal County, TX","County or equivalent",2008,109635,4884,712,1553,841,4166,86,4080,6
"41700",NA,48187,"Guadalupe County, TX","County or equivalent",2008,117172,4807,889,1687,798,3905,154,3751,13
"41700",NA,48259,"Kendall County, TX","County or equivalent",2008,32886,1715,149,445,296,1645,30,1615,-79
"41700",NA,48325,"Medina County, TX","County or equivalent",2008,44275,522,283,640,357,231,15,216,8
"41700",NA,48493,"Wilson County, TX","County or equivalent",2008,40398,1252,217,551,334,1055,7,1048,-20
"41740",NA,NA,"San Diego-Carlsbad-San Marcos, CA","Metropolitan Statistical Area",2008,3001072,41338,27603,47565,19962,13407,12987,420,328
"41740",NA,6073,"San Diego County, CA","County or equivalent",2008,3001072,41338,27603,47565,19962,13407,12987,420,328
"41780",NA,NA,"Sandusky, OH","Metropolitan Statistical Area",2008,77062,-100,73,911,838,-230,17,-247,57
"41780",NA,39043,"Erie County, OH","County or equivalent",2008,77062,-100,73,911,838,-230,17,-247,57
"41860",NA,NA,"San Francisco-Oakland-Fremont, CA","Metropolitan Statistical Area",2008,4274531,58406,25158,54818,29660,33010,27504,5506,238
"41860",36084,NA,"Oakland-Fremont-Hayward, CA","Metropolitan Division",2008,2504071,35738,17395,34059,16664,18058,14890,3168,285
"41860",36084,6001,"Alameda County, CA","County or equivalent",2008,1474368,20722,11054,20656,9602,9669,10791,-1122,-1
"41860",36084,6013,"Contra Costa County, CA","County or equivalent",2008,1029703,15016,6341,13403,7062,8389,4099,4290,286
"41860",41884,NA,"San Francisco-San Mateo-Redwood City, CA","Metropolitan Division",2008,1770460,22668,7763,20759,12996,14952,12614,2338,-47
"41860",41884,6041,"Marin County, CA","County or equivalent",2008,248794,1862,701,2561,1860,1031,1079,-48,130
"41860",41884,6075,"San Francisco County, CA","County or equivalent",2008,808976,9791,2320,8654,6334,7584,6170,1414,-113
"41860",41884,6081,"San Mateo County, CA","County or equivalent",2008,712690,11015,4742,9544,4802,6337,5365,972,-64
"41940",NA,NA,"San Jose-Sunnyvale-Santa Clara, CA","Metropolitan Statistical Area",2008,1819198,32843,18009,27477,9468,15280,17905,-2625,-446
"41940",NA,6069,"San Benito County, CA","County or equivalent",2008,54699,302,585,855,270,-287,241,-528,4
"41940",NA,6085,"Santa Clara County, CA","County or equivalent",2008,1764499,32541,17424,26622,9198,15567,17664,-2097,-450
"42020",NA,NA,"San Luis Obispo-Paso Robles, CA","Metropolitan Statistical Area",2008,265297,3531,941,3039,2098,2441,439,2002,149
"42020",NA,6079,"San Luis Obispo County, CA","County or equivalent",2008,265297,3531,941,3039,2098,2441,439,2002,149
"42060",NA,NA,"Santa Barbara-Santa Maria-Goleta, CA","Metropolitan Statistical Area",2008,405396,3304,3420,6312,2892,-78,2037,-2115,-38
"42060",NA,6083,"Santa Barbara County, CA","County or equivalent",2008,405396,3304,3420,6312,2892,-78,2037,-2115,-38
"42100",NA,NA,"Santa Cruz-Watsonville, CA","Metropolitan Statistical Area",2008,253137,2482,1825,3461,1636,603,1084,-481,54
"42100",NA,6087,"Santa Cruz County, CA","County or equivalent",2008,253137,2482,1825,3461,1636,603,1084,-481,54
"42140",NA,NA,"Santa Fe, NM","Metropolitan Statistical Area",2008,143937,1568,708,1677,969,813,540,273,47
"42140",NA,35049,"Santa Fe County, NM","County or equivalent",2008,143937,1568,708,1677,969,813,540,273,47
"42220",NA,NA,"Santa Rosa-Petaluma, CA","Metropolitan Statistical Area",2008,466741,4451,2182,5948,3766,2054,1763,291,215
"42220",NA,6097,"Sonoma County, CA","County or equivalent",2008,466741,4451,2182,5948,3766,2054,1763,291,215
"42340",NA,NA,"Savannah, GA","Metropolitan Statistical Area",2008,334353,5046,2584,5340,2756,2400,382,2018,62
"42340",NA,13029,"Bryan County, GA","County or equivalent",2008,31173,1182,311,514,203,865,10,855,6
"42340",NA,13051,"Chatham County, GA","County or equivalent",2008,251120,2588,1858,4079,2221,668,362,306,62
"42340",NA,13103,"Effingham County, GA","County or equivalent",2008,52060,1276,415,747,332,867,10,857,-6
"42540",NA,NA,"Scranton--Wilkes-Barre, PA","Metropolitan Statistical Area",2008,549150,98,-1068,5955,7023,828,220,608,338
"42540",NA,42069,"Lackawanna County, PA","County or equivalent",2008,209408,146,-340,2335,2675,340,93,247,146
"42540",NA,42079,"Luzerne County, PA","County or equivalent",2008,311983,1,-765,3309,4074,569,124,445,197
"42540",NA,42131,"Wyoming County, PA","County or equivalent",2008,27759,-49,37,311,274,-81,3,-84,-5
"42660",NA,NA,"Seattle-Tacoma-Bellevue, WA","Metropolitan Statistical Area",2008,3344813,46588,21531,43417,21886,23735,11866,11869,1322
"42660",42644,NA,"Seattle-Bellevue-Everett, WA","Metropolitan Division",2008,2559174,34054,16385,32545,16160,16693,10491,6202,976
"42660",42644,53033,"King County, WA","County or equivalent",2008,1875519,24805,11209,23073,11864,12804,8829,3975,792
"42660",42644,53061,"Snohomish County, WA","County or equivalent",2008,683655,9249,5176,9472,4296,3889,1662,2227,184
"42660",45104,NA,"Tacoma, WA","Metropolitan Division",2008,785639,12534,5146,10872,5726,7042,1375,5667,346
"42660",45104,53053,"Pierce County, WA","County or equivalent",2008,785639,12534,5146,10872,5726,7042,1375,5667,346
"42680",NA,NA,"Sebastian-Vero Beach, FL","Metropolitan Statistical Area",2008,132315,869,-154,1531,1685,997,218,779,26
"42680",NA,12061,"Indian River County, FL","County or equivalent",2008,132315,869,-154,1531,1685,997,218,779,26
"43100",NA,NA,"Sheboygan, WI","Metropolitan Statistical Area",2008,114561,355,482,1466,984,-176,124,-300,49
"43100",NA,55117,"Sheboygan County, WI","County or equivalent",2008,114561,355,482,1466,984,-176,124,-300,49
"43300",NA,NA,"Sherman-Denison, TX","Metropolitan Statistical Area",2008,118804,738,523,1729,1206,179,168,11,36
"43300",NA,48181,"Grayson County, TX","County or equivalent",2008,118804,738,523,1729,1206,179,168,11,36
"43340",NA,NA,"Shreveport-Bossier City, LA","Metropolitan Statistical Area",2008,389533,2033,2206,5966,3760,-195,164,-359,22
"43340",NA,22015,"Bossier Parish, LA","County or equivalent",2008,110250,1504,903,1770,867,608,65,543,-7
"43340",NA,22017,"Caddo Parish, LA","County or equivalent",2008,252895,418,1221,3817,2596,-824,93,-917,21
"43340",NA,22031,"De Soto Parish, LA","County or equivalent",2008,26388,111,82,379,297,21,6,15,8
"43580",NA,NA,"Sioux City, IA-NE-SD","Metropolitan Statistical Area",2008,143157,817,1006,2203,1197,-176,426,-602,-13
"43580",NA,19193,"Woodbury County, IA","County or equivalent",2008,102559,649,745,1626,881,-147,289,-436,51
"43580",NA,31043,"Dakota County, NE","County or equivalent",2008,20174,-104,152,297,145,-228,113,-341,-28
"43580",NA,31051,"Dixon County, NE","County or equivalent",2008,6293,74,20,90,70,89,4,85,-35
"43580",NA,46127,"Union County, SD","County or equivalent",2008,14131,198,89,190,101,110,20,90,-1
"43620",NA,NA,"Sioux Falls, SD","Metropolitan Statistical Area",2008,232930,5937,2237,3802,1565,3763,348,3415,-63
"43620",NA,46083,"Lincoln County, SD","County or equivalent",2008,39713,1981,606,804,198,1370,13,1357,5
"43620",NA,46087,"McCook County, SD","County or equivalent",2008,5671,-76,11,84,73,-88,1,-89,1
"43620",NA,46099,"Minnehaha County, SD","County or equivalent",2008,179180,4038,1628,2820,1192,2482,332,2150,-72
"43620",NA,46125,"Turner County, SD","County or equivalent",2008,8366,-6,-8,94,102,-1,2,-3,3
"43780",NA,NA,"South Bend-Mishawaka, IN-MI","Metropolitan Statistical Area",2008,316865,632,1609,4398,2789,-930,481,-1411,-47
"43780",NA,18141,"St. Joseph County, IN","County or equivalent",2008,266680,923,1526,3863,2337,-686,472,-1158,83
"43780",NA,26027,"Cass County, MI","County or equivalent",2008,50185,-291,83,535,452,-244,9,-253,-130
"43900",NA,NA,"Spartanburg, SC","Metropolitan Statistical Area",2008,280738,5453,999,3703,2704,4468,349,4119,-14
"43900",NA,45083,"Spartanburg County, SC","County or equivalent",2008,280738,5453,999,3703,2704,4468,349,4119,-14
"44060",NA,NA,"Spokane, WA","Metropolitan Statistical Area",2008,462677,6673,2461,6219,3758,4250,621,3629,-38
"44060",NA,53063,"Spokane County, WA","County or equivalent",2008,462677,6673,2461,6219,3758,4250,621,3629,-38
"44100",NA,NA,"Springfield, IL","Metropolitan Statistical Area",2008,207389,1097,835,2791,1956,160,85,75,102
"44100",NA,17129,"Menard County, IL","County or equivalent",2008,12464,10,10,141,131,11,3,8,-11
"44100",NA,17167,"Sangamon County, IL","County or equivalent",2008,194925,1087,825,2650,1825,149,82,67,113
"44140",NA,NA,"Springfield, MA","Metropolitan Statistical Area",2008,687558,617,1800,7975,6175,-1397,1874,-3271,214
"44140",NA,25011,"Franklin County, MA","County or equivalent",2008,71735,88,91,712,621,-46,82,-128,43
"44140",NA,25013,"Hampden County, MA","County or equivalent",2008,460840,211,1605,5980,4375,-1535,1527,-3062,141
"44140",NA,25015,"Hampshire County, MA","County or equivalent",2008,154983,318,104,1283,1179,184,265,-81,30
"44180",NA,NA,"Springfield, MO","Metropolitan Statistical Area",2008,426144,6537,2649,6271,3622,3841,170,3671,47
"44180",NA,29043,"Christian County, MO","County or equivalent",2008,75479,2525,620,1150,530,1942,5,1937,-37
"44180",NA,29059,"Dallas County, MO","County or equivalent",2008,16844,29,86,255,169,-58,3,-61,1
"44180",NA,29077,"Greene County, MO","County or equivalent",2008,266944,3151,1538,3845,2307,1541,137,1404,72
"44180",NA,29167,"Polk County, MO","County or equivalent",2008,30404,242,123,445,322,116,21,95,3
"44180",NA,29225,"Webster County, MO","County or equivalent",2008,36473,590,282,576,294,300,4,296,8
"44220",NA,NA,"Springfield, OH","Metropolitan Statistical Area",2008,139859,-434,286,1880,1594,-780,28,-808,60
"44220",NA,39023,"Clark County, OH","County or equivalent",2008,139859,-434,286,1880,1594,-780,28,-808,60
"44300",NA,NA,"State College, PA","Metropolitan Statistical Area",2008,144779,1011,445,1381,936,504,498,6,62
"44300",NA,42027,"Centre County, PA","County or equivalent",2008,144779,1011,445,1381,936,504,498,6,62
"44700",NA,NA,"Stockton, CA","Metropolitan Statistical Area",2008,672388,4502,7074,11805,4731,-2819,2356,-5175,247
"44700",NA,6077,"San Joaquin County, CA","County or equivalent",2008,672388,4502,7074,11805,4731,-2819,2356,-5175,247
"44940",NA,NA,"Sumter, SC","Metropolitan Statistical Area",2008,104148,140,625,1625,1000,-513,74,-587,28
"44940",NA,45085,"Sumter County, SC","County or equivalent",2008,104148,140,625,1625,1000,-513,74,-587,28
"45060",NA,NA,"Syracuse, NY","Metropolitan Statistical Area",2008,643794,-180,2350,7906,5556,-2497,863,-3360,-33
"45060",NA,36053,"Madison County, NY","County or equivalent",2008,69766,-96,195,768,573,-285,21,-306,-6
"45060",NA,36067,"Onondaga County, NY","County or equivalent",2008,452633,-20,1757,5720,3963,-1738,819,-2557,-39
"45060",NA,36075,"Oswego County, NY","County or equivalent",2008,121395,-64,398,1418,1020,-474,23,-497,12
"45220",NA,NA,"Tallahassee, FL","Metropolitan Statistical Area",2008,357259,3834,2206,4716,2510,1572,462,1110,56
"45220",NA,12039,"Gadsden County, FL","County or equivalent",2008,47560,804,280,756,476,517,52,465,7
"45220",NA,12065,"Jefferson County, FL","County or equivalent",2008,14547,118,-1,157,158,134,-1,135,-15
"45220",NA,12073,"Leon County, FL","County or equivalent",2008,264063,1922,1837,3451,1614,-5,406,-411,90
"45220",NA,12129,"Wakulla County, FL","County or equivalent",2008,31089,990,90,352,262,926,5,921,-26
"45300",NA,NA,"Tampa-St. Petersburg-Clearwater, FL","Metropolitan Statistical Area",2008,2733761,18488,4557,33755,29198,13560,7050,6510,371
"45300",NA,12053,"Hernando County, FL","County or equivalent",2008,171689,2880,-685,1798,2483,3635,77,3558,-70
"45300",NA,12057,"Hillsborough County, FL","County or equivalent",2008,1180784,10266,7987,17223,9236,2034,4134,-2100,245
"45300",NA,12101,"Pasco County, FL","County or equivalent",2008,471028,9526,-28,5734,5762,9827,528,9299,-273
"45300",NA,12103,"Pinellas County, FL","County or equivalent",2008,910260,-4184,-2717,9000,11717,-1936,2311,-4247,469
"45460",NA,NA,"Terre Haute, IN","Metropolitan Statistical Area",2008,170233,122,302,2165,1863,-183,96,-279,3
"45460",NA,18021,"Clay County, IN","County or equivalent",2008,26703,71,50,338,288,16,8,8,5
"45460",NA,18153,"Sullivan County, IN","County or equivalent",2008,21328,-12,-7,230,237,-17,-1,-16,12
"45460",NA,18165,"Vermillion County, IN","County or equivalent",2008,16234,-144,-19,211,230,-123,2,-125,-2
"45460",NA,18167,"Vigo County, IN","County or equivalent",2008,105968,207,278,1386,1108,-59,87,-146,-12
"45500",NA,NA,"Texarkana, TX-Texarkana, AR","Metropolitan Statistical Area",2008,135509,1285,518,1802,1284,769,56,713,-2
"45500",NA,5091,"Miller County, AR","County or equivalent",2008,43226,441,306,609,303,139,19,120,-4
"45500",NA,48037,"Bowie County, TX","County or equivalent",2008,92283,844,212,1193,981,630,37,593,2
"45780",NA,NA,"Toledo, OH","Metropolitan Statistical Area",2008,649104,-1666,2956,8892,5936,-4739,498,-5237,117
"45780",NA,39051,"Fulton County, OH","County or equivalent",2008,42485,3,209,563,354,-220,8,-228,14
"45780",NA,39095,"Lucas County, OH","County or equivalent",2008,440456,-1952,2229,6444,4215,-4258,395,-4653,77
"45780",NA,39123,"Ottawa County, OH","County or equivalent",2008,40823,-246,15,445,430,-239,1,-240,-22
"45780",NA,39173,"Wood County, OH","County or equivalent",2008,125340,529,503,1440,937,-22,94,-116,48
"45820",NA,NA,"Topeka, KS","Metropolitan Statistical Area",2008,229619,1324,1260,3375,2115,55,182,-127,9
"45820",NA,20085,"Jackson County, KS","County or equivalent",2008,13240,-108,75,189,114,-191,1,-192,8
"45820",NA,20087,"Jefferson County, KS","County or equivalent",2008,18421,-15,56,223,167,-63,4,-67,-8
"45820",NA,20139,"Osage County, KS","County or equivalent",2008,16327,-92,21,192,171,-91,2,-93,-22
"45820",NA,20177,"Shawnee County, KS","County or equivalent",2008,174709,1462,1076,2675,1599,354,174,180,32
"45820",NA,20197,"Wabaunsee County, KS","County or equivalent",2008,6922,77,32,96,64,46,1,45,-1
"45940",NA,NA,"Trenton-Ewing, NJ","Metropolitan Statistical Area",2008,364883,1126,2013,4757,2744,-833,1756,-2589,-54
"45940",NA,34021,"Mercer County, NJ","County or equivalent",2008,364883,1126,2013,4757,2744,-833,1756,-2589,-54
"46060",NA,NA,"Tucson, AZ","Metropolitan Statistical Area",2008,1012018,15425,6186,14337,8151,9530,2509,7021,-291
"46060",NA,4019,"Pima County, AZ","County or equivalent",2008,1012018,15425,6186,14337,8151,9530,2509,7021,-291
"46140",NA,NA,"Tulsa, OK","Metropolitan Statistical Area",2008,916079,11734,5790,14111,8321,5771,1405,4366,173
"46140",NA,40037,"Creek County, OK","County or equivalent",2008,69822,882,191,930,739,643,7,636,48
"46140",NA,40111,"Okmulgee County, OK","County or equivalent",2008,39219,-125,113,563,450,-252,11,-263,14
"46140",NA,40113,"Osage County, OK","County or equivalent",2008,45489,56,112,478,366,6,12,-6,-62
"46140",NA,40117,"Pawnee County, OK","County or equivalent",2008,16307,-114,23,208,185,-148,0,-148,11
"46140",NA,40131,"Rogers County, OK","County or equivalent",2008,84300,1369,407,1075,668,931,27,904,31
"46140",NA,40143,"Tulsa County, OK","County or equivalent",2008,591982,7841,4377,9887,5510,3233,1319,1914,231
"46140",NA,40145,"Wagoner County, OK","County or equivalent",2008,68960,1825,567,970,403,1358,29,1329,-100
"46220",NA,NA,"Tuscaloosa, AL","Metropolitan Statistical Area",2008,206765,2267,954,2822,1868,1258,184,1074,55
"46220",NA,1063,"Greene County, AL","County or equivalent",2008,9172,-32,-1,113,114,-25,0,-25,-6
"46220",NA,1065,"Hale County, AL","County or equivalent",2008,18145,62,11,227,216,46,0,46,5
"46220",NA,1125,"Tuscaloosa County, AL","County or equivalent",2008,179448,2237,944,2482,1538,1237,184,1053,56
"46340",NA,NA,"Tyler, TX","Metropolitan Statistical Area",2008,201277,3325,1473,3243,1770,1813,432,1381,39
"46340",NA,48423,"Smith County, TX","County or equivalent",2008,201277,3325,1473,3243,1770,1813,432,1381,39
"46540",NA,NA,"Utica-Rome, NY","Metropolitan Statistical Area",2008,293790,-268,330,3436,3106,-771,598,-1369,173
"46540",NA,36043,"Herkimer County, NY","County or equivalent",2008,62200,-188,59,751,692,-247,15,-262,0
"46540",NA,36065,"Oneida County, NY","County or equivalent",2008,231590,-80,271,2685,2414,-524,583,-1107,173
"46660",NA,NA,"Valdosta, GA","Metropolitan Statistical Area",2008,133348,3386,1117,2157,1040,2304,128,2176,-35
"46660",NA,13027,"Brooks County, GA","County or equivalent",2008,16425,101,-13,181,194,120,10,110,-6
"46660",NA,13101,"Echols County, GA","County or equivalent",2008,4063,2,20,26,6,-1,39,-40,-17
"46660",NA,13173,"Lanier County, GA","County or equivalent",2008,8277,339,52,111,59,286,5,281,1
"46660",NA,13185,"Lowndes County, GA","County or equivalent",2008,104583,2944,1058,1839,781,1899,74,1825,-13
"46700",NA,NA,"Vallejo-Fairfield, CA","Metropolitan Statistical Area",2008,407515,473,3012,5834,2822,-2634,1298,-3932,95
"46700",NA,6095,"Solano County, CA","County or equivalent",2008,407515,473,3012,5834,2822,-2634,1298,-3932,95
"47020",NA,NA,"Victoria, TX","Metropolitan Statistical Area",2008,114313,791,796,1801,1005,-40,157,-197,35
"47020",NA,48057,"Calhoun County, TX","County or equivalent",2008,20406,149,118,305,187,44,69,-25,-13
"47020",NA,48175,"Goliad County, TX","County or equivalent",2008,7152,53,12,80,68,43,1,42,-2
"47020",NA,48469,"Victoria County, TX","County or equivalent",2008,86755,589,666,1416,750,-127,87,-214,50
"47220",NA,NA,"Vineland-Millville-Bridgeton, NJ","Metropolitan Statistical Area",2008,156830,1423,1172,2582,1410,179,419,-240,72
"47220",NA,34011,"Cumberland County, NJ","County or equivalent",2008,156830,1423,1172,2582,1410,179,419,-240,72
"47260",NA,NA,"Virginia Beach-Norfolk-Newport News, VA-NC","Metropolitan Statistical Area",2008,1658292,-1387,12079,24674,12595,-13978,1545,-15523,512
"47260",NA,37053,"Currituck County, NC","County or equivalent",2008,24183,324,102,285,183,221,6,215,1
"47260",NA,51073,"Gloucester County, VA","County or equivalent",2008,38656,458,132,447,315,328,4,324,-2
"47260",NA,51093,"Isle of Wight County, VA","County or equivalent",2008,35472,525,112,413,301,409,5,404,4
"47260",NA,51095,"James City County, VA","County or equivalent",2008,62414,1320,129,631,502,1178,42,1136,13
"47260",NA,51115,"Mathews County, VA","County or equivalent",2008,9038,0,-52,65,117,59,1,58,-7
"47260",NA,51181,"Surry County, VA","County or equivalent",2008,7128,44,3,69,66,43,-1,44,-2
"47260",NA,51199,"York County, VA","County or equivalent",2008,61027,-59,239,602,363,-296,64,-360,-2
"47260",NA,51550,"Chesapeake city, VA","County or equivalent",2008,220111,1281,1576,3093,1517,-311,102,-413,16
"47260",NA,51650,"Hampton city, VA","County or equivalent",2008,145494,-972,920,2046,1126,-1910,113,-2023,18
"47260",NA,51700,"Newport News city, VA","County or equivalent",2008,179614,-1196,1753,3142,1389,-3054,255,-3309,105
"47260",NA,51710,"Norfolk city, VA","County or equivalent",2008,234220,-1762,2251,4205,1954,-4117,313,-4430,104
"47260",NA,51735,"Poquoson city, VA","County or equivalent",2008,11829,-5,-5,103,108,5,4,1,-5
"47260",NA,51740,"Portsmouth city, VA","County or equivalent",2008,100577,-1354,650,1716,1066,-2066,22,-2088,62
"47260",NA,51800,"Suffolk city, VA","County or equivalent",2008,82302,1183,558,1261,703,619,27,592,6
"47260",NA,51810,"Virginia Beach city, VA","County or equivalent",2008,433746,-1258,3608,6370,2762,-5084,569,-5653,218
"47260",NA,51830,"Williamsburg city, VA","County or equivalent",2008,12481,84,103,226,123,-2,19,-21,-17
"47300",NA,NA,"Visalia-Porterville, CA","Metropolitan Statistical Area",2008,426276,7104,6196,8956,2760,755,1809,-1054,153
"47300",NA,6107,"Tulare County, CA","County or equivalent",2008,426276,7104,6196,8956,2760,755,1809,-1054,153
"47380",NA,NA,"Waco, TX","Metropolitan Statistical Area",2008,230213,2407,1639,3594,1955,681,462,219,87
"47380",NA,48309,"McLennan County, TX","County or equivalent",2008,230213,2407,1639,3594,1955,681,462,219,87
"47580",NA,NA,"Warner Robins, GA","Metropolitan Statistical Area",2008,133161,2189,1084,2024,940,1098,124,974,7
"47580",NA,13153,"Houston County, GA","County or equivalent",2008,133161,2189,1084,2024,940,1098,124,974,7
"47900",NA,NA,"Washington-Arlington-Alexandria, DC-VA-MD-WV","Metropolitan Statistical Area",2008,5358130,55835,47110,78386,31276,9716,27975,-18259,-991
"47900",13644,NA,"Bethesda-Frederick-Gaithersburg, MD","Metropolitan Division",2008,1176401,10763,9219,16131,6912,1380,7334,-5954,164
"47900",13644,24021,"Frederick County, MD","County or equivalent",2008,225721,1574,1645,3102,1457,-168,228,-396,97
"47900",13644,24031,"Montgomery County, MD","County or equivalent",2008,950680,9189,7574,13029,5455,1548,7106,-5558,67
"47900",47894,NA,"Washington-Arlington-Alexandria, DC-VA-MD-WV","Metropolitan Division",2008,4181729,45072,37891,62255,24364,8336,20641,-12305,-1155
"47900",47894,11001,"District of Columbia, DC","County or equivalent",2008,591833,3965,2941,8313,5372,1210,2832,-1622,-186
"47900",47894,24009,"Calvert County, MD","County or equivalent",2008,88698,553,451,1077,626,105,38,67,-3
"47900",47894,24017,"Charles County, MD","County or equivalent",2008,140764,595,1070,1936,866,-451,62,-513,-24
"47900",47894,24033,"Prince George's County, MD","County or equivalent",2008,820852,-4466,6817,12239,5422,-10860,3463,-14323,-423
"47900",47894,51013,"Arlington County, VA","County or equivalent",2008,209969,6060,1890,2929,1039,4153,2403,1750,17
"47900",47894,51043,"Clarke County, VA","County or equivalent",2008,14458,117,5,144,139,112,9,103,0
"47900",47894,51059,"Fairfax County, VA","County or equivalent",2008,1015302,11151,9113,13631,4518,2532,7969,-5437,-494
"47900",47894,51061,"Fauquier County, VA","County or equivalent",2008,66839,717,386,849,463,330,55,275,1
"47900",47894,51107,"Loudoun County, VA","County or equivalent",2008,289995,12649,4481,5450,969,8282,671,7611,-114
"47900",47894,51153,"Prince William County, VA","County or equivalent",2008,364734,5146,5254,6697,1443,-166,990,-1156,58
"47900",47894,51177,"Spotsylvania County, VA","County or equivalent",2008,120031,1144,1077,1773,696,37,52,-15,30
"47900",47894,51179,"Stafford County, VA","County or equivalent",2008,121736,1115,1205,1737,532,-118,52,-170,28
"47900",47894,51187,"Warren County, VA","County or equivalent",2008,36663,406,221,528,307,168,6,162,17
"47900",47894,51510,"Alexandria city, VA","County or equivalent",2008,143885,4037,1697,2529,832,2317,1487,830,23
"47900",47894,51600,"Fairfax city, VA","County or equivalent",2008,23844,617,124,346,222,509,221,288,-16
"47900",47894,51610,"Falls Church city, VA","County or equivalent",2008,11169,263,68,139,71,206,62,144,-11
"47900",47894,51630,"Fredericksburg city, VA","County or equivalent",2008,22818,431,196,429,233,291,36,255,-56
"47900",47894,51683,"Manassas city, VA","County or equivalent",2008,35205,-154,419,616,197,-550,167,-717,-23
"47900",47894,51685,"Manassas Park city, VA","County or equivalent",2008,11319,-101,216,234,18,-315,51,-366,-2
"47900",47894,54037,"Jefferson County, WV","County or equivalent",2008,51615,827,260,659,399,544,15,529,23
"47940",NA,NA,"Waterloo-Cedar Falls, IA","Metropolitan Statistical Area",2008,164220,1146,804,2204,1400,327,300,27,15
"47940",NA,19013,"Black Hawk County, IA","County or equivalent",2008,128347,1143,730,1781,1051,414,296,118,-1
"47940",NA,19017,"Bremer County, IA","County or equivalent",2008,23690,-33,73,287,214,-115,5,-120,9
"47940",NA,19075,"Grundy County, IA","County or equivalent",2008,12183,36,1,136,135,28,-1,29,7
"48140",NA,NA,"Wausau, WI","Metropolitan Statistical Area",2008,130962,1179,721,1717,996,415,73,342,43
"48140",NA,55073,"Marathon County, WI","County or equivalent",2008,130962,1179,721,1717,996,415,73,342,43
"48260",NA,NA,"Weirton-Steubenville, WV-OH","Metropolitan Statistical Area",2008,122054,-497,-425,1261,1686,-61,16,-77,-11
"48260",NA,39081,"Jefferson County, OH","County or equivalent",2008,68526,-230,-236,726,962,-30,16,-46,36
"48260",NA,54009,"Brooke County, WV","County or equivalent",2008,23520,-117,-95,218,313,-19,0,-19,-3
"48260",NA,54029,"Hancock County, WV","County or equivalent",2008,30008,-150,-94,317,411,-12,0,-12,-44
"48300",NA,NA,"Wenatchee, WA","Metropolitan Statistical Area",2008,108193,1464,621,1531,910,963,340,623,-120
"48300",NA,53007,"Chelan County, WA","County or equivalent",2008,71540,846,334,972,638,624,226,398,-112
"48300",NA,53017,"Douglas County, WA","County or equivalent",2008,36653,618,287,559,272,339,114,225,-8
"48540",NA,NA,"Wheeling, WV-OH","Metropolitan Statistical Area",2008,144847,-917,-277,1529,1806,-619,27,-646,-21
"48540",NA,39013,"Belmont County, OH","County or equivalent",2008,67975,-317,-127,735,862,-174,9,-183,-16
"48540",NA,54051,"Marshall County, WV","County or equivalent",2008,32766,-346,-64,315,379,-249,0,-249,-33
"48540",NA,54069,"Ohio County, WV","County or equivalent",2008,44106,-254,-86,479,565,-196,18,-214,28
"48620",NA,NA,"Wichita, KS","Metropolitan Statistical Area",2008,603716,8395,5012,9982,4970,3238,1101,2137,145
"48620",NA,20015,"Butler County, KS","County or equivalent",2008,63562,683,317,862,545,345,30,315,21
"48620",NA,20079,"Harvey County, KS","County or equivalent",2008,33675,204,104,454,350,77,39,38,23
"48620",NA,20173,"Sedgwick County, KS","County or equivalent",2008,482863,7714,4524,8358,3834,3042,1030,2012,148
"48620",NA,20191,"Sumner County, KS","County or equivalent",2008,23616,-206,67,308,241,-226,2,-228,-47
"48660",NA,NA,"Wichita Falls, TX","Metropolitan Statistical Area",2008,147328,-592,763,2203,1440,-1272,197,-1469,-83
"48660",NA,48009,"Archer County, TX","County or equivalent",2008,9119,165,34,117,83,134,2,132,-3
"48660",NA,48077,"Clay County, TX","County or equivalent",2008,10888,-223,7,110,103,-203,1,-204,-27
"48660",NA,48485,"Wichita County, TX","County or equivalent",2008,127321,-534,722,1976,1254,-1203,194,-1397,-53
"48700",NA,NA,"Williamsport, PA","Metropolitan Statistical Area",2008,116670,-165,159,1396,1237,-367,10,-377,43
"48700",NA,42081,"Lycoming County, PA","County or equivalent",2008,116670,-165,159,1396,1237,-367,10,-377,43
"48900",NA,NA,"Wilmington, NC","Metropolitan Statistical Area",2008,347012,8232,1449,4375,2926,6681,360,6321,102
"48900",NA,37019,"Brunswick County, NC","County or equivalent",2008,103160,4194,281,1221,940,3878,87,3791,35
"48900",NA,37129,"New Hanover County, NC","County or equivalent",2008,192538,2434,1005,2540,1535,1363,210,1153,66
"48900",NA,37141,"Pender County, NC","County or equivalent",2008,51314,1604,163,614,451,1440,63,1377,1
"49020",NA,NA,"Winchester, VA-WV","Metropolitan Statistical Area",2008,122369,1462,793,1771,978,683,133,550,-14
"49020",NA,51069,"Frederick County, VA","County or equivalent",2008,73898,1211,620,1094,474,589,36,553,2
"49020",NA,51840,"Winchester city, VA","County or equivalent",2008,25897,219,140,416,276,107,96,11,-28
"49020",NA,54027,"Hampshire County, WV","County or equivalent",2008,22574,32,33,261,228,-13,1,-14,12
"49180",NA,NA,"Winston-Salem, NC","Metropolitan Statistical Area",2008,468124,6509,2624,6581,3957,3757,1237,2520,128
"49180",NA,37059,"Davie County, NC","County or equivalent",2008,40971,607,129,474,345,453,55,398,25
"49180",NA,37067,"Forsyth County, NC","County or equivalent",2008,343028,5389,2362,5153,2791,2962,1085,1877,65
"49180",NA,37169,"Stokes County, NC","County or equivalent",2008,46171,234,27,481,454,192,31,161,15
"49180",NA,37197,"Yadkin County, NC","County or equivalent",2008,37954,279,106,473,367,150,66,84,23
"49340",NA,NA,"Worcester, MA","Metropolitan Statistical Area",2008,783806,1663,3372,9977,6605,-1956,2227,-4183,247
"49340",NA,25027,"Worcester County, MA","County or equivalent",2008,783806,1663,3372,9977,6605,-1956,2227,-4183,247
"49420",NA,NA,"Yakima, WA","Metropolitan Statistical Area",2008,234564,2543,2636,4392,1756,-167,846,-1013,74
"49420",NA,53077,"Yakima County, WA","County or equivalent",2008,234564,2543,2636,4392,1756,-167,846,-1013,74
"49620",NA,NA,"York-Hanover, PA","Metropolitan Statistical Area",2008,424583,4198,1955,5433,3478,2069,277,1792,174
"49620",NA,42133,"York County, PA","County or equivalent",2008,424583,4198,1955,5433,3478,2069,277,1792,174
"49660",NA,NA,"Youngstown-Warren-Boardman, OH-PA","Metropolitan Statistical Area",2008,565947,-4570,-296,6375,6671,-4267,189,-4456,-7
"49660",NA,39099,"Mahoning County, OH","County or equivalent",2008,237978,-2219,-228,2662,2890,-1912,119,-2031,-79
"49660",NA,39155,"Trumbull County, OH","County or equivalent",2008,211317,-2068,60,2452,2392,-2164,43,-2207,36
"49660",NA,42085,"Mercer County, PA","County or equivalent",2008,116652,-283,-128,1261,1389,-191,27,-218,36
"49700",NA,NA,"Yuba City, CA","Metropolitan Statistical Area",2008,165274,1972,1882,3117,1235,63,607,-544,27
"49700",NA,6101,"Sutter County, CA","County or equivalent",2008,92207,655,878,1612,734,-267,409,-676,44
"49700",NA,6115,"Yuba County, CA","County or equivalent",2008,73067,1317,1004,1505,501,330,198,132,-17
"49740",NA,NA,"Yuma, AZ","Metropolitan Statistical Area",2008,194322,4712,2262,3553,1291,2358,857,1501,92
"49740",NA,4027,"Yuma County, AZ","County or equivalent",2008,194322,4712,2262,3553,1291,2358,857,1501,92
" ",NA,NA,"","",2008,NA,NA,NA,NA,NA,NA,NA,NA,NA
" ",NA,NA,"Micropolitan Statistical Area","",2008,NA,NA,NA,NA,NA,NA,NA,NA,NA
" ",NA,NA,"","",2008,NA,NA,NA,NA,NA,NA,NA,NA,NA
"10020",NA,NA,"Abbeville, LA","Micropolitan Statistical Area",2008,56096,428,249,808,559,193,43,150,-14
"10020",NA,22113,"Vermilion Parish, LA","County or equivalent",2008,56096,428,249,808,559,193,43,150,-14
"10100",NA,NA,"Aberdeen, SD","Micropolitan Statistical Area",2008,39188,64,180,554,374,-136,8,-144,20
"10100",NA,46013,"Brown County, SD","County or equivalent",2008,35154,26,173,513,340,-164,8,-172,17
"10100",NA,46045,"Edmunds County, SD","County or equivalent",2008,4034,38,7,41,34,28,0,28,3
"10140",NA,NA,"Aberdeen, WA","Micropolitan Statistical Area",2008,71342,161,167,927,760,-50,70,-120,44
"10140",NA,53027,"Grays Harbor County, WA","County or equivalent",2008,71342,161,167,927,760,-50,70,-120,44
"10220",NA,NA,"Ada, OK","Micropolitan Statistical Area",2008,36999,487,172,562,390,300,14,286,15
"10220",NA,40123,"Pontotoc County, OK","County or equivalent",2008,36999,487,172,562,390,300,14,286,15
"10300",NA,NA,"Adrian, MI","Micropolitan Statistical Area",2008,100801,-544,414,1269,855,-1030,34,-1064,72
"10300",NA,26091,"Lenawee County, MI","County or equivalent",2008,100801,-544,414,1269,855,-1030,34,-1064,72
"10460",NA,NA,"Alamogordo, NM","Micropolitan Statistical Area",2008,62776,8,337,859,522,-301,306,-607,-28
"10460",NA,35035,"Otero County, NM","County or equivalent",2008,62776,8,337,859,522,-301,306,-607,-28
"10540",NA,NA,"Albany-Lebanon, OR","Micropolitan Statistical Area",2008,115348,2295,519,1583,1064,1834,77,1757,-58
"10540",NA,41043,"Linn County, OR","County or equivalent",2008,115348,2295,519,1583,1064,1834,77,1757,-58
"10620",NA,NA,"Albemarle, NC","Micropolitan Statistical Area",2008,59614,461,194,771,577,246,63,183,21
"10620",NA,37167,"Stanly County, NC","County or equivalent",2008,59614,461,194,771,577,246,63,183,21
"10660",NA,NA,"Albert Lea, MN","Micropolitan Statistical Area",2008,30927,-235,36,396,360,-273,25,-298,2
"10660",NA,27047,"Freeborn County, MN","County or equivalent",2008,30927,-235,36,396,360,-273,25,-298,2
"10700",NA,NA,"Albertville, AL","Micropolitan Statistical Area",2008,88484,1057,494,1456,962,508,191,317,55
"10700",NA,1095,"Marshall County, AL","County or equivalent",2008,88484,1057,494,1456,962,508,191,317,55
"10760",NA,NA,"Alexander City, AL","Micropolitan Statistical Area",2008,51587,-3,-88,584,672,99,3,96,-14
"10760",NA,1037,"Coosa County, AL","County or equivalent",2008,10814,-24,-19,105,124,-2,0,-2,-3
"10760",NA,1123,"Tallapoosa County, AL","County or equivalent",2008,40773,21,-69,479,548,101,3,98,-11
"10820",NA,NA,"Alexandria, MN","Micropolitan Statistical Area",2008,36258,253,99,472,373,156,2,154,-2
"10820",NA,27041,"Douglas County, MN","County or equivalent",2008,36258,253,99,472,373,156,2,154,-2
"10860",NA,NA,"Alice, TX","Micropolitan Statistical Area",2008,41069,-46,305,696,391,-362,11,-373,11
"10860",NA,48249,"Jim Wells County, TX","County or equivalent",2008,41069,-46,305,696,391,-362,11,-373,11
"10880",NA,NA,"Allegan, MI","Micropolitan Statistical Area",2008,112975,375,718,1541,823,-383,82,-465,40
"10880",NA,26005,"Allegan County, MI","County or equivalent",2008,112975,375,718,1541,823,-383,82,-465,40
"10940",NA,NA,"Alma, MI","Micropolitan Statistical Area",2008,42245,-43,98,515,417,-162,10,-172,21
"10940",NA,26057,"Gratiot County, MI","County or equivalent",2008,42245,-43,98,515,417,-162,10,-172,21
"10980",NA,NA,"Alpena, MI","Micropolitan Statistical Area",2008,29520,-182,-38,297,335,-130,9,-139,-14
"10980",NA,26007,"Alpena County, MI","County or equivalent",2008,29520,-182,-38,297,335,-130,9,-139,-14
"11060",NA,NA,"Altus, OK","Micropolitan Statistical Area",2008,25236,-450,221,446,225,-635,40,-675,-36
"11060",NA,40065,"Jackson County, OK","County or equivalent",2008,25236,-450,221,446,225,-635,40,-675,-36
"11140",NA,NA,"Americus, GA","Micropolitan Statistical Area",2008,36704,-15,188,565,377,-189,28,-217,-14
"11140",NA,13249,"Schley County, GA","County or equivalent",2008,4255,149,43,62,19,107,3,104,-1
"11140",NA,13261,"Sumter County, GA","County or equivalent",2008,32449,-164,145,503,358,-296,25,-321,-13
"11220",NA,NA,"Amsterdam, NY","Micropolitan Statistical Area",2008,48679,29,42,637,595,-45,39,-84,32
"11220",NA,36057,"Montgomery County, NY","County or equivalent",2008,48679,29,42,637,595,-45,39,-84,32
"11380",NA,NA,"Andrews, TX","Micropolitan Statistical Area",2008,13645,525,131,241,110,410,11,399,-16
"11380",NA,48003,"Andrews County, TX","County or equivalent",2008,13645,525,131,241,110,410,11,399,-16
"11420",NA,NA,"Angola, IN","Micropolitan Statistical Area",2008,33368,2,145,416,271,-130,17,-147,-13
"11420",NA,18151,"Steuben County, IN","County or equivalent",2008,33368,2,145,416,271,-130,17,-147,-13
"11580",NA,NA,"Arcadia, FL","Micropolitan Statistical Area",2008,33991,-288,221,485,264,-397,299,-696,-112
"11580",NA,12027,"DeSoto County, FL","County or equivalent",2008,33991,-288,221,485,264,-397,299,-696,-112
"11620",NA,NA,"Ardmore, OK","Micropolitan Statistical Area",2008,57134,554,176,826,650,357,28,329,21
"11620",NA,40019,"Carter County, OK","County or equivalent",2008,47979,495,151,703,552,325,22,303,19
"11620",NA,40085,"Love County, OK","County or equivalent",2008,9155,59,25,123,98,32,6,26,2
"11660",NA,NA,"Arkadelphia, AR","Micropolitan Statistical Area",2008,23888,92,86,307,221,23,24,-1,-17
"11660",NA,5019,"Clark County, AR","County or equivalent",2008,23888,92,86,307,221,23,24,-1,-17
"11740",NA,NA,"Ashland, OH","Micropolitan Statistical Area",2008,55125,282,225,725,500,34,10,24,23
"11740",NA,39005,"Ashland County, OH","County or equivalent",2008,55125,282,225,725,500,34,10,24,23
"11780",NA,NA,"Ashtabula, OH","Micropolitan Statistical Area",2008,100648,-503,277,1318,1041,-802,50,-852,22
"11780",NA,39007,"Ashtabula County, OH","County or equivalent",2008,100648,-503,277,1318,1041,-802,50,-852,22
"11820",NA,NA,"Astoria, OR","Micropolitan Statistical Area",2008,37404,99,64,427,363,15,55,-40,20
"11820",NA,41007,"Clatsop County, OR","County or equivalent",2008,37404,99,64,427,363,15,55,-40,20
"11860",NA,NA,"Atchison, KS","Micropolitan Statistical Area",2008,16481,-48,62,232,170,-108,5,-113,-2
"11860",NA,20005,"Atchison County, KS","County or equivalent",2008,16481,-48,62,232,170,-108,5,-113,-2
"11900",NA,NA,"Athens, OH","Micropolitan Statistical Area",2008,63255,55,157,625,468,-128,132,-260,26
"11900",NA,39009,"Athens County, OH","County or equivalent",2008,63255,55,157,625,468,-128,132,-260,26
"11940",NA,NA,"Athens, TN","Micropolitan Statistical Area",2008,52511,460,47,622,575,402,29,373,11
"11940",NA,47107,"McMinn County, TN","County or equivalent",2008,52511,460,47,622,575,402,29,373,11
"11980",NA,NA,"Athens, TX","Micropolitan Statistical Area",2008,78814,101,97,970,873,41,76,-35,-37
"11980",NA,48213,"Henderson County, TX","County or equivalent",2008,78814,101,97,970,873,41,76,-35,-37
"12140",NA,NA,"Auburn, IN","Micropolitan Statistical Area",2008,41884,151,223,573,350,-93,15,-108,21
"12140",NA,18033,"DeKalb County, IN","County or equivalent",2008,41884,151,223,573,350,-93,15,-108,21
"12180",NA,NA,"Auburn, NY","Micropolitan Statistical Area",2008,79823,-201,121,859,738,-338,19,-357,16
"12180",NA,36011,"Cayuga County, NY","County or equivalent",2008,79823,-201,121,859,738,-338,19,-357,16
"12300",NA,NA,"Augusta-Waterville, ME","Micropolitan Statistical Area",2008,120959,273,166,1300,1134,81,34,47,26
"12300",NA,23011,"Kennebec County, ME","County or equivalent",2008,120959,273,166,1300,1134,81,34,47,26
"12380",NA,NA,"Austin, MN","Micropolitan Statistical Area",2008,37859,-93,157,543,386,-247,70,-317,-3
"12380",NA,27099,"Mower County, MN","County or equivalent",2008,37859,-93,157,543,386,-247,70,-317,-3
"12460",NA,NA,"Bainbridge, GA","Micropolitan Statistical Area",2008,28823,291,103,406,303,178,38,140,10
"12460",NA,13087,"Decatur County, GA","County or equivalent",2008,28823,291,103,406,303,178,38,140,10
"12660",NA,NA,"Baraboo, WI","Micropolitan Statistical Area",2008,59013,614,286,821,535,290,16,274,38
"12660",NA,55111,"Sauk County, WI","County or equivalent",2008,59013,614,286,821,535,290,16,274,38
"12740",NA,NA,"Barre, VT","Micropolitan Statistical Area",2008,58829,-23,132,632,500,-175,53,-228,20
"12740",NA,50023,"Washington County, VT","County or equivalent",2008,58829,-23,132,632,500,-175,53,-228,20
"12780",NA,NA,"Bartlesville, OK","Micropolitan Statistical Area",2008,50452,682,115,671,556,544,59,485,23
"12780",NA,40147,"Washington County, OK","County or equivalent",2008,50452,682,115,671,556,544,59,485,23
"12820",NA,NA,"Bastrop, LA","Micropolitan Statistical Area",2008,28602,-158,-10,380,390,-155,1,-156,7
"12820",NA,22067,"Morehouse Parish, LA","County or equivalent",2008,28602,-158,-10,380,390,-155,1,-156,7
"12860",NA,NA,"Batavia, NY","Micropolitan Statistical Area",2008,57821,-312,94,655,561,-435,22,-457,29
"12860",NA,36037,"Genesee County, NY","County or equivalent",2008,57821,-312,94,655,561,-435,22,-457,29
"12900",NA,NA,"Batesville, AR","Micropolitan Statistical Area",2008,34641,94,117,494,377,-43,17,-60,20
"12900",NA,5063,"Independence County, AR","County or equivalent",2008,34641,94,117,494,377,-43,17,-60,20
"13060",NA,NA,"Bay City, TX","Micropolitan Statistical Area",2008,37265,405,181,546,365,205,122,83,19
"13060",NA,48321,"Matagorda County, TX","County or equivalent",2008,37265,405,181,546,365,205,122,83,19
"13100",NA,NA,"Beatrice, NE","Micropolitan Statistical Area",2008,23035,-126,20,283,263,-153,2,-155,7
"13100",NA,31067,"Gage County, NE","County or equivalent",2008,23035,-126,20,283,263,-153,2,-155,7
"13180",NA,NA,"Beaver Dam, WI","Micropolitan Statistical Area",2008,87912,183,148,990,842,-13,26,-39,48
"13180",NA,55027,"Dodge County, WI","County or equivalent",2008,87912,183,148,990,842,-13,26,-39,48
"13220",NA,NA,"Beckley, WV","Micropolitan Statistical Area",2008,79357,290,-41,898,939,305,29,276,26
"13220",NA,54081,"Raleigh County, WV","County or equivalent",2008,79357,290,-41,898,939,305,29,276,26
"13260",NA,NA,"Bedford, IN","Micropolitan Statistical Area",2008,45913,-72,57,538,481,-150,10,-160,21
"13260",NA,18093,"Lawrence County, IN","County or equivalent",2008,45913,-72,57,538,481,-150,10,-160,21
"13300",NA,NA,"Beeville, TX","Micropolitan Statistical Area",2008,32661,7,150,387,237,-156,6,-162,13
"13300",NA,48025,"Bee County, TX","County or equivalent",2008,32661,7,150,387,237,-156,6,-162,13
"13340",NA,NA,"Bellefontaine, OH","Micropolitan Statistical Area",2008,46220,-62,186,637,451,-238,19,-257,-10
"13340",NA,39091,"Logan County, OH","County or equivalent",2008,46220,-62,186,637,451,-238,19,-257,-10
"13420",NA,NA,"Bemidji, MN","Micropolitan Statistical Area",2008,43835,406,362,700,338,56,9,47,-12
"13420",NA,27007,"Beltrami County, MN","County or equivalent",2008,43835,406,362,700,338,56,9,47,-12
"13500",NA,NA,"Bennettsville, SC","Micropolitan Statistical Area",2008,28704,-271,-6,335,341,-281,2,-283,16
"13500",NA,45069,"Marlboro County, SC","County or equivalent",2008,28704,-271,-6,335,341,-281,2,-283,16
"13540",NA,NA,"Bennington, VT","Micropolitan Statistical Area",2008,36382,-26,-21,373,394,-26,21,-47,21
"13540",NA,50003,"Bennington County, VT","County or equivalent",2008,36382,-26,-21,373,394,-26,21,-47,21
"13620",NA,NA,"Berlin, NH-VT","Micropolitan Statistical Area",2008,38471,-366,-121,351,472,-265,9,-274,20
"13620",NA,33007,"Coos County, NH","County or equivalent",2008,31971,-374,-103,295,398,-295,9,-304,24
"13620",NA,50009,"Essex County, VT","County or equivalent",2008,6500,8,-18,56,74,30,0,30,-4
"13660",NA,NA,"Big Rapids, MI","Micropolitan Statistical Area",2008,41562,-166,128,469,341,-270,33,-303,-24
"13660",NA,26107,"Mecosta County, MI","County or equivalent",2008,41562,-166,128,469,341,-270,33,-303,-24
"13700",NA,NA,"Big Spring, TX","Micropolitan Statistical Area",2008,32537,292,128,484,356,170,16,154,-6
"13700",NA,48227,"Howard County, TX","County or equivalent",2008,32537,292,128,484,356,170,16,154,-6
"13860",NA,NA,"Bishop, CA","Micropolitan Statistical Area",2008,17136,-258,55,232,177,-253,22,-275,-60
"13860",NA,6027,"Inyo County, CA","County or equivalent",2008,17136,-258,55,232,177,-253,22,-275,-60
"13940",NA,NA,"Blackfoot, ID","Micropolitan Statistical Area",2008,43903,544,538,814,276,10,57,-47,-4
"13940",NA,16011,"Bingham County, ID","County or equivalent",2008,43903,544,538,814,276,10,57,-47,-4
"14100",NA,NA,"Bloomsburg-Berwick, PA","Micropolitan Statistical Area",2008,82709,110,-69,862,931,155,24,131,24
"14100",NA,42037,"Columbia County, PA","County or equivalent",2008,65004,186,-44,653,697,208,20,188,22
"14100",NA,42093,"Montour County, PA","County or equivalent",2008,17705,-76,-25,209,234,-53,4,-57,2
"14140",NA,NA,"Bluefield, WV-VA","Micropolitan Statistical Area",2008,105287,274,-124,1192,1316,394,19,375,4
"14140",NA,51185,"Tazewell County, VA","County or equivalent",2008,43787,35,-52,484,536,97,9,88,-10
"14140",NA,54055,"Mercer County, WV","County or equivalent",2008,61500,239,-72,708,780,297,10,287,14
"14180",NA,NA,"Blytheville, AR","Micropolitan Statistical Area",2008,46808,161,240,776,536,-54,15,-69,-25
"14180",NA,5093,"Mississippi County, AR","County or equivalent",2008,46808,161,240,776,536,-54,15,-69,-25
"14220",NA,NA,"Bogalusa, LA","Micropolitan Statistical Area",2008,45430,435,105,665,560,305,3,302,25
"14220",NA,22117,"Washington Parish, LA","County or equivalent",2008,45430,435,105,665,560,305,3,302,25
"14300",NA,NA,"Bonham, TX","Micropolitan Statistical Area",2008,33229,299,20,418,398,281,19,262,-2
"14300",NA,48147,"Fannin County, TX","County or equivalent",2008,33229,299,20,418,398,281,19,262,-2
"14340",NA,NA,"Boone, IA","Micropolitan Statistical Area",2008,26349,-6,47,324,277,-68,5,-73,15
"14340",NA,19015,"Boone County, IA","County or equivalent",2008,26349,-6,47,324,277,-68,5,-73,15
"14380",NA,NA,"Boone, NC","Micropolitan Statistical Area",2008,45196,723,126,418,292,602,40,562,-5
"14380",NA,37189,"Watauga County, NC","County or equivalent",2008,45196,723,126,418,292,602,40,562,-5
"14420",NA,NA,"Borger, TX","Micropolitan Statistical Area",2008,21512,-224,89,310,221,-281,37,-318,-32
"14420",NA,48233,"Hutchinson County, TX","County or equivalent",2008,21512,-224,89,310,221,-281,37,-318,-32
"14580",NA,NA,"Bozeman, MT","Micropolitan Statistical Area",2008,89824,2581,882,1300,418,1706,67,1639,-7
"14580",NA,30031,"Gallatin County, MT","County or equivalent",2008,89824,2581,882,1300,418,1706,67,1639,-7
"14620",NA,NA,"Bradford, PA","Micropolitan Statistical Area",2008,43537,-201,-28,477,505,-177,4,-181,4
"14620",NA,42083,"McKean County, PA","County or equivalent",2008,43537,-201,-28,477,505,-177,4,-181,4
"14660",NA,NA,"Brainerd, MN","Micropolitan Statistical Area",2008,90904,757,375,1226,851,397,9,388,-15
"14660",NA,27021,"Cass County, MN","County or equivalent",2008,28732,89,102,384,282,42,-1,43,-55
"14660",NA,27035,"Crow Wing County, MN","County or equivalent",2008,62172,668,273,842,569,355,10,345,40
"14700",NA,NA,"Branson, MO","Micropolitan Statistical Area",2008,78574,1406,222,1005,783,1201,30,1171,-17
"14700",NA,29209,"Stone County, MO","County or equivalent",2008,31551,60,-28,315,343,140,5,135,-52
"14700",NA,29213,"Taney County, MO","County or equivalent",2008,47023,1346,250,690,440,1061,25,1036,35
"14780",NA,NA,"Brenham, TX","Micropolitan Statistical Area",2008,32244,308,94,450,356,237,54,183,-23
"14780",NA,48477,"Washington County, TX","County or equivalent",2008,32244,308,94,450,356,237,54,183,-23
"14820",NA,NA,"Brevard, NC","Micropolitan Statistical Area",2008,30187,234,-86,307,393,306,25,281,14
"14820",NA,37175,"Transylvania County, NC","County or equivalent",2008,30187,234,-86,307,393,306,25,281,14
"14940",NA,NA,"Brigham City, UT","Micropolitan Statistical Area",2008,49015,1222,646,954,308,589,40,549,-13
"14940",NA,49003,"Box Elder County, UT","County or equivalent",2008,49015,1222,646,954,308,589,40,549,-13
"15020",NA,NA,"Brookhaven, MS","Micropolitan Statistical Area",2008,34931,382,154,535,381,241,5,236,-13
"15020",NA,28085,"Lincoln County, MS","County or equivalent",2008,34931,382,154,535,381,241,5,236,-13
"15060",NA,NA,"Brookings, OR","Micropolitan Statistical Area",2008,21523,-228,-175,157,332,-56,9,-65,3
"15060",NA,41015,"Curry County, OR","County or equivalent",2008,21523,-228,-175,157,332,-56,9,-65,3
"15100",NA,NA,"Brookings, SD","Micropolitan Statistical Area",2008,29668,339,197,370,173,150,32,118,-8
"15100",NA,46011,"Brookings County, SD","County or equivalent",2008,29668,339,197,370,173,150,32,118,-8
"15140",NA,NA,"Brownsville, TN","Micropolitan Statistical Area",2008,19024,-105,36,263,227,-148,16,-164,7
"15140",NA,47075,"Haywood County, TN","County or equivalent",2008,19024,-105,36,263,227,-148,16,-164,7
"15220",NA,NA,"Brownwood, TX","Micropolitan Statistical Area",2008,38379,118,42,499,457,71,19,52,5
"15220",NA,48049,"Brown County, TX","County or equivalent",2008,38379,118,42,499,457,71,19,52,5
"15340",NA,NA,"Bucyrus, OH","Micropolitan Statistical Area",2008,43696,-408,24,529,505,-406,2,-408,-26
"15340",NA,39033,"Crawford County, OH","County or equivalent",2008,43696,-408,24,529,505,-406,2,-408,-26
"15420",NA,NA,"Burley, ID","Micropolitan Statistical Area",2008,39993,569,385,730,345,196,100,96,-12
"15420",NA,16031,"Cassia County, ID","County or equivalent",2008,21348,433,222,400,178,217,41,176,-6
"15420",NA,16067,"Minidoka County, ID","County or equivalent",2008,18645,136,163,330,167,-21,59,-80,-6
"15460",NA,NA,"Burlington, IA-IL","Micropolitan Statistical Area",2008,48106,-42,135,611,476,-190,24,-214,13
"15460",NA,17071,"Henderson County, IL","County or equivalent",2008,7477,-84,-17,64,81,-70,0,-70,3
"15460",NA,19057,"Des Moines County, IA","County or equivalent",2008,40629,42,152,547,395,-120,24,-144,10
"15580",NA,NA,"Butte-Silver Bow, MT","Micropolitan Statistical Area",2008,32803,201,15,402,387,164,8,156,22
"15580",NA,30093,"Silver Bow County, MT","County or equivalent",2008,32803,201,15,402,387,164,8,156,22
"15620",NA,NA,"Cadillac, MI","Micropolitan Statistical Area",2008,46674,-45,158,602,444,-184,6,-190,-19
"15620",NA,26113,"Missaukee County, MI","County or equivalent",2008,15001,21,25,170,145,2,-1,3,-6
"15620",NA,26165,"Wexford County, MI","County or equivalent",2008,31673,-66,133,432,299,-186,7,-193,-13
"15660",NA,NA,"Calhoun, GA","Micropolitan Statistical Area",2008,52800,980,471,891,420,510,159,351,-1
"15660",NA,13129,"Gordon County, GA","County or equivalent",2008,52800,980,471,891,420,510,159,351,-1
"15700",NA,NA,"Cambridge, MD","Micropolitan Statistical Area",2008,31998,153,-17,394,411,162,10,152,8
"15700",NA,24019,"Dorchester County, MD","County or equivalent",2008,31998,153,-17,394,411,162,10,152,8
"15740",NA,NA,"Cambridge, OH","Micropolitan Statistical Area",2008,40177,-198,84,519,435,-263,3,-266,-19
"15740",NA,39059,"Guernsey County, OH","County or equivalent",2008,40177,-198,84,519,435,-263,3,-266,-19
"15780",NA,NA,"Camden, AR","Micropolitan Statistical Area",2008,31205,-363,7,417,410,-388,11,-399,18
"15780",NA,5013,"Calhoun County, AR","County or equivalent",2008,5435,-87,12,62,50,-99,5,-104,0
"15780",NA,5103,"Ouachita County, AR","County or equivalent",2008,25770,-276,-5,355,360,-289,6,-295,18
"15820",NA,NA,"Campbellsville, KY","Micropolitan Statistical Area",2008,24069,160,37,291,254,112,5,107,11
"15820",NA,21217,"Taylor County, KY","County or equivalent",2008,24069,160,37,291,254,112,5,107,11
"15860",NA,NA,"Canon City, CO","Micropolitan Statistical Area",2008,47283,-48,-31,448,479,-39,16,-55,22
"15860",NA,8043,"Fremont County, CO","County or equivalent",2008,47283,-48,-31,448,479,-39,16,-55,22
"15900",NA,NA,"Canton, IL","Micropolitan Statistical Area",2008,36719,-92,-40,412,452,-65,2,-67,13
"15900",NA,17057,"Fulton County, IL","County or equivalent",2008,36719,-92,-40,412,452,-65,2,-67,13
"16020",NA,NA,"Cape Girardeau-Jackson, MO-IL","Micropolitan Statistical Area",2008,93385,379,332,1256,924,76,39,37,-29
"16020",NA,17003,"Alexander County, IL","County or equivalent",2008,8152,-98,4,117,113,-101,0,-101,-1
"16020",NA,29017,"Bollinger County, MO","County or equivalent",2008,11990,-124,38,158,120,-140,2,-142,-22
"16020",NA,29031,"Cape Girardeau County, MO","County or equivalent",2008,73243,601,290,981,691,317,37,280,-6
"16060",NA,NA,"Carbondale, IL","Micropolitan Statistical Area",2008,58264,31,301,733,432,-299,209,-508,29
"16060",NA,17077,"Jackson County, IL","County or equivalent",2008,58264,31,301,733,432,-299,209,-508,29
"16100",NA,NA,"Carlsbad-Artesia, NM","Micropolitan Statistical Area",2008,51360,400,217,754,537,202,35,167,-19
"16100",NA,35015,"Eddy County, NM","County or equivalent",2008,51360,400,217,754,537,202,35,167,-19
"16260",NA,NA,"Cedar City, UT","Micropolitan Statistical Area",2008,44540,1087,815,1077,262,306,48,258,-34
"16260",NA,49021,"Iron County, UT","County or equivalent",2008,44540,1087,815,1077,262,306,48,258,-34
"16340",NA,NA,"Cedartown, GA","Micropolitan Statistical Area",2008,42018,636,279,731,452,336,108,228,21
"16340",NA,13233,"Polk County, GA","County or equivalent",2008,42018,636,279,731,452,336,108,228,21
"16380",NA,NA,"Celina, OH","Micropolitan Statistical Area",2008,40818,19,204,584,380,-212,8,-220,27
"16380",NA,39107,"Mercer County, OH","County or equivalent",2008,40818,19,204,584,380,-212,8,-220,27
"16420",NA,NA,"Central City, KY","Micropolitan Statistical Area",2008,31187,-126,-4,365,369,-130,2,-132,8
"16420",NA,21177,"Muhlenberg County, KY","County or equivalent",2008,31187,-126,-4,365,369,-130,2,-132,8
"16460",NA,NA,"Centralia, IL","Micropolitan Statistical Area",2008,39505,-84,3,496,493,-105,1,-106,18
"16460",NA,17121,"Marion County, IL","County or equivalent",2008,39505,-84,3,496,493,-105,1,-106,18
"16500",NA,NA,"Centralia, WA","Micropolitan Statistical Area",2008,74132,619,171,975,804,447,90,357,1
"16500",NA,53041,"Lewis County, WA","County or equivalent",2008,74132,619,171,975,804,447,90,357,1
"16540",NA,NA,"Chambersburg, PA","Micropolitan Statistical Area",2008,143495,1852,494,1872,1378,1336,103,1233,22
"16540",NA,42055,"Franklin County, PA","County or equivalent",2008,143495,1852,494,1872,1378,1336,103,1233,22
"16660",NA,NA,"Charleston-Mattoon, IL","Micropolitan Statistical Area",2008,63018,-92,104,718,614,-206,28,-234,10
"16660",NA,17029,"Coles County, IL","County or equivalent",2008,52172,-111,104,587,483,-222,27,-249,7
"16660",NA,17035,"Cumberland County, IL","County or equivalent",2008,10846,19,0,131,131,16,1,15,3
"16900",NA,NA,"Chester, SC","Micropolitan Statistical Area",2008,32618,44,39,408,369,17,9,8,-12
"16900",NA,45023,"Chester County, SC","County or equivalent",2008,32618,44,39,408,369,17,9,8,-12
"17060",NA,NA,"Chillicothe, OH","Micropolitan Statistical Area",2008,76073,274,197,952,755,42,17,25,35
"17060",NA,39141,"Ross County, OH","County or equivalent",2008,76073,274,197,952,755,42,17,25,35
"17180",NA,NA,"City of The Dalles, OR","Micropolitan Statistical Area",2008,23775,70,41,303,262,19,24,-5,10
"17180",NA,41065,"Wasco County, OR","County or equivalent",2008,23775,70,41,303,262,19,24,-5,10
"17200",NA,NA,"Claremont, NH","Micropolitan Statistical Area",2008,42591,15,85,492,407,-36,14,-50,-34
"17200",NA,33019,"Sullivan County, NH","County or equivalent",2008,42591,15,85,492,407,-36,14,-50,-34
"17220",NA,NA,"Clarksburg, WV","Micropolitan Statistical Area",2008,92212,615,-12,1084,1096,598,21,577,29
"17220",NA,54017,"Doddridge County, WV","County or equivalent",2008,7201,-43,-15,72,87,-30,-1,-29,2
"17220",NA,54033,"Harrison County, WV","County or equivalent",2008,68853,599,20,851,831,556,22,534,23
"17220",NA,54091,"Taylor County, WV","County or equivalent",2008,16158,59,-17,161,178,72,0,72,4
"17260",NA,NA,"Clarksdale, MS","Micropolitan Statistical Area",2008,27272,-370,200,527,327,-579,9,-588,9
"17260",NA,28027,"Coahoma County, MS","County or equivalent",2008,27272,-370,200,527,327,-579,9,-588,9
"17340",NA,NA,"Clearlake, CA","Micropolitan Statistical Area",2008,64866,368,72,792,720,323,82,241,-27
"17340",NA,6033,"Lake County, CA","County or equivalent",2008,64866,368,72,792,720,323,82,241,-27
"17380",NA,NA,"Cleveland, MS","Micropolitan Statistical Area",2008,37195,-298,229,628,399,-541,5,-546,14
"17380",NA,28011,"Bolivar County, MS","County or equivalent",2008,37195,-298,229,628,399,-541,5,-546,14
"17500",NA,NA,"Clewiston, FL","Micropolitan Statistical Area",2008,39453,207,432,742,310,-236,309,-545,11
"17500",NA,12051,"Hendry County, FL","County or equivalent",2008,39453,207,432,742,310,-236,309,-545,11
"17540",NA,NA,"Clinton, IA","Micropolitan Statistical Area",2008,48942,-114,109,614,505,-221,27,-248,-2
"17540",NA,19045,"Clinton County, IA","County or equivalent",2008,48942,-114,109,614,505,-221,27,-248,-2
"17580",NA,NA,"Clovis, NM","Micropolitan Statistical Area",2008,43755,-1252,501,871,370,-1784,81,-1865,31
"17580",NA,35009,"Curry County, NM","County or equivalent",2008,43755,-1252,501,871,370,-1784,81,-1865,31
"17700",NA,NA,"Coffeyville, KS","Micropolitan Statistical Area",2008,34395,-65,110,531,421,-202,18,-220,27
"17700",NA,20125,"Montgomery County, KS","County or equivalent",2008,34395,-65,110,531,421,-202,18,-220,27
"17740",NA,NA,"Coldwater, MI","Micropolitan Statistical Area",2008,45726,-441,215,638,423,-617,54,-671,-39
"17740",NA,26023,"Branch County, MI","County or equivalent",2008,45726,-441,215,638,423,-617,54,-671,-39
"17940",NA,NA,"Columbia, TN","Micropolitan Statistical Area",2008,81938,2145,388,1151,763,1785,86,1699,-28
"17940",NA,47119,"Maury County, TN","County or equivalent",2008,81938,2145,388,1151,763,1785,86,1699,-28
"18060",NA,NA,"Columbus, MS","Micropolitan Statistical Area",2008,59284,-182,377,927,550,-581,24,-605,22
"18060",NA,28087,"Lowndes County, MS","County or equivalent",2008,59284,-182,377,927,550,-581,24,-605,22
"18100",NA,NA,"Columbus, NE","Micropolitan Statistical Area",2008,32072,272,181,479,298,183,47,136,-92
"18100",NA,31141,"Platte County, NE","County or equivalent",2008,32072,272,181,479,298,183,47,136,-92
"18180",NA,NA,"Concord, NH","Micropolitan Statistical Area",2008,148161,88,374,1581,1207,-350,123,-473,64
"18180",NA,33013,"Merrimack County, NH","County or equivalent",2008,148161,88,374,1581,1207,-350,123,-473,64
"18220",NA,NA,"Connersville, IN","Micropolitan Statistical Area",2008,24265,15,27,314,287,-19,1,-20,7
"18220",NA,18041,"Fayette County, IN","County or equivalent",2008,24265,15,27,314,287,-19,1,-20,7
"18260",NA,NA,"Cookeville, TN","Micropolitan Statistical Area",2008,102982,1481,210,1354,1144,1322,122,1200,-51
"18260",NA,47087,"Jackson County, TN","County or equivalent",2008,10847,58,-41,101,142,113,3,110,-14
"18260",NA,47133,"Overton County, TN","County or equivalent",2008,20975,21,-21,270,291,26,1,25,16
"18260",NA,47141,"Putnam County, TN","County or equivalent",2008,71160,1402,272,983,711,1183,118,1065,-53
"18300",NA,NA,"Coos Bay, OR","Micropolitan Statistical Area",2008,63453,6,-140,671,811,95,33,62,51
"18300",NA,41011,"Coos County, OR","County or equivalent",2008,63453,6,-140,671,811,95,33,62,51
"18340",NA,NA,"Corbin, KY","Micropolitan Statistical Area",2008,38668,344,22,488,466,352,5,347,-30
"18340",NA,21235,"Whitley County, KY","County or equivalent",2008,38668,344,22,488,466,352,5,347,-30
"18380",NA,NA,"Cordele, GA","Micropolitan Statistical Area",2008,22162,35,85,340,255,-59,27,-86,9
"18380",NA,13081,"Crisp County, GA","County or equivalent",2008,22162,35,85,340,255,-59,27,-86,9
"18420",NA,NA,"Corinth, MS","Micropolitan Statistical Area",2008,35673,97,88,490,402,-9,12,-21,18
"18420",NA,28003,"Alcorn County, MS","County or equivalent",2008,35673,97,88,490,402,-9,12,-21,18
"18460",NA,NA,"Cornelia, GA","Micropolitan Statistical Area",2008,43056,927,302,684,382,633,104,529,-8
"18460",NA,13137,"Habersham County, GA","County or equivalent",2008,43056,927,302,684,382,633,104,529,-8
"18500",NA,NA,"Corning, NY","Micropolitan Statistical Area",2008,96573,-47,186,1167,981,-252,36,-288,19
"18500",NA,36101,"Steuben County, NY","County or equivalent",2008,96573,-47,186,1167,981,-252,36,-288,19
"18620",NA,NA,"Corsicana, TX","Micropolitan Statistical Area",2008,49456,397,221,711,490,201,187,14,-25
"18620",NA,48349,"Navarro County, TX","County or equivalent",2008,49456,397,221,711,490,201,187,14,-25
"18660",NA,NA,"Cortland, NY","Micropolitan Statistical Area",2008,48302,-113,146,575,429,-260,27,-287,1
"18660",NA,36023,"Cortland County, NY","County or equivalent",2008,48302,-113,146,575,429,-260,27,-287,1
"18740",NA,NA,"Coshocton, OH","Micropolitan Statistical Area",2008,35981,-276,72,466,394,-351,20,-371,3
"18740",NA,39031,"Coshocton County, OH","County or equivalent",2008,35981,-276,72,466,394,-351,20,-371,3
"18820",NA,NA,"Crawfordsville, IN","Micropolitan Statistical Area",2008,37805,54,130,493,363,-100,36,-136,24
"18820",NA,18107,"Montgomery County, IN","County or equivalent",2008,37805,54,130,493,363,-100,36,-136,24
"18860",NA,NA,"Crescent City, CA","Micropolitan Statistical Area",2008,29100,167,73,349,276,103,48,55,-9
"18860",NA,6015,"Del Norte County, CA","County or equivalent",2008,29100,167,73,349,276,103,48,55,-9
"18900",NA,NA,"Crossville, TN","Micropolitan Statistical Area",2008,53590,658,-96,576,672,711,9,702,43
"18900",NA,47035,"Cumberland County, TN","County or equivalent",2008,53590,658,-96,576,672,711,9,702,43
"18940",NA,NA,"Crowley, LA","Micropolitan Statistical Area",2008,60070,267,361,1001,640,-97,7,-104,3
"18940",NA,22001,"Acadia Parish, LA","County or equivalent",2008,60070,267,361,1001,640,-97,7,-104,3
"18980",NA,NA,"Cullman, AL","Micropolitan Statistical Area",2008,81324,917,105,1010,905,766,65,701,46
"18980",NA,1043,"Cullman County, AL","County or equivalent",2008,81324,917,105,1010,905,766,65,701,46
"19020",NA,NA,"Culpeper, VA","Micropolitan Statistical Area",2008,46203,609,356,695,339,273,50,223,-20
"19020",NA,51047,"Culpeper County, VA","County or equivalent",2008,46203,609,356,695,339,273,50,223,-20
"19220",NA,NA,"Danville, KY","Micropolitan Statistical Area",2008,54005,137,104,662,558,33,41,-8,0
"19220",NA,21021,"Boyle County, KY","County or equivalent",2008,28933,272,24,326,302,264,33,231,-16
"19220",NA,21137,"Lincoln County, KY","County or equivalent",2008,25072,-135,80,336,256,-231,8,-239,16
"19300",NA,NA,"Daphne-Fairhope-Foley, AL","Micropolitan Statistical Area",2008,174439,2691,595,2267,1672,2174,119,2055,-78
"19300",NA,1003,"Baldwin County, AL","County or equivalent",2008,174439,2691,595,2267,1672,2174,119,2055,-78
"19540",NA,NA,"Decatur, IN","Micropolitan Statistical Area",2008,33985,223,358,659,301,-126,8,-134,-9
"19540",NA,18001,"Adams County, IN","County or equivalent",2008,33985,223,358,659,301,-126,8,-134,-9
"19580",NA,NA,"Defiance, OH","Micropolitan Statistical Area",2008,38637,24,180,531,351,-163,12,-175,7
"19580",NA,39039,"Defiance County, OH","County or equivalent",2008,38637,24,180,531,351,-163,12,-175,7
"19620",NA,NA,"Del Rio, TX","Micropolitan Statistical Area",2008,48053,316,615,978,363,-334,175,-509,35
"19620",NA,48465,"Val Verde County, TX","County or equivalent",2008,48053,316,615,978,363,-334,175,-509,35
"19700",NA,NA,"Deming, NM","Micropolitan Statistical Area",2008,27227,422,155,451,296,263,119,144,4
"19700",NA,35029,"Luna County, NM","County or equivalent",2008,27227,422,155,451,296,263,119,144,4
"19760",NA,NA,"De Ridder, LA","Micropolitan Statistical Area",2008,34978,205,156,472,316,83,6,77,-34
"19760",NA,22011,"Beauregard Parish, LA","County or equivalent",2008,34978,205,156,472,316,83,6,77,-34
"19860",NA,NA,"Dickinson, ND","Micropolitan Statistical Area",2008,23386,162,112,324,212,47,11,36,3
"19860",NA,38007,"Billings County, ND","County or equivalent",2008,811,15,6,8,2,10,0,10,-1
"19860",NA,38089,"Stark County, ND","County or equivalent",2008,22575,147,106,316,210,37,11,26,4
"19900",NA,NA,"Dillon, SC","Micropolitan Statistical Area",2008,30698,30,126,474,348,-115,13,-128,19
"19900",NA,45033,"Dillon County, SC","County or equivalent",2008,30698,30,126,474,348,-115,13,-128,19
"19940",NA,NA,"Dixon, IL","Micropolitan Statistical Area",2008,35129,40,68,413,345,-32,12,-44,4
"19940",NA,17103,"Lee County, IL","County or equivalent",2008,35129,40,68,413,345,-32,12,-44,4
"19980",NA,NA,"Dodge City, KS","Micropolitan Statistical Area",2008,33293,216,447,661,214,-237,324,-561,6
"19980",NA,20057,"Ford County, KS","County or equivalent",2008,33293,216,447,661,214,-237,324,-561,6
"20060",NA,NA,"Douglas, GA","Micropolitan Statistical Area",2008,48708,390,375,809,434,4,139,-135,11
"20060",NA,13003,"Atkinson County, GA","County or equivalent",2008,8181,25,113,177,64,-84,35,-119,-4
"20060",NA,13069,"Coffee County, GA","County or equivalent",2008,40527,365,262,632,370,88,104,-16,15
"20140",NA,NA,"Dublin, GA","Micropolitan Statistical Area",2008,57398,513,245,829,584,245,27,218,23
"20140",NA,13167,"Johnson County, GA","County or equivalent",2008,9550,35,27,115,88,13,1,12,-5
"20140",NA,13175,"Laurens County, GA","County or equivalent",2008,47848,478,218,714,496,232,26,206,28
"20180",NA,NA,"DuBois, PA","Micropolitan Statistical Area",2008,82896,-109,-127,797,924,-26,7,-33,44
"20180",NA,42033,"Clearfield County, PA","County or equivalent",2008,82896,-109,-127,797,924,-26,7,-33,44
"20300",NA,NA,"Dumas, TX","Micropolitan Statistical Area",2008,20308,398,313,428,115,103,107,-4,-18
"20300",NA,48341,"Moore County, TX","County or equivalent",2008,20308,398,313,428,115,103,107,-4,-18
"20340",NA,NA,"Duncan, OK","Micropolitan Statistical Area",2008,43498,243,72,606,534,154,3,151,17
"20340",NA,40137,"Stephens County, OK","County or equivalent",2008,43498,243,72,606,534,154,3,151,17
"20380",NA,NA,"Dunn, NC","Micropolitan Statistical Area",2008,112030,3488,866,1631,765,2581,221,2360,41
"20380",NA,37085,"Harnett County, NC","County or equivalent",2008,112030,3488,866,1631,765,2581,221,2360,41
"20420",NA,NA,"Durango, CO","Micropolitan Statistical Area",2008,50482,962,362,626,264,623,28,595,-23
"20420",NA,8067,"La Plata County, CO","County or equivalent",2008,50482,962,362,626,264,623,28,595,-23
"20460",NA,NA,"Durant, OK","Micropolitan Statistical Area",2008,40109,811,171,598,427,617,38,579,23
"20460",NA,40013,"Bryan County, OK","County or equivalent",2008,40109,811,171,598,427,617,38,579,23
"20540",NA,NA,"Dyersburg, TN","Micropolitan Statistical Area",2008,37600,-42,87,497,410,-143,25,-168,14
"20540",NA,47045,"Dyer County, TN","County or equivalent",2008,37600,-42,87,497,410,-143,25,-168,14
"20580",NA,NA,"Eagle Pass, TX","Micropolitan Statistical Area",2008,52279,937,804,1109,305,116,230,-114,17
"20580",NA,48323,"Maverick County, TX","County or equivalent",2008,52279,937,804,1109,305,116,230,-114,17
"20620",NA,NA,"East Liverpool-Salem, OH","Micropolitan Statistical Area",2008,107873,-714,37,1223,1186,-802,13,-815,51
"20620",NA,39029,"Columbiana County, OH","County or equivalent",2008,107873,-714,37,1223,1186,-802,13,-815,51
"20660",NA,NA,"Easton, MD","Micropolitan Statistical Area",2008,36215,83,-23,424,447,104,29,75,2
"20660",NA,24041,"Talbot County, MD","County or equivalent",2008,36215,83,-23,424,447,104,29,75,2
"20700",NA,NA,"East Stroudsburg, PA","Micropolitan Statistical Area",2008,165058,591,461,1712,1251,177,106,71,-47
"20700",NA,42089,"Monroe County, PA","County or equivalent",2008,165058,591,461,1712,1251,177,106,71,-47
"20780",NA,NA,"Edwards, CO","Micropolitan Statistical Area",2008,60325,1593,872,1001,129,788,524,264,-67
"20780",NA,8037,"Eagle County, CO","County or equivalent",2008,52331,1440,767,878,111,721,450,271,-48
"20780",NA,8065,"Lake County, CO","County or equivalent",2008,7994,153,105,123,18,67,74,-7,-19
"20820",NA,NA,"Effingham, IL","Micropolitan Statistical Area",2008,34275,101,150,485,335,-56,13,-69,7
"20820",NA,17049,"Effingham County, IL","County or equivalent",2008,34275,101,150,485,335,-56,13,-69,7
"20900",NA,NA,"El Campo, TX","Micropolitan Statistical Area",2008,40791,60,263,682,419,-196,95,-291,-7
"20900",NA,48481,"Wharton County, TX","County or equivalent",2008,40791,60,263,682,419,-196,95,-291,-7
"20980",NA,NA,"El Dorado, AR","Micropolitan Statistical Area",2008,43213,48,41,576,535,-8,26,-34,15
"20980",NA,5139,"Union County, AR","County or equivalent",2008,43213,48,41,576,535,-8,26,-34,15
"21020",NA,NA,"Elizabeth City, NC","Micropolitan Statistical Area",2008,63649,1016,309,883,574,713,32,681,-6
"21020",NA,37029,"Camden County, NC","County or equivalent",2008,9682,221,45,120,75,172,1,171,4
"21020",NA,37139,"Pasquotank County, NC","County or equivalent",2008,41111,431,252,612,360,187,29,158,-8
"21020",NA,37143,"Perquimans County, NC","County or equivalent",2008,12856,364,12,151,139,354,2,352,-2
"21120",NA,NA,"Elk City, OK","Micropolitan Statistical Area",2008,21136,343,123,350,227,230,6,224,-10
"21120",NA,40009,"Beckham County, OK","County or equivalent",2008,21136,343,123,350,227,230,6,224,-10
"21220",NA,NA,"Elko, NV","Micropolitan Statistical Area",2008,48699,289,515,782,267,-195,115,-310,-31
"21220",NA,32007,"Elko County, NV","County or equivalent",2008,47071,224,498,763,265,-246,111,-357,-28
"21220",NA,32011,"Eureka County, NV","County or equivalent",2008,1628,65,17,19,2,51,4,47,-3
"21260",NA,NA,"Ellensburg, WA","Micropolitan Statistical Area",2008,38951,788,187,435,248,591,51,540,10
"21260",NA,53037,"Kittitas County, WA","County or equivalent",2008,38951,788,187,435,248,591,51,540,10
"21380",NA,NA,"Emporia, KS","Micropolitan Statistical Area",2008,38366,-330,299,597,298,-609,145,-754,-20
"21380",NA,20017,"Chase County, KS","County or equivalent",2008,2804,-46,4,29,25,-41,0,-41,-9
"21380",NA,20111,"Lyon County, KS","County or equivalent",2008,35562,-284,295,568,273,-568,145,-713,-11
"21420",NA,NA,"Enid, OK","Micropolitan Statistical Area",2008,58167,663,282,951,669,381,42,339,0
"21420",NA,40047,"Garfield County, OK","County or equivalent",2008,58167,663,282,951,669,381,42,339,0
"21460",NA,NA,"Enterprise-Ozark, AL","Micropolitan Statistical Area",2008,96045,1146,410,1359,949,740,54,686,-4
"21460",NA,1031,"Coffee County, AL","County or equivalent",2008,47753,1000,157,642,485,837,36,801,6
"21460",NA,1045,"Dale County, AL","County or equivalent",2008,48292,146,253,717,464,-97,18,-115,-10
"21540",NA,NA,"Escanaba, MI","Micropolitan Statistical Area",2008,37179,-140,16,418,402,-164,5,-169,8
"21540",NA,26041,"Delta County, MI","County or equivalent",2008,37179,-140,16,418,402,-164,5,-169,8
"21580",NA,NA,"Espanola, NM","Micropolitan Statistical Area",2008,40692,-15,398,732,334,-431,58,-489,18
"21580",NA,35039,"Rio Arriba County, NM","County or equivalent",2008,40692,-15,398,732,334,-431,58,-489,18
"21640",NA,NA,"Eufaula, AL-GA","Micropolitan Statistical Area",2008,32012,-101,51,367,316,-144,30,-174,-8
"21640",NA,1005,"Barbour County, AL","County or equivalent",2008,29309,-151,30,329,299,-173,30,-203,-8
"21640",NA,13239,"Quitman County, GA","County or equivalent",2008,2703,50,21,38,17,29,0,29,0
"21700",NA,NA,"Eureka-Arcata-Fortuna, CA","Micropolitan Statistical Area",2008,129000,386,512,1665,1153,-199,102,-301,73
"21700",NA,6023,"Humboldt County, CA","County or equivalent",2008,129000,386,512,1665,1153,-199,102,-301,73
"21740",NA,NA,"Evanston, WY","Micropolitan Statistical Area",2008,20617,462,216,345,129,255,11,244,-9
"21740",NA,56041,"Uinta County, WY","County or equivalent",2008,20617,462,216,345,129,255,11,244,-9
"21860",NA,NA,"Fairmont, MN","Micropolitan Statistical Area",2008,20435,-7,-12,245,257,-3,3,-6,8
"21860",NA,27091,"Martin County, MN","County or equivalent",2008,20435,-7,-12,245,257,-3,3,-6,8
"21900",NA,NA,"Fairmont, WV","Micropolitan Statistical Area",2008,56496,-157,-47,655,702,-140,8,-148,30
"21900",NA,54049,"Marion County, WV","County or equivalent",2008,56496,-157,-47,655,702,-140,8,-148,30
"21980",NA,NA,"Fallon, NV","Micropolitan Statistical Area",2008,24896,112,141,370,229,-17,27,-44,-12
"21980",NA,32001,"Churchill County, NV","County or equivalent",2008,24896,112,141,370,229,-17,27,-44,-12
"22060",NA,NA,"Faribault-Northfield, MN","Micropolitan Statistical Area",2008,62390,637,403,845,442,204,114,90,30
"22060",NA,27131,"Rice County, MN","County or equivalent",2008,62390,637,403,845,442,204,114,90,30
"22100",NA,NA,"Farmington, MO","Micropolitan Statistical Area",2008,63214,452,175,846,671,258,15,243,19
"22100",NA,29187,"St. Francois County, MO","County or equivalent",2008,63214,452,175,846,671,258,15,243,19
"22260",NA,NA,"Fergus Falls, MN","Micropolitan Statistical Area",2008,56786,-83,-5,657,662,-120,38,-158,42
"22260",NA,27111,"Otter Tail County, MN","County or equivalent",2008,56786,-83,-5,657,662,-120,38,-158,42
"22280",NA,NA,"Fernley, NV","Micropolitan Statistical Area",2008,53022,659,286,771,485,410,40,370,-37
"22280",NA,32019,"Lyon County, NV","County or equivalent",2008,53022,659,286,771,485,410,40,370,-37
"22300",NA,NA,"Findlay, OH","Micropolitan Statistical Area",2008,74273,8,352,978,626,-390,65,-455,46
"22300",NA,39063,"Hancock County, OH","County or equivalent",2008,74273,8,352,978,626,-390,65,-455,46
"22340",NA,NA,"Fitzgerald, GA","Micropolitan Statistical Area",2008,27866,303,129,427,298,169,39,130,5
"22340",NA,13017,"Ben Hill County, GA","County or equivalent",2008,17635,-24,111,318,207,-139,24,-163,4
"22340",NA,13155,"Irwin County, GA","County or equivalent",2008,10231,327,18,109,91,308,15,293,1
"22580",NA,NA,"Forest City, NC","Micropolitan Statistical Area",2008,63424,496,5,781,776,465,22,443,26
"22580",NA,37161,"Rutherford County, NC","County or equivalent",2008,63424,496,5,781,776,465,22,443,26
"22620",NA,NA,"Forrest City, AR","Micropolitan Statistical Area",2008,26336,-541,95,382,287,-652,-1,-651,16
"22620",NA,5123,"St. Francis County, AR","County or equivalent",2008,26336,-541,95,382,287,-652,-1,-651,16
"22700",NA,NA,"Fort Dodge, IA","Micropolitan Statistical Area",2008,38517,-89,62,499,437,-179,21,-200,28
"22700",NA,19187,"Webster County, IA","County or equivalent",2008,38517,-89,62,499,437,-179,21,-200,28
"22780",NA,NA,"Fort Leonard Wood, MO","Micropolitan Statistical Area",2008,44546,246,441,707,266,-183,34,-217,-12
"22780",NA,29169,"Pulaski County, MO","County or equivalent",2008,44546,246,441,707,266,-183,34,-217,-12
"22800",NA,NA,"Fort Madison-Keokuk, IA-MO","Micropolitan Statistical Area",2008,42588,-330,38,506,468,-368,14,-382,0
"22800",NA,19111,"Lee County, IA","County or equivalent",2008,35408,-298,25,411,386,-321,14,-335,-2
"22800",NA,29045,"Clark County, MO","County or equivalent",2008,7180,-32,13,95,82,-47,0,-47,2
"22820",NA,NA,"Fort Morgan, CO","Micropolitan Statistical Area",2008,27804,47,204,429,225,-159,139,-298,2
"22820",NA,8087,"Morgan County, CO","County or equivalent",2008,27804,47,204,429,225,-159,139,-298,2
"22840",NA,NA,"Fort Payne, AL","Micropolitan Statistical Area",2008,68515,691,309,1003,694,345,132,213,37
"22840",NA,1049,"DeKalb County, AL","County or equivalent",2008,68515,691,309,1003,694,345,132,213,37
"22860",NA,NA,"Fort Polk South, LA","Micropolitan Statistical Area",2008,45639,-1888,534,853,319,-2455,64,-2519,33
"22860",NA,22115,"Vernon Parish, LA","County or equivalent",2008,45639,-1888,534,853,319,-2455,64,-2519,33
"22980",NA,NA,"Fort Valley, GA","Micropolitan Statistical Area",2008,26736,548,207,449,242,353,52,301,-12
"22980",NA,13225,"Peach County, GA","County or equivalent",2008,26736,548,207,449,242,353,52,301,-12
"23140",NA,NA,"Frankfort, IN","Micropolitan Statistical Area",2008,34069,307,195,514,319,97,128,-31,15
"23140",NA,18023,"Clinton County, IN","County or equivalent",2008,34069,307,195,514,319,97,128,-31,15
"23180",NA,NA,"Frankfort, KY","Micropolitan Statistical Area",2008,70191,532,215,879,664,299,55,244,18
"23180",NA,21005,"Anderson County, KY","County or equivalent",2008,21347,106,88,265,177,12,6,6,6
"23180",NA,21073,"Franklin County, KY","County or equivalent",2008,48844,426,127,614,487,287,49,238,12
"23240",NA,NA,"Fredericksburg, TX","Micropolitan Statistical Area",2008,23782,401,-35,278,313,432,27,405,4
"23240",NA,48171,"Gillespie County, TX","County or equivalent",2008,23782,401,-35,278,313,432,27,405,4
"23300",NA,NA,"Freeport, IL","Micropolitan Statistical Area",2008,46367,-214,56,567,511,-255,51,-306,-15
"23300",NA,17177,"Stephenson County, IL","County or equivalent",2008,46367,-214,56,567,511,-255,51,-306,-15
"23340",NA,NA,"Fremont, NE","Micropolitan Statistical Area",2008,35872,-39,150,539,389,-194,23,-217,5
"23340",NA,31053,"Dodge County, NE","County or equivalent",2008,35872,-39,150,539,389,-194,23,-217,5
"23380",NA,NA,"Fremont, OH","Micropolitan Statistical Area",2008,60637,-290,209,822,613,-534,10,-544,35
"23380",NA,39143,"Sandusky County, OH","County or equivalent",2008,60637,-290,209,822,613,-534,10,-544,35
"23500",NA,NA,"Gaffney, SC","Micropolitan Statistical Area",2008,54394,461,98,683,585,351,24,327,12
"23500",NA,45021,"Cherokee County, SC","County or equivalent",2008,54394,461,98,683,585,351,24,327,12
"23620",NA,NA,"Gainesville, TX","Micropolitan Statistical Area",2008,38407,48,216,569,353,-159,98,-257,-9
"23620",NA,48097,"Cooke County, TX","County or equivalent",2008,38407,48,216,569,353,-159,98,-257,-9
"23660",NA,NA,"Galesburg, IL","Micropolitan Statistical Area",2008,69398,-250,-56,798,854,-222,17,-239,28
"23660",NA,17095,"Knox County, IL","County or equivalent",2008,51857,-116,-77,581,658,-63,12,-75,24
"23660",NA,17187,"Warren County, IL","County or equivalent",2008,17541,-134,21,217,196,-159,5,-164,4
"23700",NA,NA,"Gallup, NM","Micropolitan Statistical Area",2008,70724,745,894,1387,493,-169,37,-206,20
"23700",NA,35031,"McKinley County, NM","County or equivalent",2008,70724,745,894,1387,493,-169,37,-206,20
"23780",NA,NA,"Garden City, KS","Micropolitan Statistical Area",2008,40998,216,604,769,165,-353,314,-667,-35
"23780",NA,20055,"Finney County, KS","County or equivalent",2008,40998,216,604,769,165,-353,314,-667,-35
"23820",NA,NA,"Gardnerville Ranchos, NV","Micropolitan Statistical Area",2008,45180,-125,49,434,385,-88,33,-121,-86
"23820",NA,32005,"Douglas County, NV","County or equivalent",2008,45180,-125,49,434,385,-88,33,-121,-86
"23860",NA,NA,"Georgetown, SC","Micropolitan Statistical Area",2008,60731,343,133,762,629,298,45,253,-88
"23860",NA,45043,"Georgetown County, SC","County or equivalent",2008,60731,343,133,762,629,298,45,253,-88
"23900",NA,NA,"Gettysburg, PA","Micropolitan Statistical Area",2008,101119,600,192,1133,941,381,101,280,27
"23900",NA,42001,"Adams County, PA","County or equivalent",2008,101119,600,192,1133,941,381,101,280,27
"23940",NA,NA,"Gillette, WY","Micropolitan Statistical Area",2008,41473,1040,523,722,199,511,12,499,6
"23940",NA,56005,"Campbell County, WY","County or equivalent",2008,41473,1040,523,722,199,511,12,499,6
"23980",NA,NA,"Glasgow, KY","Micropolitan Statistical Area",2008,51854,526,137,713,576,409,17,392,-20
"23980",NA,21009,"Barren County, KY","County or equivalent",2008,41566,476,132,579,447,360,17,343,-16
"23980",NA,21169,"Metcalfe County, KY","County or equivalent",2008,10288,50,5,134,129,49,0,49,-4
"24100",NA,NA,"Gloversville, NY","Micropolitan Statistical Area",2008,55024,65,27,598,571,12,26,-14,26
"24100",NA,36035,"Fulton County, NY","County or equivalent",2008,55024,65,27,598,571,12,26,-14,26
"24180",NA,NA,"Granbury, TX","Micropolitan Statistical Area",2008,58515,1738,78,703,625,1641,49,1592,19
"24180",NA,48221,"Hood County, TX","County or equivalent",2008,50573,1534,67,602,535,1439,44,1395,28
"24180",NA,48425,"Somervell County, TX","County or equivalent",2008,7942,204,11,101,90,202,5,197,-9
"24260",NA,NA,"Grand Island, NE","Micropolitan Statistical Area",2008,70694,1060,518,1144,626,533,190,343,9
"24260",NA,31079,"Hall County, NE","County or equivalent",2008,56401,1007,493,974,481,497,189,308,17
"24260",NA,31093,"Howard County, NE","County or equivalent",2008,6593,18,23,86,63,7,0,7,-12
"24260",NA,31121,"Merrick County, NE","County or equivalent",2008,7700,35,2,84,82,29,1,28,4
"24380",NA,NA,"Grants, NM","Micropolitan Statistical Area",2008,27285,55,209,444,235,-152,11,-163,-2
"24380",NA,35006,"Cibola County, NM","County or equivalent",2008,27285,55,209,444,235,-152,11,-163,-2
"24420",NA,NA,"Grants Pass, OR","Micropolitan Statistical Area",2008,81618,690,-153,869,1022,813,17,796,30
"24420",NA,41033,"Josephine County, OR","County or equivalent",2008,81618,690,-153,869,1022,813,17,796,30
"24460",NA,NA,"Great Bend, KS","Micropolitan Statistical Area",2008,27703,-62,114,398,284,-187,58,-245,11
"24460",NA,20009,"Barton County, KS","County or equivalent",2008,27703,-62,114,398,284,-187,58,-245,11
"24620",NA,NA,"Greeneville, TN","Micropolitan Statistical Area",2008,66157,311,-24,754,778,326,40,286,9
"24620",NA,47059,"Greene County, TN","County or equivalent",2008,66157,311,-24,754,778,326,40,286,9
"24700",NA,NA,"Greensburg, IN","Micropolitan Statistical Area",2008,24998,61,140,374,234,-44,28,-72,-35
"24700",NA,18031,"Decatur County, IN","County or equivalent",2008,24998,61,140,374,234,-44,28,-72,-35
"24740",NA,NA,"Greenville, MS","Micropolitan Statistical Area",2008,55079,-560,327,928,601,-911,19,-930,24
"24740",NA,28151,"Washington County, MS","County or equivalent",2008,55079,-560,327,928,601,-911,19,-930,24
"24820",NA,NA,"Greenville, OH","Micropolitan Statistical Area",2008,52027,-149,141,691,550,-328,1,-329,38
"24820",NA,39037,"Darke County, OH","County or equivalent",2008,52027,-149,141,691,550,-328,1,-329,38
"24900",NA,NA,"Greenwood, MS","Micropolitan Statistical Area",2008,45552,76,277,731,454,-209,15,-224,8
"24900",NA,28015,"Carroll County, MS","County or equivalent",2008,10367,64,45,134,89,29,3,26,-10
"24900",NA,28083,"Leflore County, MS","County or equivalent",2008,35185,12,232,597,365,-238,12,-250,18
"24940",NA,NA,"Greenwood, SC","Micropolitan Statistical Area",2008,68549,376,178,886,708,189,123,66,9
"24940",NA,45047,"Greenwood County, SC","County or equivalent",2008,68549,376,178,886,708,189,123,66,9
"24980",NA,NA,"Grenada, MS","Micropolitan Statistical Area",2008,22995,-50,55,344,289,-115,11,-126,10
"24980",NA,28043,"Grenada County, MS","County or equivalent",2008,22995,-50,55,344,289,-115,11,-126,10
"25100",NA,NA,"Guymon, OK","Micropolitan Statistical Area",2008,20283,393,289,406,117,131,173,-42,-27
"25100",NA,40139,"Texas County, OK","County or equivalent",2008,20283,393,289,406,117,131,173,-42,-27
"25220",NA,NA,"Hammond, LA","Micropolitan Statistical Area",2008,117001,1546,790,1893,1103,734,24,710,22
"25220",NA,22105,"Tangipahoa Parish, LA","County or equivalent",2008,117001,1546,790,1893,1103,734,24,710,22
"25300",NA,NA,"Hannibal, MO","Micropolitan Statistical Area",2008,38057,54,145,555,410,-109,4,-113,18
"25300",NA,29127,"Marion County, MO","County or equivalent",2008,28225,68,100,426,326,-41,3,-44,9
"25300",NA,29173,"Ralls County, MO","County or equivalent",2008,9832,-14,45,129,84,-68,1,-69,9
"25340",NA,NA,"Harriman, TN","Micropolitan Statistical Area",2008,53430,124,-83,538,621,180,16,164,27
"25340",NA,47145,"Roane County, TN","County or equivalent",2008,53430,124,-83,538,621,180,16,164,27
"25380",NA,NA,"Harrisburg, IL","Micropolitan Statistical Area",2008,25944,-105,-48,336,384,-65,7,-72,8
"25380",NA,17165,"Saline County, IL","County or equivalent",2008,25944,-105,-48,336,384,-65,7,-72,8
"25460",NA,NA,"Harrison, AR","Micropolitan Statistical Area",2008,45179,200,86,572,486,87,6,81,27
"25460",NA,5009,"Boone County, AR","County or equivalent",2008,36881,237,89,484,395,119,7,112,29
"25460",NA,5101,"Newton County, AR","County or equivalent",2008,8298,-37,-3,88,91,-32,-1,-31,-2
"25580",NA,NA,"Hastings, NE","Micropolitan Statistical Area",2008,39508,304,155,538,383,131,79,52,18
"25580",NA,31001,"Adams County, NE","County or equivalent",2008,33238,369,160,466,306,189,79,110,20
"25580",NA,31035,"Clay County, NE","County or equivalent",2008,6270,-65,-5,72,77,-58,0,-58,-2
"25660",NA,NA,"Havre, MT","Micropolitan Statistical Area",2008,16454,-82,151,281,130,-228,1,-229,-5
"25660",NA,30041,"Hill County, MT","County or equivalent",2008,16454,-82,151,281,130,-228,1,-229,-5
"25700",NA,NA,"Hays, KS","Micropolitan Statistical Area",2008,27801,380,143,394,251,249,27,222,-12
"25700",NA,20051,"Ellis County, KS","County or equivalent",2008,27801,380,143,394,251,249,27,222,-12
"25720",NA,NA,"Heber, UT","Micropolitan Statistical Area",2008,21066,624,343,443,100,319,29,290,-38
"25720",NA,49051,"Wasatch County, UT","County or equivalent",2008,21066,624,343,443,100,319,29,290,-38
"25740",NA,NA,"Helena, MT","Micropolitan Statistical Area",2008,72180,1161,267,846,579,861,24,837,33
"25740",NA,30043,"Jefferson County, MT","County or equivalent",2008,11255,165,22,102,80,140,1,139,3
"25740",NA,30049,"Lewis and Clark County, MT","County or equivalent",2008,60925,996,245,744,499,721,23,698,30
"25760",NA,NA,"Helena-West Helena, AR","Micropolitan Statistical Area",2008,21603,-397,97,378,281,-463,5,-468,-31
"25760",NA,5107,"Phillips County, AR","County or equivalent",2008,21603,-397,97,378,281,-463,5,-468,-31
"25780",NA,NA,"Henderson, NC","Micropolitan Statistical Area",2008,42891,-1,234,705,471,-258,87,-345,23
"25780",NA,37181,"Vance County, NC","County or equivalent",2008,42891,-1,234,705,471,-258,87,-345,23
"25820",NA,NA,"Hereford, TX","Micropolitan Statistical Area",2008,18501,107,234,379,145,-122,42,-164,-5
"25820",NA,48117,"Deaf Smith County, TX","County or equivalent",2008,18501,107,234,379,145,-122,42,-164,-5
"25900",NA,NA,"Hilo, HI","Micropolitan Statistical Area",2008,175784,3237,1323,2657,1334,1818,320,1498,96
"25900",NA,15001,"Hawaii County, HI","County or equivalent",2008,175784,3237,1323,2657,1334,1818,320,1498,96
"25940",NA,NA,"Hilton Head Island-Beaufort, SC","Micropolitan Statistical Area",2008,172745,4123,1225,2706,1481,2915,475,2440,-17
"25940",NA,45013,"Beaufort County, SC","County or equivalent",2008,150415,3693,1094,2369,1275,2610,398,2212,-11
"25940",NA,45053,"Jasper County, SC","County or equivalent",2008,22330,430,131,337,206,305,77,228,-6
"26020",NA,NA,"Hobbs, NM","Micropolitan Statistical Area",2008,59155,1163,582,1080,498,564,73,491,17
"26020",NA,35025,"Lea County, NM","County or equivalent",2008,59155,1163,582,1080,498,564,73,491,17
"26140",NA,NA,"Homosassa Springs, FL","Micropolitan Statistical Area",2008,141416,1472,-1097,1188,2285,2443,56,2387,126
"26140",NA,12017,"Citrus County, FL","County or equivalent",2008,141416,1472,-1097,1188,2285,2443,56,2387,126
"26220",NA,NA,"Hood River, OR","Micropolitan Statistical Area",2008,21536,336,170,316,146,155,82,73,11
"26220",NA,41027,"Hood River County, OR","County or equivalent",2008,21536,336,170,316,146,155,82,73,11
"26260",NA,NA,"Hope, AR","Micropolitan Statistical Area",2008,32057,-417,161,476,315,-585,93,-678,7
"26260",NA,5057,"Hempstead County, AR","County or equivalent",2008,22900,-243,131,344,213,-380,84,-464,6
"26260",NA,5099,"Nevada County, AR","County or equivalent",2008,9157,-174,30,132,102,-205,9,-214,1
"26340",NA,NA,"Houghton, MI","Micropolitan Statistical Area",2008,37376,236,90,451,361,144,40,104,2
"26340",NA,26061,"Houghton County, MI","County or equivalent",2008,35174,206,91,433,342,112,40,72,3
"26340",NA,26083,"Keweenaw County, MI","County or equivalent",2008,2202,30,-1,18,19,32,0,32,-1
"26460",NA,NA,"Hudson, NY","Micropolitan Statistical Area",2008,62006,-219,-16,628,644,-224,45,-269,21
"26460",NA,36021,"Columbia County, NY","County or equivalent",2008,62006,-219,-16,628,644,-224,45,-269,21
"26480",NA,NA,"Humboldt, TN","Micropolitan Statistical Area",2008,49257,746,-32,635,667,757,16,741,21
"26480",NA,47053,"Gibson County, TN","County or equivalent",2008,49257,746,-32,635,667,757,16,741,21
"26500",NA,NA,"Huntingdon, PA","Micropolitan Statistical Area",2008,45543,16,9,438,429,-2,-1,-1,9
"26500",NA,42061,"Huntingdon County, PA","County or equivalent",2008,45543,16,9,438,429,-2,-1,-1,9
"26540",NA,NA,"Huntington, IN","Micropolitan Statistical Area",2008,37570,-159,68,471,403,-241,8,-249,14
"26540",NA,18069,"Huntington County, IN","County or equivalent",2008,37570,-159,68,471,403,-241,8,-249,14
"26660",NA,NA,"Huntsville, TX","Micropolitan Statistical Area",2008,64212,282,225,654,429,40,82,-42,17
"26660",NA,48471,"Walker County, TX","County or equivalent",2008,64212,282,225,654,429,40,82,-42,17
"26700",NA,NA,"Huron, SD","Micropolitan Statistical Area",2008,15878,172,54,236,182,123,6,117,-5
"26700",NA,46005,"Beadle County, SD","County or equivalent",2008,15878,172,54,236,182,123,6,117,-5
"26740",NA,NA,"Hutchinson, KS","Micropolitan Statistical Area",2008,63427,337,193,852,659,97,35,62,47
"26740",NA,20155,"Reno County, KS","County or equivalent",2008,63427,337,193,852,659,97,35,62,47
"26780",NA,NA,"Hutchinson, MN","Micropolitan Statistical Area",2008,37165,58,270,561,291,-222,19,-241,10
"26780",NA,27085,"McLeod County, MN","County or equivalent",2008,37165,58,270,561,291,-222,19,-241,10
"26860",NA,NA,"Indiana, PA","Micropolitan Statistical Area",2008,87479,-91,-10,892,902,-121,38,-159,40
"26860",NA,42063,"Indiana County, PA","County or equivalent",2008,87479,-91,-10,892,902,-121,38,-159,40
"26940",NA,NA,"Indianola, MS","Micropolitan Statistical Area",2008,30697,-303,182,508,326,-485,12,-497,0
"26940",NA,28133,"Sunflower County, MS","County or equivalent",2008,30697,-303,182,508,326,-485,12,-497,0
"27020",NA,NA,"Iron Mountain, MI-WI","Micropolitan Statistical Area",2008,31464,-216,-25,321,346,-203,3,-206,12
"27020",NA,26043,"Dickinson County, MI","County or equivalent",2008,26812,-124,-22,286,308,-123,3,-126,21
"27020",NA,55037,"Florence County, WI","County or equivalent",2008,4652,-92,-3,35,38,-80,0,-80,-9
"27220",NA,NA,"Jackson, WY-ID","Micropolitan Statistical Area",2008,29209,957,352,454,102,615,99,516,-10
"27220",NA,16081,"Teton County, ID","County or equivalent",2008,8833,539,146,170,24,392,26,366,1
"27220",NA,56039,"Teton County, WY","County or equivalent",2008,20376,418,206,284,78,223,73,150,-11
"27300",NA,NA,"Jacksonville, IL","Micropolitan Statistical Area",2008,40432,-148,23,481,458,-188,11,-199,17
"27300",NA,17137,"Morgan County, IL","County or equivalent",2008,35251,-114,20,420,400,-151,10,-161,17
"27300",NA,17171,"Scott County, IL","County or equivalent",2008,5181,-34,3,61,58,-37,1,-38,0
"27380",NA,NA,"Jacksonville, TX","Micropolitan Statistical Area",2008,48321,265,292,768,476,-28,142,-170,1
"27380",NA,48073,"Cherokee County, TX","County or equivalent",2008,48321,265,292,768,476,-28,142,-170,1
"27420",NA,NA,"Jamestown, ND","Micropolitan Statistical Area",2008,20394,-63,27,232,205,-86,6,-92,-4
"27420",NA,38093,"Stutsman County, ND","County or equivalent",2008,20394,-63,27,232,205,-86,6,-92,-4
"27460",NA,NA,"Jamestown-Dunkirk-Fredonia, NY","Micropolitan Statistical Area",2008,133789,-164,177,1577,1400,-371,87,-458,30
"27460",NA,36013,"Chautauqua County, NY","County or equivalent",2008,133789,-164,177,1577,1400,-371,87,-458,30
"27540",NA,NA,"Jasper, IN","Micropolitan Statistical Area",2008,54018,265,213,724,511,55,38,17,-3
"27540",NA,18037,"Dubois County, IN","County or equivalent",2008,41449,285,210,571,361,67,38,29,8
"27540",NA,18125,"Pike County, IN","County or equivalent",2008,12569,-20,3,153,150,-12,0,-12,-11
"27660",NA,NA,"Jennings, LA","Micropolitan Statistical Area",2008,31263,127,123,463,340,-10,5,-15,14
"27660",NA,22053,"Jefferson Davis Parish, LA","County or equivalent",2008,31263,127,123,463,340,-10,5,-15,14
"27700",NA,NA,"Jesup, GA","Micropolitan Statistical Area",2008,29509,520,156,437,281,359,18,341,5
"27700",NA,13305,"Wayne County, GA","County or equivalent",2008,29509,520,156,437,281,359,18,341,5
"27940",NA,NA,"Juneau, AK","Micropolitan Statistical Area",2008,30988,458,274,392,118,197,35,162,-13
"27940",NA,2110,"Juneau City and Borough, AK","County or equivalent",2008,30988,458,274,392,118,197,35,162,-13
"27980",NA,NA,"Kahului-Wailuku, HI","Micropolitan Statistical Area",2008,143574,2169,1147,2119,972,994,418,576,28
"27980",NA,15009,"Maui County, HI","County or equivalent",2008,143574,2169,1147,2119,972,994,418,576,28
"28060",NA,NA,"Kalispell, MT","Micropolitan Statistical Area",2008,88473,1707,490,1228,738,1202,30,1172,15
"28060",NA,30029,"Flathead County, MT","County or equivalent",2008,88473,1707,490,1228,738,1202,30,1172,15
"28180",NA,NA,"Kapaa, HI","Micropolitan Statistical Area",2008,63689,928,439,885,446,466,100,366,23
"28180",NA,15007,"Kauai County, HI","County or equivalent",2008,63689,928,439,885,446,466,100,366,23
"28260",NA,NA,"Kearney, NE","Micropolitan Statistical Area",2008,51833,311,387,788,401,-60,24,-84,-16
"28260",NA,31019,"Buffalo County, NE","County or equivalent",2008,45354,415,380,712,332,55,25,30,-20
"28260",NA,31099,"Kearney County, NE","County or equivalent",2008,6479,-104,7,76,69,-115,-1,-114,4
"28300",NA,NA,"Keene, NH","Micropolitan Statistical Area",2008,77170,-134,112,773,661,-266,27,-293,20
"28300",NA,33005,"Cheshire County, NH","County or equivalent",2008,77170,-134,112,773,661,-266,27,-293,20
"28340",NA,NA,"Kendallville, IN","Micropolitan Statistical Area",2008,47601,150,306,697,391,-174,122,-296,18
"28340",NA,18113,"Noble County, IN","County or equivalent",2008,47601,150,306,697,391,-174,122,-296,18
"28380",NA,NA,"Kennett, MO","Micropolitan Statistical Area",2008,31454,-155,68,492,424,-236,13,-249,13
"28380",NA,29069,"Dunklin County, MO","County or equivalent",2008,31454,-155,68,492,424,-236,13,-249,13
"28500",NA,NA,"Kerrville, TX","Micropolitan Statistical Area",2008,48269,604,-59,612,671,715,61,654,-52
"28500",NA,48265,"Kerr County, TX","County or equivalent",2008,48269,604,-59,612,671,715,61,654,-52
"28540",NA,NA,"Ketchikan, AK","Micropolitan Statistical Area",2008,13142,-20,105,190,85,-123,14,-137,-2
"28540",NA,2130,"Ketchikan Gateway Borough, AK","County or equivalent",2008,13142,-20,105,190,85,-123,14,-137,-2
"28580",NA,NA,"Key West, FL","Micropolitan Statistical Area",2008,72243,-667,-41,610,651,-456,318,-774,-170
"28580",NA,12087,"Monroe County, FL","County or equivalent",2008,72243,-667,-41,610,651,-456,318,-774,-170
"28620",NA,NA,"Kill Devil Hills, NC","Micropolitan Statistical Area",2008,33584,-109,165,427,262,-192,28,-220,-82
"28620",NA,37055,"Dare County, NC","County or equivalent",2008,33584,-109,165,427,262,-192,28,-220,-82
"28780",NA,NA,"Kingsville, TX","Micropolitan Statistical Area",2008,31127,99,306,525,219,-177,49,-226,-30
"28780",NA,48261,"Kenedy County, TX","County or equivalent",2008,388,-6,3,4,1,-7,0,-7,-2
"28780",NA,48273,"Kleberg County, TX","County or equivalent",2008,30739,105,303,521,218,-170,49,-219,-28
"28820",NA,NA,"Kinston, NC","Micropolitan Statistical Area",2008,56826,141,99,792,693,26,67,-41,16
"28820",NA,37107,"Lenoir County, NC","County or equivalent",2008,56826,141,99,792,693,26,67,-41,16
"28860",NA,NA,"Kirksville, MO","Micropolitan Statistical Area",2008,29053,349,83,348,265,255,20,235,11
"28860",NA,29001,"Adair County, MO","County or equivalent",2008,24943,327,83,301,218,234,19,215,10
"28860",NA,29197,"Schuyler County, MO","County or equivalent",2008,4110,22,0,47,47,21,1,20,1
"28900",NA,NA,"Klamath Falls, OR","Micropolitan Statistical Area",2008,66425,17,199,863,664,-223,45,-268,41
"28900",NA,41035,"Klamath County, OR","County or equivalent",2008,66425,17,199,863,664,-223,45,-268,41
"28980",NA,NA,"Kodiak, AK","Micropolitan Statistical Area",2008,13049,68,194,211,17,-105,66,-171,-21
"28980",NA,2150,"Kodiak Island Borough, AK","County or equivalent",2008,13049,68,194,211,17,-105,66,-171,-21
"29060",NA,NA,"Laconia, NH","Micropolitan Statistical Area",2008,61281,216,9,613,604,180,38,142,27
"29060",NA,33001,"Belknap County, NH","County or equivalent",2008,61281,216,9,613,604,180,38,142,27
"29220",NA,NA,"La Follette, TN","Micropolitan Statistical Area",2008,40936,257,-2,496,498,249,22,227,10
"29220",NA,47013,"Campbell County, TN","County or equivalent",2008,40936,257,-2,496,498,249,22,227,10
"29260",NA,NA,"La Grande, OR","Micropolitan Statistical Area",2008,24961,224,116,342,226,92,23,69,16
"29260",NA,41061,"Union County, OR","County or equivalent",2008,24961,224,116,342,226,92,23,69,16
"29300",NA,NA,"LaGrange, GA","Micropolitan Statistical Area",2008,64233,851,369,1031,662,467,61,406,15
"29300",NA,13285,"Troup County, GA","County or equivalent",2008,64233,851,369,1031,662,467,61,406,15
"29380",NA,NA,"Lake City, FL","Micropolitan Statistical Area",2008,69092,1224,194,915,721,1089,30,1059,-59
"29380",NA,12023,"Columbia County, FL","County or equivalent",2008,69092,1224,194,915,721,1089,30,1059,-59
"29500",NA,NA,"Lamesa, TX","Micropolitan Statistical Area",2008,13692,-69,78,203,125,-142,17,-159,-5
"29500",NA,48115,"Dawson County, TX","County or equivalent",2008,13692,-69,78,203,125,-142,17,-159,-5
"29580",NA,NA,"Lancaster, SC","Micropolitan Statistical Area",2008,75913,2375,259,965,706,2079,50,2029,37
"29580",NA,45057,"Lancaster County, SC","County or equivalent",2008,75913,2375,259,965,706,2079,50,2029,37
"29660",NA,NA,"Laramie, WY","Micropolitan Statistical Area",2008,32758,470,257,424,167,236,54,182,-23
"29660",NA,56001,"Albany County, WY","County or equivalent",2008,32758,470,257,424,167,236,54,182,-23
"29780",NA,NA,"Las Vegas, NM","Micropolitan Statistical Area",2008,28558,-71,85,364,279,-164,6,-170,8
"29780",NA,35047,"San Miguel County, NM","County or equivalent",2008,28558,-71,85,364,279,-164,6,-170,8
"29860",NA,NA,"Laurel, MS","Micropolitan Statistical Area",2008,85451,699,542,1424,882,169,116,53,-12
"29860",NA,28061,"Jasper County, MS","County or equivalent",2008,18253,196,87,272,185,109,3,106,0
"29860",NA,28067,"Jones County, MS","County or equivalent",2008,67198,503,455,1152,697,60,113,-53,-12
"29900",NA,NA,"Laurinburg, NC","Micropolitan Statistical Area",2008,36508,167,182,534,352,-32,21,-53,17
"29900",NA,37165,"Scotland County, NC","County or equivalent",2008,36508,167,182,534,352,-32,21,-53,17
"29980",NA,NA,"Lawrenceburg, TN","Micropolitan Statistical Area",2008,40954,73,96,555,459,-28,9,-37,5
"29980",NA,47099,"Lawrence County, TN","County or equivalent",2008,40954,73,96,555,459,-28,9,-37,5
"30060",NA,NA,"Lebanon, MO","Micropolitan Statistical Area",2008,35524,178,161,536,375,-1,6,-7,18
"30060",NA,29105,"Laclede County, MO","County or equivalent",2008,35524,178,161,536,375,-1,6,-7,18
"30100",NA,NA,"Lebanon, NH-VT","Micropolitan Statistical Area",2008,171404,339,149,1671,1522,220,105,115,-30
"30100",NA,33009,"Grafton County, NH","County or equivalent",2008,85921,590,84,826,742,506,80,426,0
"30100",NA,50017,"Orange County, VT","County or equivalent",2008,28917,-39,57,294,237,-94,0,-94,-2
"30100",NA,50027,"Windsor County, VT","County or equivalent",2008,56566,-212,8,551,543,-192,25,-217,-28
"30220",NA,NA,"Levelland, TX","Micropolitan Statistical Area",2008,22205,19,175,367,192,-123,17,-140,-33
"30220",NA,48219,"Hockley County, TX","County or equivalent",2008,22205,19,175,367,192,-123,17,-140,-33
"30260",NA,NA,"Lewisburg, PA","Micropolitan Statistical Area",2008,43640,164,76,449,373,67,15,52,21
"30260",NA,42119,"Union County, PA","County or equivalent",2008,43640,164,76,449,373,67,15,52,21
"30280",NA,NA,"Lewisburg, TN","Micropolitan Statistical Area",2008,29731,589,136,397,261,441,26,415,12
"30280",NA,47117,"Marshall County, TN","County or equivalent",2008,29731,589,136,397,261,441,26,415,12
"30380",NA,NA,"Lewistown, PA","Micropolitan Statistical Area",2008,46062,8,92,631,539,-106,1,-107,22
"30380",NA,42087,"Mifflin County, PA","County or equivalent",2008,46062,8,92,631,539,-106,1,-107,22
"30420",NA,NA,"Lexington, NE","Micropolitan Statistical Area",2008,26591,60,256,466,210,-198,155,-353,2
"30420",NA,31047,"Dawson County, NE","County or equivalent",2008,24665,109,261,446,185,-155,155,-310,3
"30420",NA,31073,"Gosper County, NE","County or equivalent",2008,1926,-49,-5,20,25,-43,0,-43,-1
"30500",NA,NA,"Lexington Park, MD","Micropolitan Statistical Area",2008,101578,1316,925,1610,685,374,52,322,17
"30500",NA,24037,"St. Mary's County, MD","County or equivalent",2008,101578,1316,925,1610,685,374,52,322,17
"30580",NA,NA,"Liberal, KS","Micropolitan Statistical Area",2008,23016,127,421,533,112,-272,257,-529,-22
"30580",NA,20175,"Seward County, KS","County or equivalent",2008,23016,127,421,533,112,-272,257,-529,-22
"30660",NA,NA,"Lincoln, IL","Micropolitan Statistical Area",2008,29788,-29,37,348,311,-75,7,-82,9
"30660",NA,17107,"Logan County, IL","County or equivalent",2008,29788,-29,37,348,311,-75,7,-82,9
"30740",NA,NA,"Lincolnton, NC","Micropolitan Statistical Area",2008,74746,1978,352,956,604,1592,213,1379,34
"30740",NA,37109,"Lincoln County, NC","County or equivalent",2008,74746,1978,352,956,604,1592,213,1379,34
"30820",NA,NA,"Lock Haven, PA","Micropolitan Statistical Area",2008,37038,-72,43,446,403,-126,8,-134,11
"30820",NA,42035,"Clinton County, PA","County or equivalent",2008,37038,-72,43,446,403,-126,8,-134,11
"30900",NA,NA,"Logansport, IN","Micropolitan Statistical Area",2008,39123,83,143,534,391,-65,70,-135,5
"30900",NA,18017,"Cass County, IN","County or equivalent",2008,39123,83,143,534,391,-65,70,-135,5
"30940",NA,NA,"London, KY","Micropolitan Statistical Area",2008,57586,251,233,771,538,21,24,-3,-3
"30940",NA,21125,"Laurel County, KY","County or equivalent",2008,57586,251,233,771,538,21,24,-3,-3
"31060",NA,NA,"Los Alamos, NM","Micropolitan Statistical Area",2008,18150,-347,62,162,100,-399,51,-450,-10
"31060",NA,35028,"Los Alamos County, NM","County or equivalent",2008,18150,-347,62,162,100,-399,51,-450,-10
"31260",NA,NA,"Lufkin, TX","Micropolitan Statistical Area",2008,83038,468,582,1355,773,-161,126,-287,47
"31260",NA,48005,"Angelina County, TX","County or equivalent",2008,83038,468,582,1355,773,-161,126,-287,47
"31300",NA,NA,"Lumberton, NC","Micropolitan Statistical Area",2008,129123,1057,1041,2243,1202,18,352,-334,-2
"31300",NA,37155,"Robeson County, NC","County or equivalent",2008,129123,1057,1041,2243,1202,18,352,-334,-2
"31380",NA,NA,"Macomb, IL","Micropolitan Statistical Area",2008,32788,-229,29,305,276,-266,56,-322,8
"31380",NA,17109,"McDonough County, IL","County or equivalent",2008,32788,-229,29,305,276,-266,56,-322,8
"31500",NA,NA,"Madison, IN","Micropolitan Statistical Area",2008,32820,229,61,387,326,169,6,163,-1
"31500",NA,18077,"Jefferson County, IN","County or equivalent",2008,32820,229,61,387,326,169,6,163,-1
"31580",NA,NA,"Madisonville, KY","Micropolitan Statistical Area",2008,46338,91,32,585,553,33,11,22,26
"31580",NA,21107,"Hopkins County, KY","County or equivalent",2008,46338,91,32,585,553,33,11,22,26
"31620",NA,NA,"Magnolia, AR","Micropolitan Statistical Area",2008,24146,-215,59,319,260,-275,8,-283,1
"31620",NA,5027,"Columbia County, AR","County or equivalent",2008,24146,-215,59,319,260,-275,8,-283,1
"31660",NA,NA,"Malone, NY","Micropolitan Statistical Area",2008,50521,72,107,517,410,-42,8,-50,7
"31660",NA,36033,"Franklin County, NY","County or equivalent",2008,50521,72,107,517,410,-42,8,-50,7
"31740",NA,NA,"Manhattan, KS","Micropolitan Statistical Area",2008,121935,3702,1473,2089,616,2219,274,1945,10
"31740",NA,20061,"Geary County, KS","County or equivalent",2008,31171,1632,525,685,160,1102,61,1041,5
"31740",NA,20149,"Pottawatomie County, KS","County or equivalent",2008,19695,279,187,351,164,89,1,88,3
"31740",NA,20161,"Riley County, KS","County or equivalent",2008,71069,1791,761,1053,292,1028,212,816,2
"31820",NA,NA,"Manitowoc, WI","Micropolitan Statistical Area",2008,80641,-127,168,934,766,-319,61,-380,24
"31820",NA,55071,"Manitowoc County, WI","County or equivalent",2008,80641,-127,168,934,766,-319,61,-380,24
"31860",NA,NA,"Mankato-North Mankato, MN","Micropolitan Statistical Area",2008,92428,763,527,1186,659,237,89,148,-1
"31860",NA,27013,"Blue Earth County, MN","County or equivalent",2008,60401,491,342,783,441,129,61,68,20
"31860",NA,27103,"Nicollet County, MN","County or equivalent",2008,32027,272,185,403,218,108,28,80,-21
"31940",NA,NA,"Marinette, WI-MI","Micropolitan Statistical Area",2008,66490,-155,-16,722,738,-175,11,-186,36
"31940",NA,26109,"Menominee County, MI","County or equivalent",2008,24202,4,6,260,254,-5,5,-10,3
"31940",NA,55075,"Marinette County, WI","County or equivalent",2008,42288,-159,-22,462,484,-170,6,-176,33
"31980",NA,NA,"Marion, IN","Micropolitan Statistical Area",2008,68609,-178,8,790,782,-174,9,-183,-12
"31980",NA,18053,"Grant County, IN","County or equivalent",2008,68609,-178,8,790,782,-174,9,-183,-12
"32020",NA,NA,"Marion, OH","Micropolitan Statistical Area",2008,65768,232,187,818,631,32,10,22,13
"32020",NA,39101,"Marion County, OH","County or equivalent",2008,65768,232,187,818,631,32,10,22,13
"32060",NA,NA,"Marion-Herrin, IL","Micropolitan Statistical Area",2008,64628,459,119,838,719,326,14,312,14
"32060",NA,17199,"Williamson County, IL","County or equivalent",2008,64628,459,119,838,719,326,14,312,14
"32100",NA,NA,"Marquette, MI","Micropolitan Statistical Area",2008,65492,175,73,677,604,59,16,43,43
"32100",NA,26103,"Marquette County, MI","County or equivalent",2008,65492,175,73,677,604,59,16,43,43
"32140",NA,NA,"Marshall, MN","Micropolitan Statistical Area",2008,24844,160,108,334,226,48,34,14,4
"32140",NA,27083,"Lyon County, MN","County or equivalent",2008,24844,160,108,334,226,48,34,14,4
"32180",NA,NA,"Marshall, MO","Micropolitan Statistical Area",2008,22505,-109,77,312,235,-173,37,-210,-13
"32180",NA,29195,"Saline County, MO","County or equivalent",2008,22505,-109,77,312,235,-173,37,-210,-13
"32220",NA,NA,"Marshall, TX","Micropolitan Statistical Area",2008,63594,383,300,904,604,102,74,28,-19
"32220",NA,48203,"Harrison County, TX","County or equivalent",2008,63594,383,300,904,604,102,74,28,-19
"32260",NA,NA,"Marshalltown, IA","Micropolitan Statistical Area",2008,39523,309,202,627,425,122,102,20,-15
"32260",NA,19127,"Marshall County, IA","County or equivalent",2008,39523,309,202,627,425,122,102,20,-15
"32270",NA,NA,"Marshfield-Wisconsin Rapids, WI","Micropolitan Statistical Area",2008,73756,-40,183,888,705,-281,44,-325,58
"32270",NA,55141,"Wood County, WI","County or equivalent",2008,73756,-40,183,888,705,-281,44,-325,58
"32280",NA,NA,"Martin, TN","Micropolitan Statistical Area",2008,33375,201,7,363,356,192,40,152,2
"32280",NA,47183,"Weakley County, TN","County or equivalent",2008,33375,201,7,363,356,192,40,152,2
"32300",NA,NA,"Martinsville, VA","Micropolitan Statistical Area",2008,69859,-147,-113,790,903,-7,145,-152,-27
"32300",NA,51089,"Henry County, VA","County or equivalent",2008,55316,-145,-4,642,646,-129,114,-243,-12
"32300",NA,51690,"Martinsville city, VA","County or equivalent",2008,14543,-2,-109,148,257,122,31,91,-15
"32340",NA,NA,"Maryville, MO","Micropolitan Statistical Area",2008,22054,-5,64,250,186,-74,15,-89,5
"32340",NA,29147,"Nodaway County, MO","County or equivalent",2008,22054,-5,64,250,186,-74,15,-89,5
"32380",NA,NA,"Mason City, IA","Micropolitan Statistical Area",2008,51447,-214,20,597,577,-263,19,-282,29
"32380",NA,19033,"Cerro Gordo County, IA","County or equivalent",2008,43786,-218,35,519,484,-278,18,-296,25
"32380",NA,19195,"Worth County, IA","County or equivalent",2008,7661,4,-15,78,93,15,1,14,4
"32460",NA,NA,"Mayfield, KY","Micropolitan Statistical Area",2008,37487,3,36,472,436,-26,52,-78,-7
"32460",NA,21083,"Graves County, KY","County or equivalent",2008,37487,3,36,472,436,-26,52,-78,-7
"32500",NA,NA,"Maysville, KY","Micropolitan Statistical Area",2008,31221,126,47,389,342,90,12,78,-11
"32500",NA,21135,"Lewis County, KY","County or equivalent",2008,13807,-61,29,185,156,-84,1,-85,-6
"32500",NA,21161,"Mason County, KY","County or equivalent",2008,17414,187,18,204,186,174,11,163,-5
"32540",NA,NA,"McAlester, OK","Micropolitan Statistical Area",2008,45115,479,77,592,515,368,15,353,34
"32540",NA,40121,"Pittsburg County, OK","County or equivalent",2008,45115,479,77,592,515,368,15,353,34
"32620",NA,NA,"McComb, MS","Micropolitan Statistical Area",2008,53209,28,233,848,615,-177,3,-180,-28
"32620",NA,28005,"Amite County, MS","County or equivalent",2008,13248,-85,28,180,152,-87,1,-88,-26
"32620",NA,28113,"Pike County, MS","County or equivalent",2008,39961,113,205,668,463,-90,2,-92,-2
"32660",NA,NA,"McMinnville, TN","Micropolitan Statistical Area",2008,39842,196,101,534,433,71,89,-18,24
"32660",NA,47177,"Warren County, TN","County or equivalent",2008,39842,196,101,534,433,71,89,-18,24
"32700",NA,NA,"McPherson, KS","Micropolitan Statistical Area",2008,29044,-106,17,351,334,-109,5,-114,-14
"32700",NA,20113,"McPherson County, KS","County or equivalent",2008,29044,-106,17,351,334,-109,5,-114,-14
"32740",NA,NA,"Meadville, PA","Micropolitan Statistical Area",2008,88411,-324,126,1055,929,-479,3,-482,29
"32740",NA,42039,"Crawford County, PA","County or equivalent",2008,88411,-324,126,1055,929,-479,3,-482,29
"32860",NA,NA,"Menomonie, WI","Micropolitan Statistical Area",2008,42688,146,215,500,285,-87,25,-112,18
"32860",NA,55033,"Dunn County, WI","County or equivalent",2008,42688,146,215,500,285,-87,25,-112,18
"32940",NA,NA,"Meridian, MS","Micropolitan Statistical Area",2008,105525,172,435,1626,1191,-297,15,-312,34
"32940",NA,28023,"Clarke County, MS","County or equivalent",2008,17378,24,48,235,187,-13,1,-14,-11
"32940",NA,28069,"Kemper County, MS","County or equivalent",2008,9967,-115,44,135,91,-163,1,-164,4
"32940",NA,28075,"Lauderdale County, MS","County or equivalent",2008,78180,263,343,1256,913,-121,13,-134,41
"32980",NA,NA,"Merrill, WI","Micropolitan Statistical Area",2008,29499,-120,8,307,299,-130,13,-143,2
"32980",NA,55069,"Lincoln County, WI","County or equivalent",2008,29499,-120,8,307,299,-130,13,-143,2
"33020",NA,NA,"Mexico, MO","Micropolitan Statistical Area",2008,26049,220,106,398,292,111,0,111,3
"33020",NA,29007,"Audrain County, MO","County or equivalent",2008,26049,220,106,398,292,111,0,111,3
"33060",NA,NA,"Miami, OK","Micropolitan Statistical Area",2008,31849,-476,62,468,406,-552,21,-573,14
"33060",NA,40115,"Ottawa County, OK","County or equivalent",2008,31849,-476,62,468,406,-552,21,-573,14
"33180",NA,NA,"Middlesborough, KY","Micropolitan Statistical Area",2008,29055,62,-9,362,371,55,12,43,16
"33180",NA,21013,"Bell County, KY","County or equivalent",2008,29055,62,-9,362,371,55,12,43,16
"33220",NA,NA,"Midland, MI","Micropolitan Statistical Area",2008,82605,12,276,930,654,-263,103,-366,-1
"33220",NA,26111,"Midland County, MI","County or equivalent",2008,82605,12,276,930,654,-263,103,-366,-1
"33300",NA,NA,"Milledgeville, GA","Micropolitan Statistical Area",2008,56156,239,184,696,512,51,20,31,4
"33300",NA,13009,"Baldwin County, GA","County or equivalent",2008,46716,357,185,587,402,161,20,141,11
"33300",NA,13141,"Hancock County, GA","County or equivalent",2008,9440,-118,-1,109,110,-110,0,-110,-7
"33380",NA,NA,"Minden, LA","Micropolitan Statistical Area",2008,40754,-116,-4,542,546,-141,8,-149,29
"33380",NA,22119,"Webster Parish, LA","County or equivalent",2008,40754,-116,-4,542,546,-141,8,-149,29
"33420",NA,NA,"Mineral Wells, TX","Micropolitan Statistical Area",2008,27486,218,86,391,305,159,35,124,-27
"33420",NA,48363,"Palo Pinto County, TX","County or equivalent",2008,27486,218,86,391,305,159,35,124,-27
"33500",NA,NA,"Minot, ND","Micropolitan Statistical Area",2008,63399,-58,547,1073,526,-542,41,-583,-63
"33500",NA,38049,"McHenry County, ND","County or equivalent",2008,5168,-43,3,55,52,-26,1,-27,-20
"33500",NA,38075,"Renville County, ND","County or equivalent",2008,2245,-54,-6,14,20,-45,1,-46,-3
"33500",NA,38101,"Ward County, ND","County or equivalent",2008,55986,39,550,1004,454,-471,39,-510,-40
"33580",NA,NA,"Mitchell, SD","Micropolitan Statistical Area",2008,22540,-46,154,356,202,-203,9,-212,3
"33580",NA,46035,"Davison County, SD","County or equivalent",2008,18931,-56,116,307,191,-186,9,-195,14
"33580",NA,46061,"Hanson County, SD","County or equivalent",2008,3609,10,38,49,11,-17,0,-17,-11
"33620",NA,NA,"Moberly, MO","Micropolitan Statistical Area",2008,25723,88,108,366,258,-25,16,-41,5
"33620",NA,29175,"Randolph County, MO","County or equivalent",2008,25723,88,108,366,258,-25,16,-41,5
"33820",NA,NA,"Monroe, WI","Micropolitan Statistical Area",2008,36090,372,142,475,333,240,9,231,-10
"33820",NA,55045,"Green County, WI","County or equivalent",2008,36090,372,142,475,333,240,9,231,-10
"33940",NA,NA,"Montrose, CO","Micropolitan Statistical Area",2008,40539,1093,214,582,368,904,37,867,-25
"33940",NA,8085,"Montrose County, CO","County or equivalent",2008,40539,1093,214,582,368,904,37,867,-25
"33980",NA,NA,"Morehead City, NC","Micropolitan Statistical Area",2008,63195,41,27,680,653,105,33,72,-91
"33980",NA,37031,"Carteret County, NC","County or equivalent",2008,63195,41,27,680,653,105,33,72,-91
"34020",NA,NA,"Morgan City, LA","Micropolitan Statistical Area",2008,51083,-203,268,781,513,-462,28,-490,-9
"34020",NA,22101,"St. Mary Parish, LA","County or equivalent",2008,51083,-203,268,781,513,-462,28,-490,-9
"34140",NA,NA,"Moscow, ID","Micropolitan Statistical Area",2008,35906,158,201,425,224,-52,59,-111,9
"34140",NA,16057,"Latah County, ID","County or equivalent",2008,35906,158,201,425,224,-52,59,-111,9
"34180",NA,NA,"Moses Lake, WA","Micropolitan Statistical Area",2008,84697,2336,987,1565,578,1349,516,833,0
"34180",NA,53025,"Grant County, WA","County or equivalent",2008,84697,2336,987,1565,578,1349,516,833,0
"34220",NA,NA,"Moultrie, GA","Micropolitan Statistical Area",2008,45279,621,282,725,443,349,171,178,-10
"34220",NA,13071,"Colquitt County, GA","County or equivalent",2008,45279,621,282,725,443,349,171,178,-10
"34260",NA,NA,"Mountain Home, AR","Micropolitan Statistical Area",2008,42115,243,-251,425,676,513,0,513,-19
"34260",NA,5005,"Baxter County, AR","County or equivalent",2008,42115,243,-251,425,676,513,0,513,-19
"34300",NA,NA,"Mountain Home, ID","Micropolitan Statistical Area",2008,28997,133,363,507,144,-213,64,-277,-17
"34300",NA,16039,"Elmore County, ID","County or equivalent",2008,28997,133,363,507,144,-213,64,-277,-17
"34340",NA,NA,"Mount Airy, NC","Micropolitan Statistical Area",2008,72468,296,143,921,778,148,165,-17,5
"34340",NA,37171,"Surry County, NC","County or equivalent",2008,72468,296,143,921,778,148,165,-17,5
"34380",NA,NA,"Mount Pleasant, MI","Micropolitan Statistical Area",2008,66778,-12,400,808,408,-445,69,-514,33
"34380",NA,26073,"Isabella County, MI","County or equivalent",2008,66778,-12,400,808,408,-445,69,-514,33
"34420",NA,NA,"Mount Pleasant, TX","Micropolitan Statistical Area",2008,29793,582,337,564,227,232,173,59,13
"34420",NA,48449,"Titus County, TX","County or equivalent",2008,29793,582,337,564,227,232,173,59,13
"34460",NA,NA,"Mount Sterling, KY","Micropolitan Statistical Area",2008,44112,581,156,588,432,432,4,428,-7
"34460",NA,21011,"Bath County, KY","County or equivalent",2008,11750,176,20,153,133,160,1,159,-4
"34460",NA,21165,"Menifee County, KY","County or equivalent",2008,6744,-1,-3,74,77,0,1,-1,2
"34460",NA,21173,"Montgomery County, KY","County or equivalent",2008,25618,406,139,361,222,272,2,270,-5
"34500",NA,NA,"Mount Vernon, IL","Micropolitan Statistical Area",2008,48350,40,81,573,492,-72,9,-81,31
"34500",NA,17065,"Hamilton County, IL","County or equivalent",2008,8267,43,-15,84,99,51,0,51,7
"34500",NA,17081,"Jefferson County, IL","County or equivalent",2008,40083,-3,96,489,393,-123,9,-132,24
"34540",NA,NA,"Mount Vernon, OH","Micropolitan Statistical Area",2008,59324,434,193,782,589,210,5,205,31
"34540",NA,39083,"Knox County, OH","County or equivalent",2008,59324,434,193,782,589,210,5,205,31
"34660",NA,NA,"Murray, KY","Micropolitan Statistical Area",2008,36240,124,48,388,340,63,53,10,13
"34660",NA,21035,"Calloway County, KY","County or equivalent",2008,36240,124,48,388,340,63,53,10,13
"34700",NA,NA,"Muscatine, IA","Micropolitan Statistical Area",2008,54229,126,328,782,454,-185,76,-261,-17
"34700",NA,19115,"Louisa County, IA","County or equivalent",2008,11725,-43,43,156,113,-73,19,-92,-13
"34700",NA,19139,"Muscatine County, IA","County or equivalent",2008,42504,169,285,626,341,-112,57,-169,-4
"34780",NA,NA,"Muskogee, OK","Micropolitan Statistical Area",2008,71278,266,253,1081,828,17,55,-38,-4
"34780",NA,40101,"Muskogee County, OK","County or equivalent",2008,71278,266,253,1081,828,17,55,-38,-4
"34860",NA,NA,"Nacogdoches, TX","Micropolitan Statistical Area",2008,62768,547,513,1051,538,2,155,-153,32
"34860",NA,48347,"Nacogdoches County, TX","County or equivalent",2008,62768,547,513,1051,538,2,155,-153,32
"35020",NA,NA,"Natchez, MS-LA","Micropolitan Statistical Area",2008,50371,-348,86,703,617,-435,8,-443,1
"35020",NA,22029,"Concordia Parish, LA","County or equivalent",2008,19064,17,48,272,224,-29,2,-31,-2
"35020",NA,28001,"Adams County, MS","County or equivalent",2008,31307,-365,38,431,393,-406,6,-412,3
"35060",NA,NA,"Natchitoches, LA","Micropolitan Statistical Area",2008,39576,89,255,639,384,-188,22,-210,22
"35060",NA,22069,"Natchitoches Parish, LA","County or equivalent",2008,39576,89,255,639,384,-188,22,-210,22
"35100",NA,NA,"New Bern, NC","Micropolitan Statistical Area",2008,119507,614,650,1853,1203,-79,141,-220,43
"35100",NA,37049,"Craven County, NC","County or equivalent",2008,96892,590,722,1645,923,-160,128,-288,28
"35100",NA,37103,"Jones County, NC","County or equivalent",2008,10113,25,-19,97,116,37,8,29,7
"35100",NA,37137,"Pamlico County, NC","County or equivalent",2008,12502,-1,-53,111,164,44,5,39,8
"35140",NA,NA,"Newberry, SC","Micropolitan Statistical Area",2008,37823,224,87,516,429,129,87,42,8
"35140",NA,45071,"Newberry County, SC","County or equivalent",2008,37823,224,87,516,429,129,87,42,8
"35220",NA,NA,"New Castle, IN","Micropolitan Statistical Area",2008,47162,171,-4,544,548,175,1,174,0
"35220",NA,18065,"Henry County, IN","County or equivalent",2008,47162,171,-4,544,548,175,1,174,0
"35260",NA,NA,"New Castle, PA","Micropolitan Statistical Area",2008,90272,-444,-120,1010,1130,-365,12,-377,41
"35260",NA,42073,"Lawrence County, PA","County or equivalent",2008,90272,-444,-120,1010,1130,-365,12,-377,41
"35340",NA,NA,"New Iberia, LA","Micropolitan Statistical Area",2008,75097,154,466,1158,692,-308,31,-339,-4
"35340",NA,22045,"Iberia Parish, LA","County or equivalent",2008,75097,154,466,1158,692,-308,31,-339,-4
"35420",NA,NA,"New Philadelphia-Dover, OH","Micropolitan Statistical Area",2008,91348,85,263,1205,942,-244,20,-264,66
"35420",NA,39157,"Tuscarawas County, OH","County or equivalent",2008,91348,85,263,1205,942,-244,20,-264,66
"35460",NA,NA,"Newport, TN","Micropolitan Statistical Area",2008,35688,371,-15,422,437,380,8,372,6
"35460",NA,47029,"Cocke County, TN","County or equivalent",2008,35688,371,-15,422,437,380,8,372,6
"35500",NA,NA,"Newton, IA","Micropolitan Statistical Area",2008,36583,-64,101,429,328,-146,17,-163,-19
"35500",NA,19099,"Jasper County, IA","County or equivalent",2008,36583,-64,101,429,328,-146,17,-163,-19
"35580",NA,NA,"New Ulm, MN","Micropolitan Statistical Area",2008,25862,-105,36,303,267,-147,3,-150,6
"35580",NA,27015,"Brown County, MN","County or equivalent",2008,25862,-105,36,303,267,-147,3,-150,6
"35700",NA,NA,"Nogales, AZ","Micropolitan Statistical Area",2008,42923,448,547,826,279,-96,206,-302,-3
"35700",NA,4023,"Santa Cruz County, AZ","County or equivalent",2008,42923,448,547,826,279,-96,206,-302,-3
"35740",NA,NA,"Norfolk, NE","Micropolitan Statistical Area",2008,47561,-123,217,700,483,-335,57,-392,-5
"35740",NA,31119,"Madison County, NE","County or equivalent",2008,34020,-20,165,522,357,-175,52,-227,-10
"35740",NA,31139,"Pierce County, NE","County or equivalent",2008,7231,-30,18,94,76,-52,1,-53,4
"35740",NA,31167,"Stanton County, NE","County or equivalent",2008,6310,-73,34,84,50,-108,4,-112,1
"35820",NA,NA,"North Platte, NE","Micropolitan Statistical Area",2008,36831,146,198,544,346,-41,15,-56,-11
"35820",NA,31111,"Lincoln County, NE","County or equivalent",2008,35582,147,183,525,342,-29,15,-44,-7
"35820",NA,31113,"Logan County, NE","County or equivalent",2008,735,-11,11,14,3,-21,0,-21,-1
"35820",NA,31117,"McPherson County, NE","County or equivalent",2008,514,10,4,5,1,9,0,9,-3
"35860",NA,NA,"North Vernon, IN","Micropolitan Statistical Area",2008,28040,-37,144,387,243,-196,5,-201,15
"35860",NA,18079,"Jennings County, IN","County or equivalent",2008,28040,-37,144,387,243,-196,5,-201,15
"35900",NA,NA,"North Wilkesboro, NC","Micropolitan Statistical Area",2008,66655,-40,158,825,667,-159,132,-291,-39
"35900",NA,37193,"Wilkes County, NC","County or equivalent",2008,66655,-40,158,825,667,-159,132,-291,-39
"35940",NA,NA,"Norwalk, OH","Micropolitan Statistical Area",2008,59659,-56,342,876,534,-386,43,-429,-12
"35940",NA,39077,"Huron County, OH","County or equivalent",2008,59659,-56,342,876,534,-386,43,-429,-12
"36020",NA,NA,"Oak Harbor, WA","Micropolitan Statistical Area",2008,81424,449,187,924,737,578,68,510,-316
"36020",NA,53029,"Island County, WA","County or equivalent",2008,81424,449,187,924,737,578,68,510,-316
"36060",NA,NA,"Oak Hill, WV","Micropolitan Statistical Area",2008,46341,66,7,580,573,60,8,52,-1
"36060",NA,54019,"Fayette County, WV","County or equivalent",2008,46341,66,7,580,573,60,8,52,-1
"36180",NA,NA,"Ocean Pines, MD","Micropolitan Statistical Area",2008,49274,4,-62,511,573,82,46,36,-16
"36180",NA,24047,"Worcester County, MD","County or equivalent",2008,49274,4,-62,511,573,82,46,36,-16
"36300",NA,NA,"Ogdensburg-Massena, NY","Micropolitan Statistical Area",2008,109701,-71,269,1310,1041,-345,64,-409,5
"36300",NA,36089,"St. Lawrence County, NY","County or equivalent",2008,109701,-71,269,1310,1041,-345,64,-409,5
"36340",NA,NA,"Oil City, PA","Micropolitan Statistical Area",2008,54423,-332,-42,603,645,-285,7,-292,-5
"36340",NA,42121,"Venango County, PA","County or equivalent",2008,54423,-332,-42,603,645,-285,7,-292,-5
"36380",NA,NA,"Okeechobee, FL","Micropolitan Statistical Area",2008,40359,266,220,610,390,17,150,-133,29
"36380",NA,12093,"Okeechobee County, FL","County or equivalent",2008,40359,266,220,610,390,17,150,-133,29
"36460",NA,NA,"Olean, NY","Micropolitan Statistical Area",2008,79688,-495,223,1021,798,-710,10,-720,-8
"36460",NA,36009,"Cattaraugus County, NY","County or equivalent",2008,79688,-495,223,1021,798,-710,10,-720,-8
"36580",NA,NA,"Oneonta, NY","Micropolitan Statistical Area",2008,61962,-273,-36,590,626,-259,13,-272,22
"36580",NA,36077,"Otsego County, NY","County or equivalent",2008,61962,-273,-36,590,626,-259,13,-272,22
"36620",NA,NA,"Ontario, OR-ID","Micropolitan Statistical Area",2008,53873,171,382,813,431,-210,90,-300,-1
"36620",NA,16075,"Payette County, ID","County or equivalent",2008,22966,277,160,354,194,120,13,107,-3
"36620",NA,41045,"Malheur County, OR","County or equivalent",2008,30907,-106,222,459,237,-330,77,-407,2
"36660",NA,NA,"Opelousas-Eunice, LA","Micropolitan Statistical Area",2008,92173,808,491,1443,952,279,13,266,38
"36660",NA,22097,"St. Landry Parish, LA","County or equivalent",2008,92173,808,491,1443,952,279,13,266,38
"36700",NA,NA,"Orangeburg, SC","Micropolitan Statistical Area",2008,90336,-21,307,1282,975,-367,20,-387,39
"36700",NA,45075,"Orangeburg County, SC","County or equivalent",2008,90336,-21,307,1282,975,-367,20,-387,39
"36820",NA,NA,"Oskaloosa, IA","Micropolitan Statistical Area",2008,22321,68,94,298,204,-36,17,-53,10
"36820",NA,19123,"Mahaska County, IA","County or equivalent",2008,22321,68,94,298,204,-36,17,-53,10
"36860",NA,NA,"Ottawa-Streator, IL","Micropolitan Statistical Area",2008,153410,413,306,2000,1694,14,87,-73,93
"36860",NA,17011,"Bureau County, IL","County or equivalent",2008,34933,11,59,449,390,-72,12,-84,24
"36860",NA,17099,"LaSalle County, IL","County or equivalent",2008,112474,406,243,1490,1247,97,73,24,66
"36860",NA,17155,"Putnam County, IL","County or equivalent",2008,6003,-4,4,61,57,-11,2,-13,3
"36900",NA,NA,"Ottumwa, IA","Micropolitan Statistical Area",2008,35513,54,122,500,378,-83,28,-111,15
"36900",NA,19179,"Wapello County, IA","County or equivalent",2008,35513,54,122,500,378,-83,28,-111,15
"36940",NA,NA,"Owatonna, MN","Micropolitan Statistical Area",2008,36546,317,286,565,279,20,68,-48,11
"36940",NA,27147,"Steele County, MN","County or equivalent",2008,36546,317,286,565,279,20,68,-48,11
"37020",NA,NA,"Owosso, MI","Micropolitan Statistical Area",2008,70880,-782,283,889,606,-1077,5,-1082,12
"37020",NA,26155,"Shiawassee County, MI","County or equivalent",2008,70880,-782,283,889,606,-1077,5,-1082,12
"37060",NA,NA,"Oxford, MS","Micropolitan Statistical Area",2008,43922,769,221,551,330,543,47,496,5
"37060",NA,28071,"Lafayette County, MS","County or equivalent",2008,43922,769,221,551,330,543,47,496,5
"37140",NA,NA,"Paducah, KY-IL","Micropolitan Statistical Area",2008,98093,451,70,1221,1151,332,11,321,49
"37140",NA,17127,"Massac County, IL","County or equivalent",2008,15070,-8,19,210,191,-37,0,-37,10
"37140",NA,21007,"Ballard County, KY","County or equivalent",2008,8323,84,-11,98,109,99,1,98,-4
"37140",NA,21139,"Livingston County, KY","County or equivalent",2008,9591,-27,-19,97,116,-16,0,-16,8
"37140",NA,21145,"McCracken County, KY","County or equivalent",2008,65109,402,81,816,735,286,10,276,35
"37220",NA,NA,"Pahrump, NV","Micropolitan Statistical Area",2008,44375,353,-96,500,596,444,39,405,5
"37220",NA,32023,"Nye County, NV","County or equivalent",2008,44375,353,-96,500,596,444,39,405,5
"37260",NA,NA,"Palatka, FL","Micropolitan Statistical Area",2008,73459,-199,133,1052,919,-364,63,-427,32
"37260",NA,12107,"Putnam County, FL","County or equivalent",2008,73459,-199,133,1052,919,-364,63,-427,32
"37300",NA,NA,"Palestine, TX","Micropolitan Statistical Area",2008,56838,122,76,684,608,36,42,-6,10
"37300",NA,48001,"Anderson County, TX","County or equivalent",2008,56838,122,76,684,608,36,42,-6,10
"37420",NA,NA,"Pampa, TX","Micropolitan Statistical Area",2008,23081,250,117,369,252,139,36,103,-6
"37420",NA,48179,"Gray County, TX","County or equivalent",2008,22248,252,109,356,247,146,36,110,-3
"37420",NA,48393,"Roberts County, TX","County or equivalent",2008,833,-2,8,13,5,-7,0,-7,-3
"37500",NA,NA,"Paragould, AR","Micropolitan Statistical Area",2008,40684,332,172,566,394,146,8,138,14
"37500",NA,5055,"Greene County, AR","County or equivalent",2008,40684,332,172,566,394,146,8,138,14
"37540",NA,NA,"Paris, TN","Micropolitan Statistical Area",2008,31770,195,-80,367,447,254,10,244,21
"37540",NA,47079,"Henry County, TN","County or equivalent",2008,31770,195,-80,367,447,254,10,244,21
"37580",NA,NA,"Paris, TX","Micropolitan Statistical Area",2008,49286,196,90,660,570,103,52,51,3
"37580",NA,48277,"Lamar County, TX","County or equivalent",2008,49286,196,90,660,570,103,52,51,3
"37660",NA,NA,"Parsons, KS","Micropolitan Statistical Area",2008,21871,-113,53,309,256,-182,4,-186,16
"37660",NA,20099,"Labette County, KS","County or equivalent",2008,21871,-113,53,309,256,-182,4,-186,16
"37740",NA,NA,"Payson, AZ","Micropolitan Statistical Area",2008,52166,229,102,746,644,123,35,88,4
"37740",NA,4007,"Gila County, AZ","County or equivalent",2008,52166,229,102,746,644,123,35,88,4
"37780",NA,NA,"Pecos, TX","Micropolitan Statistical Area",2008,11062,-107,66,172,106,-159,19,-178,-14
"37780",NA,48389,"Reeves County, TX","County or equivalent",2008,11062,-107,66,172,106,-159,19,-178,-14
"37800",NA,NA,"Pella, IA","Micropolitan Statistical Area",2008,32571,82,128,448,320,-30,6,-36,-16
"37800",NA,19125,"Marion County, IA","County or equivalent",2008,32571,82,128,448,320,-30,6,-36,-16
"37820",NA,NA,"Pendleton-Hermiston, OR","Micropolitan Statistical Area",2008,84666,309,654,1224,570,-340,178,-518,-5
"37820",NA,41049,"Morrow County, OR","County or equivalent",2008,11140,20,104,159,55,-76,34,-110,-8
"37820",NA,41059,"Umatilla County, OR","County or equivalent",2008,73526,289,550,1065,515,-264,144,-408,3
"37940",NA,NA,"Peru, IN","Micropolitan Statistical Area",2008,36219,-423,112,432,320,-529,3,-532,-6
"37940",NA,18103,"Miami County, IN","County or equivalent",2008,36219,-423,112,432,320,-529,3,-532,-6
"38020",NA,NA,"Phoenix Lake-Cedar Ridge, CA","Micropolitan Statistical Area",2008,55644,-83,-96,507,603,36,15,21,-23
"38020",NA,6109,"Tuolumne County, CA","County or equivalent",2008,55644,-83,-96,507,603,36,15,21,-23
"38100",NA,NA,"Picayune, MS","Micropolitan Statistical Area",2008,57466,459,232,782,550,319,9,310,-92
"38100",NA,28109,"Pearl River County, MS","County or equivalent",2008,57466,459,232,782,550,319,9,310,-92
"38180",NA,NA,"Pierre, SD","Micropolitan Statistical Area",2008,19449,-201,128,272,144,-326,10,-336,-3
"38180",NA,46065,"Hughes County, SD","County or equivalent",2008,16746,-131,92,233,141,-231,10,-241,8
"38180",NA,46117,"Stanley County, SD","County or equivalent",2008,2703,-70,36,39,3,-95,0,-95,-11
"38200",NA,NA,"Pierre Part, LA","Micropolitan Statistical Area",2008,22881,-77,71,284,213,-135,6,-141,-13
"38200",NA,22007,"Assumption Parish, LA","County or equivalent",2008,22881,-77,71,284,213,-135,6,-141,-13
"38260",NA,NA,"Pittsburg, KS","Micropolitan Statistical Area",2008,38868,136,158,588,430,-32,69,-101,10
"38260",NA,20037,"Crawford County, KS","County or equivalent",2008,38868,136,158,588,430,-32,69,-101,10
"38380",NA,NA,"Plainview, TX","Micropolitan Statistical Area",2008,35234,-339,370,652,282,-711,68,-779,2
"38380",NA,48189,"Hale County, TX","County or equivalent",2008,35234,-339,370,652,282,-711,68,-779,2
"38420",NA,NA,"Platteville, WI","Micropolitan Statistical Area",2008,49238,114,109,605,496,-30,7,-37,35
"38420",NA,55043,"Grant County, WI","County or equivalent",2008,49238,114,109,605,496,-30,7,-37,35
"38460",NA,NA,"Plattsburgh, NY","Micropolitan Statistical Area",2008,81947,-113,191,853,662,-336,43,-379,32
"38460",NA,36019,"Clinton County, NY","County or equivalent",2008,81947,-113,191,853,662,-336,43,-379,32
"38500",NA,NA,"Plymouth, IN","Micropolitan Statistical Area",2008,46709,163,279,687,408,-130,109,-239,14
"38500",NA,18099,"Marshall County, IN","County or equivalent",2008,46709,163,279,687,408,-130,109,-239,14
"38580",NA,NA,"Point Pleasant, WV-OH","Micropolitan Statistical Area",2008,56590,243,72,709,637,185,1,184,-14
"38580",NA,39053,"Gallia County, OH","County or equivalent",2008,30912,96,82,416,334,15,2,13,-1
"38580",NA,54053,"Mason County, WV","County or equivalent",2008,25678,147,-10,293,303,170,-1,171,-13
"38620",NA,NA,"Ponca City, OK","Micropolitan Statistical Area",2008,45632,-79,163,714,551,-228,40,-268,-14
"38620",NA,40071,"Kay County, OK","County or equivalent",2008,45632,-79,163,714,551,-228,40,-268,-14
"38700",NA,NA,"Pontiac, IL","Micropolitan Statistical Area",2008,37681,-157,123,542,419,-273,13,-286,-7
"38700",NA,17105,"Livingston County, IL","County or equivalent",2008,37681,-157,123,542,419,-273,13,-286,-7
"38740",NA,NA,"Poplar Bluff, MO","Micropolitan Statistical Area",2008,41383,153,51,563,512,99,14,85,3
"38740",NA,29023,"Butler County, MO","County or equivalent",2008,41383,153,51,563,512,99,14,85,3
"38780",NA,NA,"Portales, NM","Micropolitan Statistical Area",2008,18889,-237,220,364,144,-462,17,-479,5
"38780",NA,35041,"Roosevelt County, NM","County or equivalent",2008,18889,-237,220,364,144,-462,17,-479,5
"38820",NA,NA,"Port Angeles, WA","Micropolitan Statistical Area",2008,71021,704,-176,696,872,888,49,839,-8
"38820",NA,53009,"Clallam County, WA","County or equivalent",2008,71021,704,-176,696,872,888,49,839,-8
"39020",NA,NA,"Portsmouth, OH","Micropolitan Statistical Area",2008,76587,138,126,1026,900,-1,12,-13,13
"39020",NA,39145,"Scioto County, OH","County or equivalent",2008,76587,138,126,1026,900,-1,12,-13,13
"39060",NA,NA,"Pottsville, PA","Micropolitan Statistical Area",2008,147254,139,-400,1528,1928,477,15,462,62
"39060",NA,42107,"Schuylkill County, PA","County or equivalent",2008,147254,139,-400,1528,1928,477,15,462,62
"39220",NA,NA,"Price, UT","Micropolitan Statistical Area",2008,19549,-59,148,333,185,-209,9,-218,2
"39220",NA,49007,"Carbon County, UT","County or equivalent",2008,19549,-59,148,333,185,-209,9,-218,2
"39260",NA,NA,"Prineville, OR","Micropolitan Statistical Area",2008,23023,166,69,282,213,82,18,64,15
"39260",NA,41013,"Crook County, OR","County or equivalent",2008,23023,166,69,282,213,82,18,64,15
"39420",NA,NA,"Pullman, WA","Micropolitan Statistical Area",2008,41664,898,228,441,213,675,177,498,-5
"39420",NA,53075,"Whitman County, WA","County or equivalent",2008,41664,898,228,441,213,675,177,498,-5
"39500",NA,NA,"Quincy, IL-MO","Micropolitan Statistical Area",2008,76848,41,64,1004,940,-50,16,-66,27
"39500",NA,17001,"Adams County, IL","County or equivalent",2008,66897,121,63,882,819,30,16,14,28
"39500",NA,29111,"Lewis County, MO","County or equivalent",2008,9951,-80,1,122,121,-80,0,-80,-1
"39700",NA,NA,"Raymondville, TX","Micropolitan Statistical Area",2008,20600,163,282,405,123,-117,36,-153,-2
"39700",NA,48489,"Willacy County, TX","County or equivalent",2008,20600,163,282,405,123,-117,36,-153,-2
"39780",NA,NA,"Red Bluff, CA","Micropolitan Statistical Area",2008,61550,594,320,906,586,285,69,216,-11
"39780",NA,6103,"Tehama County, CA","County or equivalent",2008,61550,594,320,906,586,285,69,216,-11
"39860",NA,NA,"Red Wing, MN","Micropolitan Statistical Area",2008,45897,164,182,617,435,-36,11,-47,18
"39860",NA,27049,"Goodhue County, MN","County or equivalent",2008,45897,164,182,617,435,-36,11,-47,18
"39940",NA,NA,"Rexburg, ID","Micropolitan Statistical Area",2008,50007,532,952,1184,232,-408,52,-460,-12
"39940",NA,16043,"Fremont County, ID","County or equivalent",2008,12551,50,154,254,100,-88,26,-114,-16
"39940",NA,16065,"Madison County, ID","County or equivalent",2008,37456,482,798,930,132,-320,26,-346,4
"39980",NA,NA,"Richmond, IN","Micropolitan Statistical Area",2008,67795,-341,121,891,770,-494,36,-530,32
"39980",NA,18177,"Wayne County, IN","County or equivalent",2008,67795,-341,121,891,770,-494,36,-530,32
"40080",NA,NA,"Richmond-Berea, KY","Micropolitan Statistical Area",2008,98980,1311,505,1278,773,787,45,742,19
"40080",NA,21151,"Madison County, KY","County or equivalent",2008,82192,1181,495,1079,584,676,44,632,10
"40080",NA,21203,"Rockcastle County, KY","County or equivalent",2008,16788,130,10,199,189,111,1,110,9
"40100",NA,NA,"Rio Grande City-Roma, TX","Micropolitan Statistical Area",2008,62249,914,1268,1604,336,-325,369,-694,-29
"40100",NA,48427,"Starr County, TX","County or equivalent",2008,62249,914,1268,1604,336,-325,369,-694,-29
"40180",NA,NA,"Riverton, WY","Micropolitan Statistical Area",2008,38113,652,285,645,360,371,6,365,-4
"40180",NA,56013,"Fremont County, WY","County or equivalent",2008,38113,652,285,645,360,371,6,365,-4
"40260",NA,NA,"Roanoke Rapids, NC","Micropolitan Statistical Area",2008,75470,-258,58,995,937,-320,30,-350,4
"40260",NA,37083,"Halifax County, NC","County or equivalent",2008,54983,11,96,748,652,-83,24,-107,-2
"40260",NA,37131,"Northampton County, NC","County or equivalent",2008,20487,-269,-38,247,285,-237,6,-243,6
"40300",NA,NA,"Rochelle, IL","Micropolitan Statistical Area",2008,55167,273,165,656,491,82,83,-1,26
"40300",NA,17141,"Ogle County, IL","County or equivalent",2008,55167,273,165,656,491,82,83,-1,26
"40460",NA,NA,"Rockingham, NC","Micropolitan Statistical Area",2008,46005,82,171,672,501,-79,55,-134,-10
"40460",NA,37153,"Richmond County, NC","County or equivalent",2008,46005,82,171,672,501,-79,55,-134,-10
"40500",NA,NA,"Rockland, ME","Micropolitan Statistical Area",2008,40686,-37,3,419,416,-62,11,-73,22
"40500",NA,23013,"Knox County, ME","County or equivalent",2008,40686,-37,3,419,416,-62,11,-73,22
"40540",NA,NA,"Rock Springs, WY","Micropolitan Statistical Area",2008,39944,568,440,692,252,135,15,120,-7
"40540",NA,56037,"Sweetwater County, WY","County or equivalent",2008,39944,568,440,692,252,135,15,120,-7
"40620",NA,NA,"Rolla, MO","Micropolitan Statistical Area",2008,42205,-238,195,602,407,-439,87,-526,6
"40620",NA,29161,"Phelps County, MO","County or equivalent",2008,42205,-238,195,602,407,-439,87,-526,6
"40700",NA,NA,"Roseburg, OR","Micropolitan Statistical Area",2008,104059,59,-55,1162,1217,80,26,54,34
"40700",NA,41019,"Douglas County, OR","County or equivalent",2008,104059,59,-55,1162,1217,80,26,54,34
"40740",NA,NA,"Roswell, NM","Micropolitan Statistical Area",2008,63060,600,384,1014,630,178,121,57,38
"40740",NA,35005,"Chaves County, NM","County or equivalent",2008,63060,600,384,1014,630,178,121,57,38
"40760",NA,NA,"Ruidoso, NM","Micropolitan Statistical Area",2008,20793,91,57,232,175,62,26,36,-28
"40760",NA,35027,"Lincoln County, NM","County or equivalent",2008,20793,91,57,232,175,62,26,36,-28
"40780",NA,NA,"Russellville, AR","Micropolitan Statistical Area",2008,81928,1027,468,1217,749,519,108,411,40
"40780",NA,5115,"Pope County, AR","County or equivalent",2008,59952,748,339,861,522,381,21,360,28
"40780",NA,5149,"Yell County, AR","County or equivalent",2008,21976,279,129,356,227,138,87,51,12
"40820",NA,NA,"Ruston, LA","Micropolitan Statistical Area",2008,57752,92,255,793,538,-173,35,-208,10
"40820",NA,22049,"Jackson Parish, LA","County or equivalent",2008,15191,89,10,202,192,78,0,78,1
"40820",NA,22061,"Lincoln Parish, LA","County or equivalent",2008,42561,3,245,591,346,-251,35,-286,9
"40860",NA,NA,"Rutland, VT","Micropolitan Statistical Area",2008,63331,-123,2,627,625,-135,4,-139,10
"40860",NA,50021,"Rutland County, VT","County or equivalent",2008,63331,-123,2,627,625,-135,4,-139,10
"40940",NA,NA,"Safford, AZ","Micropolitan Statistical Area",2008,44454,1738,399,713,314,1338,17,1321,1
"40940",NA,4009,"Graham County, AZ","County or equivalent",2008,36452,1475,307,578,271,1148,12,1136,20
"40940",NA,4011,"Greenlee County, AZ","County or equivalent",2008,8002,263,92,135,43,190,5,185,-19
"41220",NA,NA,"St. Marys, GA","Micropolitan Statistical Area",2008,47641,532,606,882,276,-85,27,-112,11
"41220",NA,13039,"Camden County, GA","County or equivalent",2008,47641,532,606,882,276,-85,27,-112,11
"41260",NA,NA,"St. Marys, PA","Micropolitan Statistical Area",2008,32268,-316,-65,304,369,-238,4,-242,-13
"41260",NA,42047,"Elk County, PA","County or equivalent",2008,32268,-316,-65,304,369,-238,4,-242,-13
"41460",NA,NA,"Salina, KS","Micropolitan Statistical Area",2008,60683,218,314,899,585,-94,68,-162,-2
"41460",NA,20143,"Ottawa County, KS","County or equivalent",2008,6026,23,8,74,66,14,1,13,1
"41460",NA,20169,"Saline County, KS","County or equivalent",2008,54657,195,306,825,519,-108,67,-175,-3
"41580",NA,NA,"Salisbury, NC","Micropolitan Statistical Area",2008,139225,2187,497,1810,1313,1606,288,1318,84
"41580",NA,37159,"Rowan County, NC","County or equivalent",2008,139225,2187,497,1810,1313,1606,288,1318,84
"41820",NA,NA,"Sanford, NC","Micropolitan Statistical Area",2008,59091,1276,450,973,523,823,250,573,3
"41820",NA,37105,"Lee County, NC","County or equivalent",2008,59091,1276,450,973,523,823,250,573,3
"42300",NA,NA,"Sault Ste. Marie, MI","Micropolitan Statistical Area",2008,38971,41,120,416,296,-84,11,-95,5
"42300",NA,26033,"Chippewa County, MI","County or equivalent",2008,38971,41,120,416,296,-84,11,-95,5
"42380",NA,NA,"Sayre, PA","Micropolitan Statistical Area",2008,61233,-181,75,752,677,-299,4,-303,43
"42380",NA,42015,"Bradford County, PA","County or equivalent",2008,61233,-181,75,752,677,-299,4,-303,43
"42420",NA,NA,"Scottsbluff, NE","Micropolitan Statistical Area",2008,37289,257,132,565,433,112,41,71,13
"42420",NA,31007,"Banner County, NE","County or equivalent",2008,735,3,4,6,2,-1,0,-1,0
"42420",NA,31157,"Scotts Bluff County, NE","County or equivalent",2008,36554,254,128,559,431,113,41,72,13
"42460",NA,NA,"Scottsboro, AL","Micropolitan Statistical Area",2008,53134,192,5,615,610,195,6,189,-8
"42460",NA,1071,"Jackson County, AL","County or equivalent",2008,53134,192,5,615,610,195,6,189,-8
"42500",NA,NA,"Scottsburg, IN","Micropolitan Statistical Area",2008,23627,-67,42,293,251,-122,0,-122,13
"42500",NA,18143,"Scott County, IN","County or equivalent",2008,23627,-67,42,293,251,-122,0,-122,13
"42580",NA,NA,"Seaford, DE","Micropolitan Statistical Area",2008,188036,4196,671,2536,1865,3386,242,3144,139
"42580",NA,10005,"Sussex County, DE","County or equivalent",2008,188036,4196,671,2536,1865,3386,242,3144,139
"42620",NA,NA,"Searcy, AR","Micropolitan Statistical Area",2008,74845,1338,341,1043,702,987,39,948,10
"42620",NA,5145,"White County, AR","County or equivalent",2008,74845,1338,341,1043,702,987,39,948,10
"42700",NA,NA,"Sebring, FL","Micropolitan Statistical Area",2008,100011,991,-435,1112,1547,1539,327,1212,-113
"42700",NA,12055,"Highlands County, FL","County or equivalent",2008,100011,991,-435,1112,1547,1539,327,1212,-113
"42740",NA,NA,"Sedalia, MO","Micropolitan Statistical Area",2008,41006,258,257,642,385,-6,56,-62,7
"42740",NA,29159,"Pettis County, MO","County or equivalent",2008,41006,258,257,642,385,-6,56,-62,7
"42780",NA,NA,"Selinsgrove, PA","Micropolitan Statistical Area",2008,38074,-75,166,488,322,-195,2,-197,-46
"42780",NA,42109,"Snyder County, PA","County or equivalent",2008,38074,-75,166,488,322,-195,2,-197,-46
"42820",NA,NA,"Selma, AL","Micropolitan Statistical Area",2008,42867,-124,116,672,556,-269,1,-270,29
"42820",NA,1047,"Dallas County, AL","County or equivalent",2008,42867,-124,116,672,556,-269,1,-270,29
"42860",NA,NA,"Seneca, SC","Micropolitan Statistical Area",2008,71274,614,87,837,750,488,58,430,39
"42860",NA,45073,"Oconee County, SC","County or equivalent",2008,71274,614,87,837,750,488,58,430,39
"42900",NA,NA,"Seneca Falls, NY","Micropolitan Statistical Area",2008,34086,-155,56,380,324,-193,19,-212,-18
"42900",NA,36099,"Seneca County, NY","County or equivalent",2008,34086,-155,56,380,324,-193,19,-212,-18
"42940",NA,NA,"Sevierville, TN","Micropolitan Statistical Area",2008,84835,1322,288,1078,790,983,43,940,51
"42940",NA,47155,"Sevier County, TN","County or equivalent",2008,84835,1322,288,1078,790,983,43,940,51
"42980",NA,NA,"Seymour, IN","Micropolitan Statistical Area",2008,42193,169,171,589,418,0,68,-68,-2
"42980",NA,18071,"Jackson County, IN","County or equivalent",2008,42193,169,171,589,418,0,68,-68,-2
"43060",NA,NA,"Shawnee, OK","Micropolitan Statistical Area",2008,69616,390,289,987,698,66,20,46,35
"43060",NA,40125,"Pottawatomie County, OK","County or equivalent",2008,69616,390,289,987,698,66,20,46,35
"43140",NA,NA,"Shelby, NC","Micropolitan Statistical Area",2008,99015,736,242,1235,993,432,56,376,62
"43140",NA,37045,"Cleveland County, NC","County or equivalent",2008,99015,736,242,1235,993,432,56,376,62
"43180",NA,NA,"Shelbyville, TN","Micropolitan Statistical Area",2008,44696,841,305,709,404,535,182,353,1
"43180",NA,47003,"Bedford County, TN","County or equivalent",2008,44696,841,305,709,404,535,182,353,1
"43220",NA,NA,"Shelton, WA","Micropolitan Statistical Area",2008,57846,987,143,694,551,801,42,759,43
"43220",NA,53045,"Mason County, WA","County or equivalent",2008,57846,987,143,694,551,801,42,759,43
"43260",NA,NA,"Sheridan, WY","Micropolitan Statistical Area",2008,28662,625,110,387,277,510,10,500,5
"43260",NA,56033,"Sheridan County, WY","County or equivalent",2008,28662,625,110,387,277,510,10,500,5
"43320",NA,NA,"Show Low, AZ","Micropolitan Statistical Area",2008,112757,1678,1259,2089,830,378,48,330,41
"43320",NA,4017,"Navajo County, AZ","County or equivalent",2008,112757,1678,1259,2089,830,378,48,330,41
"43380",NA,NA,"Sidney, OH","Micropolitan Statistical Area",2008,48919,171,343,745,402,-194,41,-235,22
"43380",NA,39149,"Shelby County, OH","County or equivalent",2008,48919,171,343,745,402,-194,41,-235,22
"43420",NA,NA,"Sierra Vista-Douglas, AZ","Micropolitan Statistical Area",2008,129006,1075,858,1920,1062,159,274,-115,58
"43420",NA,4003,"Cochise County, AZ","County or equivalent",2008,129006,1075,858,1920,1062,159,274,-115,58
"43460",NA,NA,"Sikeston, MO","Micropolitan Statistical Area",2008,40673,-32,223,627,404,-267,11,-278,12
"43460",NA,29201,"Scott County, MO","County or equivalent",2008,40673,-32,223,627,404,-267,11,-278,12
"43500",NA,NA,"Silver City, NM","Micropolitan Statistical Area",2008,29844,156,57,374,317,89,9,80,10
"43500",NA,35017,"Grant County, NM","County or equivalent",2008,29844,156,57,374,317,89,9,80,10
"43540",NA,NA,"Silverthorne, CO","Micropolitan Statistical Area",2008,26843,462,343,380,37,174,195,-21,-55
"43540",NA,8117,"Summit County, CO","County or equivalent",2008,26843,462,343,380,37,174,195,-21,-55
"43660",NA,NA,"Snyder, TX","Micropolitan Statistical Area",2008,15973,-11,111,254,143,-104,10,-114,-18
"43660",NA,48415,"Scurry County, TX","County or equivalent",2008,15973,-11,111,254,143,-104,10,-114,-18
"43700",NA,NA,"Somerset, KY","Micropolitan Statistical Area",2008,60851,791,87,777,690,674,13,661,30
"43700",NA,21199,"Pulaski County, KY","County or equivalent",2008,60851,791,87,777,690,674,13,661,30
"43740",NA,NA,"Somerset, PA","Micropolitan Statistical Area",2008,77454,-406,-221,744,965,-245,10,-255,60
"43740",NA,42111,"Somerset County, PA","County or equivalent",2008,77454,-406,-221,744,965,-245,10,-255,60
"43860",NA,NA,"Southern Pines-Pinehurst, NC","Micropolitan Statistical Area",2008,85608,1399,91,1077,986,1259,135,1124,49
"43860",NA,37125,"Moore County, NC","County or equivalent",2008,85608,1399,91,1077,986,1259,135,1124,49
"43940",NA,NA,"Spearfish, SD","Micropolitan Statistical Area",2008,23524,136,86,298,212,73,2,71,-23
"43940",NA,46081,"Lawrence County, SD","County or equivalent",2008,23524,136,86,298,212,73,2,71,-23
"43980",NA,NA,"Spencer, IA","Micropolitan Statistical Area",2008,16691,5,25,215,190,-27,11,-38,7
"43980",NA,19041,"Clay County, IA","County or equivalent",2008,16691,5,25,215,190,-27,11,-38,7
"44020",NA,NA,"Spirit Lake, IA","Micropolitan Statistical Area",2008,16775,106,2,183,181,97,-1,98,7
"44020",NA,19059,"Dickinson County, IA","County or equivalent",2008,16775,106,2,183,181,97,-1,98,7
"44260",NA,NA,"Starkville, MS","Micropolitan Statistical Area",2008,43944,-14,358,647,289,-388,94,-482,16
"44260",NA,28105,"Oktibbeha County, MS","County or equivalent",2008,43944,-14,358,647,289,-388,94,-482,16
"44340",NA,NA,"Statesboro, GA","Micropolitan Statistical Area",2008,67761,1577,438,884,446,1151,67,1084,-12
"44340",NA,13031,"Bulloch County, GA","County or equivalent",2008,67761,1577,438,884,446,1151,67,1084,-12
"44380",NA,NA,"Statesville-Mooresville, NC","Micropolitan Statistical Area",2008,155359,4353,882,2152,1270,3408,247,3161,63
"44380",NA,37097,"Iredell County, NC","County or equivalent",2008,155359,4353,882,2152,1270,3408,247,3161,63
"44420",NA,NA,"Staunton-Waynesboro, VA","Micropolitan Statistical Area",2008,117170,989,306,1432,1126,726,44,682,-43
"44420",NA,51015,"Augusta County, VA","County or equivalent",2008,71250,427,220,815,595,226,26,200,-19
"44420",NA,51790,"Staunton city, VA","County or equivalent",2008,23967,201,6,306,300,212,3,209,-17
"44420",NA,51820,"Waynesboro city, VA","County or equivalent",2008,21953,361,80,311,231,288,15,273,-7
"44500",NA,NA,"Stephenville, TX","Micropolitan Statistical Area",2008,35870,283,223,532,309,63,67,-4,-3
"44500",NA,48143,"Erath County, TX","County or equivalent",2008,35870,283,223,532,309,63,67,-4,-3
"44540",NA,NA,"Sterling, CO","Micropolitan Statistical Area",2008,20905,-85,59,247,188,-159,33,-192,15
"44540",NA,8075,"Logan County, CO","County or equivalent",2008,20905,-85,59,247,188,-159,33,-192,15
"44580",NA,NA,"Sterling, IL","Micropolitan Statistical Area",2008,59153,127,118,764,646,-30,37,-67,39
"44580",NA,17195,"Whiteside County, IL","County or equivalent",2008,59153,127,118,764,646,-30,37,-67,39
"44620",NA,NA,"Stevens Point, WI","Micropolitan Statistical Area",2008,68744,426,348,815,467,92,34,58,-14
"44620",NA,55097,"Portage County, WI","County or equivalent",2008,68744,426,348,815,467,92,34,58,-14
"44660",NA,NA,"Stillwater, OK","Micropolitan Statistical Area",2008,78280,556,420,973,553,128,215,-87,8
"44660",NA,40119,"Payne County, OK","County or equivalent",2008,78280,556,420,973,553,128,215,-87,8
"44740",NA,NA,"Storm Lake, IA","Micropolitan Statistical Area",2008,19702,117,99,282,183,8,107,-99,10
"44740",NA,19021,"Buena Vista County, IA","County or equivalent",2008,19702,117,99,282,183,8,107,-99,10
"44780",NA,NA,"Sturgis, MI","Micropolitan Statistical Area",2008,62232,-59,406,960,554,-445,99,-544,-20
"44780",NA,26149,"St. Joseph County, MI","County or equivalent",2008,62232,-59,406,960,554,-445,99,-544,-20
"44860",NA,NA,"Sulphur Springs, TX","Micropolitan Statistical Area",2008,33804,105,147,489,342,-22,49,-71,-20
"44860",NA,48223,"Hopkins County, TX","County or equivalent",2008,33804,105,147,489,342,-22,49,-71,-20
"44900",NA,NA,"Summerville, GA","Micropolitan Statistical Area",2008,26801,-3,22,304,282,-29,20,-49,4
"44900",NA,13055,"Chattooga County, GA","County or equivalent",2008,26801,-3,22,304,282,-29,20,-49,4
"44980",NA,NA,"Sunbury, PA","Micropolitan Statistical Area",2008,91091,112,-169,980,1149,230,17,213,51
"44980",NA,42097,"Northumberland County, PA","County or equivalent",2008,91091,112,-169,980,1149,230,17,213,51
"45000",NA,NA,"Susanville, CA","Micropolitan Statistical Area",2008,34574,-406,139,327,188,-518,3,-521,-27
"45000",NA,6035,"Lassen County, CA","County or equivalent",2008,34574,-406,139,327,188,-518,3,-521,-27
"45020",NA,NA,"Sweetwater, TX","Micropolitan Statistical Area",2008,14879,329,74,235,161,267,7,260,-12
"45020",NA,48353,"Nolan County, TX","County or equivalent",2008,14879,329,74,235,161,267,7,260,-12
"45140",NA,NA,"Tahlequah, OK","Micropolitan Statistical Area",2008,45733,645,270,682,412,382,72,310,-7
"45140",NA,40021,"Cherokee County, OK","County or equivalent",2008,45733,645,270,682,412,382,72,310,-7
"45180",NA,NA,"Talladega-Sylacauga, AL","Micropolitan Statistical Area",2008,80279,102,114,1008,894,-38,15,-53,26
"45180",NA,1121,"Talladega County, AL","County or equivalent",2008,80279,102,114,1008,894,-38,15,-53,26
"45260",NA,NA,"Tallulah, LA","Micropolitan Statistical Area",2008,11790,-24,56,211,155,-86,0,-86,6
"45260",NA,22065,"Madison Parish, LA","County or equivalent",2008,11790,-24,56,211,155,-86,0,-86,6
"45340",NA,NA,"Taos, NM","Micropolitan Statistical Area",2008,31546,38,117,380,263,-89,46,-135,10
"45340",NA,35055,"Taos County, NM","County or equivalent",2008,31546,38,117,380,263,-89,46,-135,10
"45380",NA,NA,"Taylorville, IL","Micropolitan Statistical Area",2008,34501,-62,14,413,399,-94,10,-104,18
"45380",NA,17021,"Christian County, IL","County or equivalent",2008,34501,-62,14,413,399,-94,10,-104,18
"45540",NA,NA,"The Villages, FL","Micropolitan Statistical Area",2008,74721,2632,-68,735,803,2874,41,2833,-174
"45540",NA,12119,"Sumter County, FL","County or equivalent",2008,74721,2632,-68,735,803,2874,41,2833,-174
"45580",NA,NA,"Thomaston, GA","Micropolitan Statistical Area",2008,27530,-51,-30,331,361,-35,32,-67,14
"45580",NA,13293,"Upson County, GA","County or equivalent",2008,27530,-51,-30,331,361,-35,32,-67,14
"45620",NA,NA,"Thomasville, GA","Micropolitan Statistical Area",2008,45778,596,237,712,475,360,19,341,-1
"45620",NA,13275,"Thomas County, GA","County or equivalent",2008,45778,596,237,712,475,360,19,341,-1
"45640",NA,NA,"Thomasville-Lexington, NC","Micropolitan Statistical Area",2008,158166,2092,553,1993,1440,1523,308,1215,16
"45640",NA,37057,"Davidson County, NC","County or equivalent",2008,158166,2092,553,1993,1440,1523,308,1215,16
"45660",NA,NA,"Tiffin, OH","Micropolitan Statistical Area",2008,56461,-227,220,751,531,-453,14,-467,6
"45660",NA,39147,"Seneca County, OH","County or equivalent",2008,56461,-227,220,751,531,-453,14,-467,6
"45700",NA,NA,"Tifton, GA","Micropolitan Statistical Area",2008,42434,446,326,700,374,126,127,-1,-6
"45700",NA,13277,"Tift County, GA","County or equivalent",2008,42434,446,326,700,374,126,127,-1,-6
"45740",NA,NA,"Toccoa, GA","Micropolitan Statistical Area",2008,25493,272,60,361,301,211,3,208,1
"45740",NA,13257,"Stephens County, GA","County or equivalent",2008,25493,272,60,361,301,211,3,208,1
"45860",NA,NA,"Torrington, CT","Micropolitan Statistical Area",2008,187745,-70,316,1883,1567,-410,152,-562,24
"45860",NA,9005,"Litchfield County, CT","County or equivalent",2008,187745,-70,316,1883,1567,-410,152,-562,24
"45900",NA,NA,"Traverse City, MI","Micropolitan Statistical Area",2008,142316,491,496,1705,1209,-9,49,-58,4
"45900",NA,26019,"Benzie County, MI","County or equivalent",2008,17396,-85,24,204,180,-86,0,-86,-23
"45900",NA,26055,"Grand Traverse County, MI","County or equivalent",2008,86071,670,357,1055,698,268,43,225,45
"45900",NA,26079,"Kalkaska County, MI","County or equivalent",2008,17066,-48,89,237,148,-112,0,-112,-25
"45900",NA,26089,"Leelanau County, MI","County or equivalent",2008,21783,-46,26,209,183,-79,6,-85,7
"45980",NA,NA,"Troy, AL","Micropolitan Statistical Area",2008,30381,183,87,422,335,78,22,56,18
"45980",NA,1109,"Pike County, AL","County or equivalent",2008,30381,183,87,422,335,78,22,56,18
"46020",NA,NA,"Truckee-Grass Valley, CA","Micropolitan Statistical Area",2008,97118,265,-58,910,968,250,67,183,73
"46020",NA,6057,"Nevada County, CA","County or equivalent",2008,97118,265,-58,910,968,250,67,183,73
"46100",NA,NA,"Tullahoma, TN","Micropolitan Statistical Area",2008,99494,558,183,1230,1047,331,61,270,44
"46100",NA,47031,"Coffee County, TN","County or equivalent",2008,52134,400,114,695,581,265,47,218,21
"46100",NA,47051,"Franklin County, TN","County or equivalent",2008,41165,66,65,476,411,-25,13,-38,26
"46100",NA,47127,"Moore County, TN","County or equivalent",2008,6195,92,4,59,55,91,1,90,-3
"46180",NA,NA,"Tupelo, MS","Micropolitan Statistical Area",2008,133318,1258,758,2090,1332,491,44,447,9
"46180",NA,28057,"Itawamba County, MS","County or equivalent",2008,23175,143,56,306,250,75,4,71,12
"46180",NA,28081,"Lee County, MS","County or equivalent",2008,81139,930,475,1326,851,454,28,426,1
"46180",NA,28115,"Pontotoc County, MS","County or equivalent",2008,29004,185,227,458,231,-38,12,-50,-4
"46260",NA,NA,"Tuskegee, AL","Micropolitan Statistical Area",2008,22290,-19,-25,252,277,-1,13,-14,7
"46260",NA,1087,"Macon County, AL","County or equivalent",2008,22290,-19,-25,252,277,-1,13,-14,7
"46300",NA,NA,"Twin Falls, ID","Micropolitan Statistical Area",2008,94752,1925,793,1623,830,1203,213,990,-71
"46300",NA,16053,"Jerome County, ID","County or equivalent",2008,20468,482,237,387,150,238,58,180,7
"46300",NA,16083,"Twin Falls County, ID","County or equivalent",2008,74284,1443,556,1236,680,965,155,810,-78
"46380",NA,NA,"Ukiah, CA","Micropolitan Statistical Area",2008,86221,261,371,1161,790,-143,254,-397,33
"46380",NA,6045,"Mendocino County, CA","County or equivalent",2008,86221,261,371,1161,790,-143,254,-397,33
"46420",NA,NA,"Union, SC","Micropolitan Statistical Area",2008,27672,-117,-73,307,380,-25,2,-27,-19
"46420",NA,45087,"Union County, SC","County or equivalent",2008,27672,-117,-73,307,380,-25,2,-27,-19
"46460",NA,NA,"Union City, TN-KY","Micropolitan Statistical Area",2008,38230,-63,-26,457,483,-27,23,-50,-10
"46460",NA,21075,"Fulton County, KY","County or equivalent",2008,6855,59,-21,74,95,85,0,85,-5
"46460",NA,47131,"Obion County, TN","County or equivalent",2008,31375,-122,-5,383,388,-112,23,-135,-5
"46500",NA,NA,"Urbana, OH","Micropolitan Statistical Area",2008,39650,185,168,536,368,29,0,29,-12
"46500",NA,39021,"Champaign County, OH","County or equivalent",2008,39650,185,168,536,368,29,0,29,-12
"46620",NA,NA,"Uvalde, TX","Micropolitan Statistical Area",2008,26461,-13,250,484,234,-270,38,-308,7
"46620",NA,48463,"Uvalde County, TX","County or equivalent",2008,26461,-13,250,484,234,-270,38,-308,7
"46740",NA,NA,"Valley, AL","Micropolitan Statistical Area",2008,34424,-289,-38,424,462,-270,15,-285,19
"46740",NA,1017,"Chambers County, AL","County or equivalent",2008,34424,-289,-38,424,462,-270,15,-285,19
"46780",NA,NA,"Van Wert, OH","Micropolitan Statistical Area",2008,28748,-124,84,401,317,-230,4,-234,22
"46780",NA,39161,"Van Wert County, OH","County or equivalent",2008,28748,-124,84,401,317,-230,4,-234,22
"46820",NA,NA,"Vermillion, SD","Micropolitan Statistical Area",2008,13605,147,86,161,75,60,13,47,1
"46820",NA,46027,"Clay County, SD","County or equivalent",2008,13605,147,86,161,75,60,13,47,1
"46860",NA,NA,"Vernal, UT","Micropolitan Statistical Area",2008,29885,907,451,640,189,475,7,468,-19
"46860",NA,49047,"Uintah County, UT","County or equivalent",2008,29885,907,451,640,189,475,7,468,-19
"46900",NA,NA,"Vernon, TX","Micropolitan Statistical Area",2008,13782,-76,76,231,155,-158,12,-170,6
"46900",NA,48487,"Wilbarger County, TX","County or equivalent",2008,13782,-76,76,231,155,-158,12,-170,6
"46980",NA,NA,"Vicksburg, MS","Micropolitan Statistical Area",2008,48087,-684,303,794,491,-1002,16,-1018,15
"46980",NA,28149,"Warren County, MS","County or equivalent",2008,48087,-684,303,794,491,-1002,16,-1018,15
"47080",NA,NA,"Vidalia, GA","Micropolitan Statistical Area",2008,37032,293,242,615,373,65,89,-24,-14
"47080",NA,13209,"Montgomery County, GA","County or equivalent",2008,8930,-63,52,130,78,-112,10,-122,-3
"47080",NA,13279,"Toombs County, GA","County or equivalent",2008,28102,356,190,485,295,177,79,98,-11
"47180",NA,NA,"Vincennes, IN","Micropolitan Statistical Area",2008,38057,75,23,474,451,29,28,1,23
"47180",NA,18083,"Knox County, IN","County or equivalent",2008,38057,75,23,474,451,29,28,1,23
"47340",NA,NA,"Wabash, IN","Micropolitan Statistical Area",2008,32706,-166,-22,368,390,-164,-1,-163,20
"47340",NA,18169,"Wabash County, IN","County or equivalent",2008,32706,-166,-22,368,390,-164,-1,-163,20
"47420",NA,NA,"Wahpeton, ND-MN","Micropolitan Statistical Area",2008,22620,-279,77,285,208,-329,6,-335,-27
"47420",NA,27167,"Wilkin County, MN","County or equivalent",2008,6286,-123,11,80,69,-118,0,-118,-16
"47420",NA,38077,"Richland County, ND","County or equivalent",2008,16334,-156,66,205,139,-211,6,-217,-11
"47460",NA,NA,"Walla Walla, WA","Micropolitan Statistical Area",2008,57788,659,248,765,517,387,132,255,24
"47460",NA,53071,"Walla Walla County, WA","County or equivalent",2008,57788,659,248,765,517,387,132,255,24
"47500",NA,NA,"Walterboro, SC","Micropolitan Statistical Area",2008,39019,103,102,518,416,3,20,-17,-2
"47500",NA,45029,"Colleton County, SC","County or equivalent",2008,39019,103,102,518,416,3,20,-17,-2
"47540",NA,NA,"Wapakoneta, OH","Micropolitan Statistical Area",2008,46576,200,180,632,452,-6,16,-22,26
"47540",NA,39011,"Auglaize County, OH","County or equivalent",2008,46576,200,180,632,452,-6,16,-22,26
"47620",NA,NA,"Warren, PA","Micropolitan Statistical Area",2008,40728,-236,-82,403,485,-172,1,-173,18
"47620",NA,42123,"Warren County, PA","County or equivalent",2008,40728,-236,-82,403,485,-172,1,-173,18
"47660",NA,NA,"Warrensburg, MO","Micropolitan Statistical Area",2008,52016,118,441,790,349,-341,79,-420,18
"47660",NA,29101,"Johnson County, MO","County or equivalent",2008,52016,118,441,790,349,-341,79,-420,18
"47700",NA,NA,"Warsaw, IN","Micropolitan Statistical Area",2008,76275,202,507,1102,595,-282,92,-374,-23
"47700",NA,18085,"Kosciusko County, IN","County or equivalent",2008,76275,202,507,1102,595,-282,92,-374,-23
"47780",NA,NA,"Washington, IN","Micropolitan Statistical Area",2008,30147,173,207,509,302,-26,36,-62,-8
"47780",NA,18027,"Daviess County, IN","County or equivalent",2008,30147,173,207,509,302,-26,36,-62,-8
"47820",NA,NA,"Washington, NC","Micropolitan Statistical Area",2008,46035,399,97,608,511,282,52,230,20
"47820",NA,37013,"Beaufort County, NC","County or equivalent",2008,46035,399,97,608,511,282,52,230,20
"47920",NA,NA,"Washington Court House, OH","Micropolitan Statistical Area",2008,28319,23,60,404,344,-43,8,-51,6
"47920",NA,39047,"Fayette County, OH","County or equivalent",2008,28319,23,60,404,344,-43,8,-51,6
"47980",NA,NA,"Watertown, SD","Micropolitan Statistical Area",2008,31977,23,217,527,310,-196,11,-207,2
"47980",NA,46029,"Codington County, SD","County or equivalent",2008,26317,-27,173,416,243,-203,11,-214,3
"47980",NA,46057,"Hamlin County, SD","County or equivalent",2008,5660,50,44,111,67,7,0,7,-1
"48020",NA,NA,"Watertown-Fort Atkinson, WI","Micropolitan Statistical Area",2008,80792,718,477,1066,589,228,67,161,13
"48020",NA,55055,"Jefferson County, WI","County or equivalent",2008,80792,718,477,1066,589,228,67,161,13
"48060",NA,NA,"Watertown-Fort Drum, NY","Micropolitan Statistical Area",2008,118046,120,1054,1896,842,-910,95,-1005,-24
"48060",NA,36045,"Jefferson County, NY","County or equivalent",2008,118046,120,1054,1896,842,-910,95,-1005,-24
"48100",NA,NA,"Wauchula, FL","Micropolitan Statistical Area",2008,28888,261,338,518,180,-48,185,-233,-29
"48100",NA,12049,"Hardee County, FL","County or equivalent",2008,28888,261,338,518,180,-48,185,-233,-29
"48180",NA,NA,"Waycross, GA","Micropolitan Statistical Area",2008,54006,360,198,818,620,157,63,94,5
"48180",NA,13229,"Pierce County, GA","County or equivalent",2008,18127,296,124,302,178,166,13,153,6
"48180",NA,13299,"Ware County, GA","County or equivalent",2008,35879,64,74,516,442,-9,50,-59,-1
"48460",NA,NA,"West Plains, MO","Micropolitan Statistical Area",2008,39000,396,109,558,449,258,21,237,29
"48460",NA,29091,"Howell County, MO","County or equivalent",2008,39000,396,109,558,449,258,21,237,29
"48500",NA,NA,"West Point, MS","Micropolitan Statistical Area",2008,20860,-103,94,320,226,-210,5,-215,13
"48500",NA,28025,"Clay County, MS","County or equivalent",2008,20860,-103,94,320,226,-210,5,-215,13
"48580",NA,NA,"Whitewater, WI","Micropolitan Statistical Area",2008,100749,450,460,1258,798,-71,141,-212,61
"48580",NA,55127,"Walworth County, WI","County or equivalent",2008,100749,450,460,1258,798,-71,141,-212,61
"48740",NA,NA,"Willimantic, CT","Micropolitan Statistical Area",2008,117345,500,506,1394,888,-65,220,-285,59
"48740",NA,9015,"Windham County, CT","County or equivalent",2008,117345,500,506,1394,888,-65,220,-285,59
"48780",NA,NA,"Williston, ND","Micropolitan Statistical Area",2008,19846,287,97,295,198,194,3,191,-4
"48780",NA,38105,"Williams County, ND","County or equivalent",2008,19846,287,97,295,198,194,3,191,-4
"48820",NA,NA,"Willmar, MN","Micropolitan Statistical Area",2008,40679,49,267,618,351,-205,34,-239,-13
"48820",NA,27067,"Kandiyohi County, MN","County or equivalent",2008,40679,49,267,618,351,-205,34,-239,-13
"48940",NA,NA,"Wilmington, OH","Micropolitan Statistical Area",2008,43200,238,214,597,383,2,30,-28,22
"48940",NA,39027,"Clinton County, OH","County or equivalent",2008,43200,238,214,597,383,2,30,-28,22
"48980",NA,NA,"Wilson, NC","Micropolitan Statistical Area",2008,77527,995,398,1138,740,643,199,444,-46
"48980",NA,37195,"Wilson County, NC","County or equivalent",2008,77527,995,398,1138,740,643,199,444,-46
"49060",NA,NA,"Winfield, KS","Micropolitan Statistical Area",2008,34065,-143,94,476,382,-191,21,-212,-46
"49060",NA,20035,"Cowley County, KS","County or equivalent",2008,34065,-143,94,476,382,-191,21,-212,-46
"49100",NA,NA,"Winona, MN","Micropolitan Statistical Area",2008,49879,31,193,589,396,-177,42,-219,15
"49100",NA,27169,"Winona County, MN","County or equivalent",2008,49879,31,193,589,396,-177,42,-219,15
"49260",NA,NA,"Woodward, OK","Micropolitan Statistical Area",2008,19838,164,112,305,193,48,8,40,4
"49260",NA,40153,"Woodward County, OK","County or equivalent",2008,19838,164,112,305,193,48,8,40,4
"49300",NA,NA,"Wooster, OH","Micropolitan Statistical Area",2008,113812,401,684,1653,969,-297,70,-367,14
"49300",NA,39169,"Wayne County, OH","County or equivalent",2008,113812,401,684,1653,969,-297,70,-367,14
"49380",NA,NA,"Worthington, MN","Micropolitan Statistical Area",2008,20365,263,139,319,180,113,53,60,11
"49380",NA,27105,"Nobles County, MN","County or equivalent",2008,20365,263,139,319,180,113,53,60,11
"49460",NA,NA,"Yankton, SD","Micropolitan Statistical Area",2008,21835,163,74,281,207,84,8,76,5
"49460",NA,46135,"Yankton County, SD","County or equivalent",2008,21835,163,74,281,207,84,8,76,5
"49540",NA,NA,"Yazoo City, MS","Micropolitan Statistical Area",2008,28464,-229,213,460,247,-458,7,-465,16
"49540",NA,28163,"Yazoo County, MS","County or equivalent",2008,28464,-229,213,460,247,-458,7,-465,16
"49780",NA,NA,"Zanesville, OH","Micropolitan Statistical Area",2008,85087,-143,255,1122,867,-438,8,-446,40
"49780",NA,39119,"Muskingum County, OH","County or equivalent",2008,85087,-143,255,1122,867,-438,8,-446,40
